,LIBGEO,code_insee,DEP,Ainés,Enfants,Juniors,Masters,Séniors,Actifs,Non_Actifs
0,L'Abergement-Clémenciat,1001,01,90,205,45,295,130,470,295
1,L'Abergement-de-Varey,1002,01,38,77,8,37,67,112,115
2,Ambérieu-en-Bugey,1004,01,1496,3604,1881,3899,2580,8360,5100
3,Ambérieux-en-Dombes,1005,01,140,365,200,625,265,1090,505
4,Ambléon,1006,01,12,16,8,32,16,56,28
5,Ambronay,1007,01,285,675,240,789,574,1603,960
6,Ambutrix,1008,01,39,171,110,217,127,454,210
7,Andert-et-Condon,1009,01,40,92,28,108,72,208,132
8,Anglefort,1010,01,110,338,76,308,268,652,448
9,Apremont,1011,01,36,124,20,148,68,236,160
10,Aranc,1012,01,72,64,16,96,64,176,136
11,Arandas,1013,01,12,31,9,55,12,76,43
12,Arbent,1014,01,283,853,292,1202,651,2145,1136
13,Arboys en Bugey,1015,01,100,140,40,252,84,376,240
14,Arbigny,1016,01,40,134,0,132,114,246,174
15,Argis,1017,01,47,104,17,132,87,236,151
16,Armix,1019,01,0,8,8,12,0,20,8
17,Ars-sur-Formans,1021,01,77,365,109,361,244,714,442
18,Artemare,1022,01,172,260,92,425,187,704,432
19,Asnières-sur-Saône,1023,01,5,5,20,30,5,55,10
20,Attignat,1024,01,232,1005,350,996,746,2092,1237
21,Bâgé-la-Ville,1025,01,180,935,230,998,799,2027,1115
22,Bâgé-le-Châtel,1026,01,133,200,95,259,135,489,333
23,Balan,1027,01,95,507,198,536,378,1112,602
24,Baneins,1028,01,51,139,75,201,82,358,190
25,Beaupont,1029,01,48,184,52,172,160,384,232
26,Beauregard,1030,01,80,270,113,235,190,538,350
27,Bellignat,1031,01,284,931,487,1127,703,2317,1215
28,Béligneux,1032,01,207,1006,434,802,738,1974,1213
29,Bellegarde-sur-Valserine,1033,01,1373,2876,1564,3126,2462,7152,4249
30,Belley,1034,01,1207,2210,854,2703,1468,5025,3417
31,Belleydoux,1035,01,25,80,10,145,55,210,105
32,Belmont-Luthézieu,1036,01,51,125,41,179,108,328,176
33,Bénonces,1037,01,31,62,16,63,62,141,93
34,Bény,1038,01,72,173,61,227,150,438,245
35,Béon,1039,01,64,100,52,144,108,304,164
36,Béréziat,1040,01,32,137,29,96,148,273,169
37,Bettant,1041,01,76,180,96,224,164,484,256
38,Bey,1042,01,12,54,17,109,58,184,66
39,Beynost,1043,01,640,1195,334,1407,879,2620,1835
40,Billiat,1044,01,40,177,60,160,144,364,217
41,Birieux,1045,01,36,88,16,80,64,160,124
42,Biziat,1046,01,112,200,68,276,152,496,312
43,Blyes,1047,01,34,303,59,302,216,577,337
44,La Boisse,1049,01,257,756,250,912,547,1709,1013
45,Boissey,1050,01,29,102,33,61,72,166,131
46,Bolozon,1051,01,3,10,0,39,12,51,13
47,Bouligneux,1052,01,25,75,24,88,66,178,100
48,Bourg-en-Bresse,1053,01,5737,8914,5836,11395,6606,23837,14651
49,Bourg-Saint-Christophe,1054,01,136,368,136,300,332,768,504
50,Boyeux-Saint-Jérôme,1056,01,40,92,12,124,84,220,132
51,Boz,1057,01,51,137,16,149,91,256,188
52,Brégnier-Cordon,1058,01,95,250,60,235,195,490,345
53,Brénaz,1059,01,0,13,16,37,16,69,13
54,Brénod,1060,01,100,132,52,144,108,304,232
55,Brens,1061,01,80,335,75,460,215,750,415
56,Bressolles,1062,01,72,224,84,260,168,512,296
57,Brion,1063,01,63,114,50,170,69,289,177
58,Briord,1064,01,57,247,114,276,215,605,304
59,Buellas,1065,01,180,435,126,619,385,1130,615
60,La Burbanche,1066,01,25,10,0,25,5,30,35
61,Ceignes,1067,01,25,90,10,135,25,170,115
62,Cerdon,1068,01,60,187,89,157,160,406,247
63,Certines,1069,01,60,434,140,519,297,956,494
64,Cessy,1071,01,200,1421,509,1318,1287,3114,1621
65,Ceyzériat,1072,01,268,777,340,840,661,1841,1045
66,Ceyzérieu,1073,01,120,228,60,404,184,648,348
67,Chalamont,1074,01,260,710,270,555,585,1410,970
68,Chaleins,1075,01,94,365,112,380,230,722,459
69,Chaley,1076,01,20,32,4,64,24,92,52
70,Challes-la-Montagne,1077,01,13,42,21,43,46,110,55
71,Challex,1078,01,125,370,135,420,305,860,495
72,Champagne-en-Valromey,1079,01,95,165,95,240,100,435,260
73,Champdor-Corcelles,1080,01,70,172,36,176,178,390,242
74,Champfromier,1081,01,50,150,79,293,144,516,200
75,Chanay,1082,01,60,140,60,184,100,344,200
76,Chaneins,1083,01,34,259,93,229,212,534,293
77,Chanoz-Châtenay,1084,01,89,209,42,212,176,430,298
78,La Chapelle-du-Châtelard,1085,01,33,108,33,97,71,201,141
79,Charix,1087,01,44,72,24,80,60,164,116
80,Charnoz-sur-Ain,1088,01,20,256,108,356,180,644,276
81,Château-Gaillard,1089,01,185,599,185,591,424,1200,784
82,Châtenay,1090,01,40,85,30,163,35,228,125
83,Châtillon-en-Michaille,1091,01,240,943,302,1088,682,2072,1183
84,Châtillon-la-Palud,1092,01,182,441,79,550,343,972,623
85,Châtillon-sur-Chalaronne,1093,01,699,1106,522,1449,835,2806,1805
86,Chavannes-sur-Reyssouze,1094,01,112,212,36,232,160,428,324
87,Chavannes-sur-Suran,1095,01,51,179,65,153,139,357,230
88,Chaveyriat,1096,01,80,260,116,300,224,640,340
89,Chavornay,1097,01,26,29,26,95,24,145,55
90,Chazey-Bons,1098,01,116,212,84,272,140,496,328
91,Chazey-sur-Ain,1099,01,140,400,115,490,365,970,540
92,Cheignieu-la-Balme,1100,01,25,25,5,50,30,85,50
93,Chevillard,1101,01,25,20,30,45,30,105,45
94,Chevroux,1102,01,56,296,92,272,240,604,352
95,Chevry,1103,01,70,400,178,433,388,999,470
96,Chézery-Forens,1104,01,30,110,65,140,120,325,140
97,Civrieux,1105,01,84,435,170,539,280,989,519
98,Cize,1106,01,35,45,15,35,35,85,80
99,Cleyzieu,1107,01,30,25,15,40,15,70,55
100,Coligny,1108,01,165,241,108,426,184,718,406
101,Collonges,1109,01,110,674,240,470,672,1382,784
102,Colomieu,1110,01,10,15,15,65,20,100,25
103,Conand,1111,01,5,30,10,35,30,75,35
104,Condamine,1112,01,25,130,35,145,100,280,155
105,Condeissiat,1113,01,110,230,99,208,178,485,340
106,Confort,1114,01,44,104,88,152,68,308,148
107,Confrançon,1115,01,115,394,175,305,263,743,509
108,Contrevoz,1116,01,108,115,40,169,85,294,223
109,Conzieu,1117,01,5,30,15,60,35,110,35
110,Corbonod,1118,01,116,281,112,317,248,677,397
111,Corlier,1121,01,18,26,19,25,16,60,44
112,Cormaranche-en-Bugey,1122,01,84,184,44,324,128,496,268
113,Cormoranche-sur-Saône,1123,01,112,257,74,340,229,643,369
114,Cormoz,1124,01,80,155,30,215,160,405,235
115,Corveissiat,1125,01,105,165,65,150,120,335,270
116,Courmangoux,1127,01,72,124,32,160,112,304,196
117,Courtes,1128,01,37,70,48,90,21,159,107
118,Crans,1129,01,4,67,44,85,40,169,71
119,Cras-sur-Reyssouze,1130,01,103,444,90,348,358,796,547
120,Cressin-Rochefort,1133,01,39,78,16,114,80,210,117
121,Crottet,1134,01,189,410,139,548,334,1021,599
122,Crozet,1135,01,128,614,204,643,480,1327,742
123,Cruzilles-lès-Mépillat,1136,01,104,235,70,245,165,480,339
124,Culoz,1138,01,469,705,212,850,562,1624,1174
125,Curciat-Dongalon,1139,01,93,83,18,101,80,199,176
126,Curtafond,1140,01,64,203,56,229,161,446,267
127,Cuzieu,1141,01,38,117,17,129,86,232,155
128,Dagneux,1142,01,370,1194,532,1418,840,2790,1564
129,Divonne-les-Bains,1143,01,807,2345,828,2857,2087,5772,3152
130,Dommartin,1144,01,120,253,76,208,232,516,373
131,Dompierre-sur-Veyle,1145,01,107,287,72,423,212,707,394
132,Dompierre-sur-Chalaronne,1146,01,40,131,33,125,81,239,171
133,Domsure,1147,01,60,116,36,152,100,288,176
134,Dortan,1148,01,217,390,149,697,330,1176,607
135,Douvres,1149,01,99,281,38,369,196,603,380
136,Drom,1150,01,20,60,20,65,50,135,80
137,Druillat,1151,01,155,260,110,395,225,730,415
138,Échallon,1152,01,65,215,50,270,170,490,280
139,Échenevex,1153,01,140,616,147,689,518,1354,756
140,Étrez,1154,01,72,264,149,200,162,511,336
141,Évosges,1155,01,15,30,0,50,40,90,45
142,Faramans,1156,01,56,212,80,256,168,504,268
143,Fareins,1157,01,172,521,210,852,334,1396,693
144,Farges,1158,01,109,311,65,250,192,507,420
145,Feillens,1159,01,407,720,364,1084,633,2081,1127
146,Ferney-Voltaire,1160,01,678,2214,1187,2577,2554,6318,2892
147,Flaxieu,1162,01,15,20,0,20,10,30,35
148,Foissiat,1163,01,293,484,170,705,276,1151,777
149,Francheleins,1165,01,95,491,119,431,334,884,586
150,Frans,1166,01,116,524,221,833,357,1411,640
151,Garnerans,1167,01,52,178,50,177,147,374,230
152,Genouilleux,1169,01,40,187,19,133,150,302,227
153,Béard-Géovreissiat,1170,01,36,316,104,304,240,648,352
154,Géovreisset,1171,01,41,271,54,299,192,545,312
155,Germagnat,1172,01,15,55,5,65,20,90,70
156,Gex,1173,01,519,2716,1646,2851,2820,7317,3235
157,Giron,1174,01,25,24,16,42,25,83,49
158,Gorrevod,1175,01,85,255,70,255,174,499,340
159,Grand-Corent,1177,01,10,35,10,90,35,135,45
160,Grièges,1179,01,270,470,160,685,320,1165,740
161,Grilly,1180,01,102,192,42,233,158,433,294
162,Groissiat,1181,01,50,360,115,370,304,789,410
163,Guéreins,1183,01,156,404,59,411,335,805,560
164,Hautecourt-Romanèche,1184,01,105,220,50,245,170,465,325
165,Hauteville-Lompnes,1185,01,537,668,365,1102,436,1903,1205
166,Hostiaz,1186,01,8,28,0,24,36,60,36
167,Haut Valromey,1187,01,95,160,48,253,161,462,255
168,Illiat,1188,01,51,170,50,155,144,349,221
169,Injoux-Génissiat,1189,01,119,300,185,295,243,723,419
170,Innimond,1190,01,22,12,3,30,15,48,34
171,Izenave,1191,01,24,36,40,52,12,104,60
172,Izernore,1192,01,210,656,170,687,509,1366,866
173,Izieu,1193,01,30,35,35,80,35,150,65
174,Jassans-Riottier,1194,01,676,1643,630,2051,1104,3785,2319
175,Jasseron,1195,01,117,503,89,520,355,964,620
176,Jayat,1196,01,95,329,84,340,201,625,424
177,Journans,1197,01,36,84,28,116,76,220,120
178,Joyeux,1198,01,16,52,44,120,40,204,68
179,Jujurieux,1199,01,248,589,188,652,460,1300,837
180,Labalme,1200,01,12,43,24,60,29,113,55
181,Lagnieu,1202,01,820,1823,693,2119,1361,4173,2643
182,Laiz,1203,01,86,304,132,450,183,765,390
183,Le Poizat-Lalleyriat,1204,01,61,213,44,199,178,421,274
184,Lancrans,1205,01,95,237,134,270,202,606,332
185,Lantenay,1206,01,20,68,16,53,70,139,88
186,Lapeyrouse,1207,01,12,91,38,98,57,193,103
187,Lavours,1208,01,30,25,5,45,30,80,55
188,Léaz,1209,01,75,230,60,145,185,390,305
189,Lélex,1210,01,40,48,12,88,36,136,88
190,Lent,1211,01,128,364,148,456,308,912,492
191,Lescheroux,1212,01,59,189,32,225,155,412,248
192,Leyment,1213,01,43,384,131,369,243,743,427
193,Leyssard,1214,01,25,16,12,53,13,78,41
194,Lhôpital,1215,01,10,6,0,15,3,18,16
195,Lhuis,1216,01,100,186,51,282,139,472,286
196,Lochieu,1218,01,12,28,24,28,8,60,40
197,Lompnas,1219,01,15,55,10,55,25,90,70
198,Lompnieu,1221,01,10,30,0,50,29,79,40
199,Loyettes,1224,01,200,1004,380,739,802,1921,1204
200,Lurcy,1225,01,15,106,15,191,65,271,121
201,Magnieu,1227,01,71,103,44,131,71,246,174
202,Maillat,1228,01,55,160,40,263,110,413,215
203,Malafretaz,1229,01,84,332,80,396,224,700,416
204,Mantenay-Montlin,1230,01,29,76,21,95,50,166,105
205,Manziat,1231,01,204,517,144,669,424,1237,721
206,Marboz,1232,01,295,474,123,805,372,1300,769
207,Marchamp,1233,01,32,36,4,16,48,68,68
208,Marignieu,1234,01,30,35,15,60,30,105,65
209,Marlieux,1235,01,158,268,95,243,209,547,426
210,Marsonnas,1236,01,124,268,97,348,173,618,392
211,Martignat,1237,01,99,480,114,452,363,929,579
212,Massieux,1238,01,263,695,198,843,434,1475,958
213,Massignieu-de-Rives,1239,01,75,162,70,221,125,416,237
214,Matafelon-Granges,1240,01,55,175,20,245,150,415,230
215,Meillonnas,1241,01,140,299,80,478,240,798,439
216,Mérignat,1242,01,10,19,10,36,18,64,29
217,Messimy-sur-Saône,1243,01,75,350,70,455,270,795,425
218,Meximieux,1244,01,698,2075,977,2106,1408,4491,2773
219,Bohas-Meyriat-Rignat,1245,01,92,228,80,312,180,572,320
220,Mézériat,1246,01,255,610,230,565,490,1285,865
221,Mijoux,1247,01,25,75,15,135,50,200,100
222,Mionnay,1248,01,139,510,262,818,298,1378,649
223,Miribel,1249,01,820,2409,1082,2765,1836,5683,3229
224,Misérieux,1250,01,109,500,113,570,378,1061,609
225,Mogneneins,1252,01,142,205,70,245,105,420,347
226,Montagnat,1254,01,184,499,110,684,383,1177,683
227,Montagnieu,1255,01,50,150,70,190,110,370,200
228,Montanges,1257,01,35,70,30,150,50,230,105
229,Montceaux,1258,01,70,364,95,476,191,762,434
230,Montcet,1259,01,30,191,65,213,109,387,221
231,Le Montellier,1260,01,17,73,47,68,47,162,90
232,Monthieux,1261,01,32,171,44,237,113,394,203
233,Montluel,1262,01,675,1789,856,2171,1320,4347,2464
234,Montmerle-sur-Saône,1263,01,465,1030,310,1210,725,2245,1495
235,Montracol,1264,01,75,330,84,269,255,608,405
236,Montréal-la-Cluse,1265,01,390,845,415,1050,705,2170,1235
237,Montrevel-en-Bresse,1266,01,364,520,252,764,396,1412,884
238,Nurieux-Volognat,1267,01,90,261,112,309,193,614,351
239,Murs-et-Gélignieux,1268,01,25,70,20,75,60,155,95
240,Nantua,1269,01,372,897,459,931,642,2032,1269
241,Neuville-les-Dames,1272,01,144,364,164,452,328,944,508
242,Neuville-sur-Ain,1273,01,171,454,109,474,395,978,625
243,Les Neyrolles,1274,01,65,179,64,173,165,402,244
244,Neyron,1275,01,262,520,309,865,444,1618,782
245,Niévroz,1276,01,72,402,152,516,288,956,474
246,Nivollet-Montgriffon,1277,01,8,28,8,32,36,76,36
247,Oncieu,1279,01,29,20,3,10,15,28,49
248,Ordonnaz,1280,01,16,36,8,60,24,92,52
249,Ornex,1281,01,207,1308,337,1260,1094,2691,1515
250,Outriaz,1282,01,25,70,10,65,80,155,95
251,Oyonnax,1283,01,2407,6198,2437,6713,4360,13510,8605
252,Ozan,1284,01,77,170,53,157,131,341,247
253,Parcieux,1285,01,100,327,72,351,266,689,427
254,Parves et Nattages,1286,01,105,210,53,304,196,553,315
255,Péron,1288,01,146,688,227,691,667,1585,834
256,Péronnas,1289,01,920,1341,533,2134,834,3501,2261
257,Pérouges,1290,01,160,285,105,470,195,770,445
258,Perrex,1291,01,64,200,56,312,156,524,264
259,Peyriat,1293,01,0,52,32,68,32,132,52
260,Peyrieu,1294,01,92,165,25,272,152,449,257
261,Peyzieux-sur-Saône,1295,01,16,212,52,148,179,379,228
262,Pirajoux,1296,01,40,115,10,165,60,235,155
263,Pizay,1297,01,49,200,60,299,125,484,249
264,Plagne,1298,01,0,15,25,45,25,95,15
265,Le Plantay,1299,01,16,135,35,171,79,285,151
266,Polliat,1301,01,312,610,220,825,483,1528,922
267,Pollieu,1302,01,16,35,4,62,24,90,51
268,Poncin,1303,01,211,438,159,470,301,930,649
269,Pont-d'Ain,1304,01,376,675,283,694,574,1551,1051
270,Pont-de-Vaux,1305,01,397,415,301,636,319,1256,812
271,Pont-de-Veyle,1306,01,155,316,167,423,264,854,471
272,Port,1307,01,85,205,135,276,140,551,290
273,Pougny,1308,01,60,250,79,220,220,519,310
274,Pouillat,1309,01,20,28,12,4,32,48,48
275,Prémeyzel,1310,01,20,25,12,32,22,66,45
276,Prémillieu,1311,01,8,4,8,12,4,24,12
277,Prévessin-Moëns,1313,01,363,2392,703,2077,2067,4847,2755
278,Priay,1314,01,196,448,152,421,389,962,644
279,Pugieu,1316,01,35,30,20,40,30,90,65
280,Ramasse,1317,01,30,75,45,95,50,190,105
281,Rancé,1318,01,40,230,65,290,85,440,270
282,Relevant,1319,01,30,120,45,170,90,305,150
283,Replonges,1320,01,449,927,224,1183,732,2139,1376
284,Revonnas,1321,01,68,288,88,276,188,552,356
285,Reyrieux,1322,01,386,1209,260,1474,880,2614,1595
286,Reyssouze,1323,01,115,248,84,219,235,538,363
287,Rignieux-le-Franc,1325,01,47,221,66,413,158,637,268
288,Romans,1328,01,36,136,52,136,120,308,172
289,Rossillon,1329,01,12,9,8,70,29,107,21
290,Ruffieu,1330,01,35,30,10,85,15,110,65
291,Saint-Alban,1331,01,16,46,24,36,30,90,62
292,Saint-André-de-Bâgé,1332,01,56,173,44,238,128,410,229
293,Saint-André-de-Corcy,1333,01,265,716,240,1132,527,1899,981
294,Saint-André-d'Huiriat,1334,01,52,153,20,152,154,326,205
295,Saint-André-le-Bouchoux,1335,01,45,110,30,108,75,213,155
296,Saint-André-sur-Vieux-Jonc,1336,01,156,294,100,279,221,600,450
297,Saint-Bénigne,1337,01,128,308,100,404,253,757,436
298,Groslée-Saint-Benoit,1338,01,148,295,90,403,221,714,443
299,Saint-Bernard,1339,01,156,324,108,556,184,848,480
300,Saint-Champ,1341,01,20,28,20,64,24,108,48
301,Sainte-Croix,1342,01,29,178,34,161,116,311,207
302,Saint-Cyr-sur-Menthon,1343,01,124,500,176,528,384,1088,624
303,Saint-Denis-lès-Bourg,1344,01,930,1314,346,1992,933,3271,2244
304,Saint-Denis-en-Bugey,1345,01,248,538,238,765,407,1410,786
305,Saint-Didier-d'Aussiat,1346,01,115,270,65,280,155,500,385
306,Saint-Didier-de-Formans,1347,01,173,503,132,669,313,1114,676
307,Saint-Didier-sur-Chalaronne,1348,01,356,751,277,903,458,1638,1107
308,Saint-Éloi,1349,01,20,104,48,180,84,312,124
309,Saint-Étienne-du-Bois,1350,01,369,640,229,839,453,1521,1009
310,Saint-Étienne-sur-Chalaronne,1351,01,132,480,181,409,319,909,612
311,Saint-Étienne-sur-Reyssouze,1352,01,60,152,52,176,104,332,212
312,Sainte-Euphémie,1353,01,92,464,152,632,288,1072,556
313,Saint-Genis-Pouilly,1354,01,633,2568,1480,2470,2526,6476,3201
314,Saint-Genis-sur-Menthon,1355,01,52,113,64,136,81,281,165
315,Saint-Georges-sur-Renon,1356,01,0,88,4,76,52,132,88
316,Saint-Germain-de-Joux,1357,01,39,99,66,147,88,301,138
317,Saint-Germain-les-Paroisses,1358,01,54,107,29,138,72,239,161
318,Saint-Germain-sur-Renon,1359,01,8,48,4,102,31,137,56
319,Saint-Jean-de-Gonville,1360,01,73,390,109,618,320,1047,463
320,Saint-Jean-de-Niost,1361,01,104,365,100,623,215,938,469
321,Saint-Jean-de-Thurigneux,1362,01,75,225,25,270,170,465,300
322,Saint-Jean-le-Vieux,1363,01,200,410,164,601,280,1045,610
323,Saint-Jean-sur-Reyssouze,1364,01,104,160,68,280,116,464,264
324,Saint-Jean-sur-Veyle,1365,01,116,302,76,368,195,639,418
325,Sainte-Julie,1366,01,64,294,100,232,254,586,358
326,Saint-Julien-sur-Reyssouze,1367,01,90,156,30,240,151,421,246
327,Saint-Julien-sur-Veyle,1368,01,92,217,64,196,164,424,309
328,Saint-Just,1369,01,56,212,44,344,176,564,268
329,Saint-Laurent-sur-Saône,1370,01,184,356,260,468,372,1100,540
330,Saint-Marcel,1371,01,45,419,163,385,327,875,464
331,Saint-Martin-de-Bavel,1372,01,30,91,17,144,75,236,121
332,Saint-Martin-du-Frêne,1373,01,150,220,125,360,200,685,370
333,Saint-Martin-du-Mont,1374,01,156,409,136,662,347,1145,565
334,Saint-Martin-le-Châtel,1375,01,89,230,40,307,155,502,319
335,Saint-Maurice-de-Beynost,1376,01,417,1069,457,1091,832,2380,1486
336,Saint-Maurice-de-Gourdans,1378,01,183,721,180,689,576,1445,904
337,Saint-Maurice-de-Rémens,1379,01,65,212,12,228,146,386,277
338,Saint-Nizier-le-Bouchoux,1380,01,140,145,50,205,100,355,285
339,Saint-Nizier-le-Désert,1381,01,68,269,76,260,212,548,337
340,Sainte-Olive,1382,01,30,90,5,100,55,160,120
341,Saint-Paul-de-Varax,1383,01,151,391,97,397,262,756,542
342,Saint-Rambert-en-Bugey,1384,01,249,622,270,540,478,1288,871
343,Saint-Rémy,1385,01,117,236,94,362,123,579,353
344,Saint-Sorlin-en-Bugey,1386,01,105,270,127,299,232,658,375
345,Saint-Sulpice,1387,01,17,79,13,42,55,110,96
346,Saint-Trivier-de-Courtes,1388,01,192,200,100,304,180,584,392
347,Saint-Trivier-sur-Moignans,1389,01,152,514,220,508,359,1087,666
348,Saint-Vulbas,1390,01,100,230,110,353,155,618,330
349,Salavre,1391,01,52,48,20,112,56,188,100
350,Samognat,1392,01,39,194,14,214,155,383,233
351,Sandrans,1393,01,21,135,35,166,100,301,156
352,Sault-Brénaz,1396,01,110,230,117,293,223,633,340
353,Sauverny,1397,01,60,284,118,338,253,709,344
354,Savigneux,1398,01,71,360,108,422,266,796,431
355,Ségny,1399,01,133,510,199,609,446,1254,643
356,Seillonnaz,1400,01,12,20,23,49,15,87,32
357,Sergy,1401,01,145,590,170,630,480,1280,735
358,Sermoyer,1402,01,92,157,56,208,149,413,249
359,Serrières-de-Briord,1403,01,185,355,105,405,215,725,540
360,Serrières-sur-Ain,1404,01,16,28,4,41,45,90,44
361,Servas,1405,01,70,358,126,413,220,759,428
362,Servignat,1406,01,36,28,16,56,24,96,64
363,Seyssel,1407,01,123,249,85,283,257,625,372
364,Simandre-sur-Suran,1408,01,60,188,68,268,100,436,248
365,Sonthonnax-la-Montagne,1410,01,10,105,34,105,80,219,115
366,Souclin,1411,01,16,67,16,83,49,148,83
367,Sulignat,1412,01,52,160,64,212,76,352,212
368,Surjoux,1413,01,6,0,18,24,6,48,6
369,Sutrieu,1414,01,55,55,5,40,60,105,110
370,Talissieu,1415,01,31,107,25,159,65,249,138
371,Tenay,1416,01,126,192,88,321,156,565,318
372,Thézillieu,1417,01,33,48,19,102,49,170,81
373,Thil,1418,01,60,292,108,400,156,664,352
374,Thoiry,1419,01,449,1750,650,1707,1472,3829,2199
375,Thoissey,1420,01,279,281,188,402,222,812,560
376,Torcieu,1421,01,85,180,85,259,135,479,265
377,Tossiat,1422,01,140,348,144,412,304,860,488
378,Toussieux,1423,01,40,229,68,326,148,542,269
379,Tramoyes,1424,01,154,427,168,585,263,1016,581
380,La Tranclière,1425,01,30,64,22,92,30,144,94
381,Val-Revermont,1426,01,315,671,205,768,479,1452,986
382,Trévoux,1427,01,538,1820,831,1971,1467,4269,2358
383,Valeins,1428,01,25,45,0,30,25,55,70
384,Vandeins,1429,01,48,192,84,184,156,424,240
385,Varambon,1430,01,79,102,32,177,90,299,181
386,Vaux-en-Bugey,1431,01,168,324,148,308,276,732,492
387,Verjon,1432,01,44,60,24,104,36,164,104
388,Vernoux,1433,01,8,116,16,61,73,150,124
389,Versailleux,1434,01,65,100,35,125,60,220,165
390,Versonnex,1435,01,178,695,149,710,452,1311,873
391,Vesancy,1436,01,45,118,45,176,95,316,163
392,Vescours,1437,01,15,65,10,90,50,150,80
393,Vésines,1439,01,0,28,4,40,20,64,28
394,Vieu-d'Izenave,1441,01,60,216,44,192,176,412,276
395,Vieu,1442,01,72,64,20,118,75,213,136
396,Villars-les-Dombes,1443,01,598,1044,467,1407,669,2543,1642
397,Villebois,1444,01,65,328,105,365,314,784,393
398,Villemotier,1445,01,50,200,45,215,145,405,250
399,Villeneuve,1446,01,100,464,132,376,352,860,564
400,Villereversure,1447,01,121,285,136,351,234,721,406
401,Villes,1448,01,52,84,28,136,56,220,136
402,Villette-sur-Ain,1449,01,26,183,53,303,112,468,209
403,Villieu-Loyes-Mollon,1450,01,349,927,276,1053,717,2046,1276
404,Viriat,1451,01,735,1583,555,2094,1036,3685,2318
405,Virieu-le-Grand,1452,01,85,250,119,353,226,698,335
406,Virieu-le-Petit,1453,01,35,50,20,105,40,165,85
407,Virignin,1454,01,104,305,75,254,245,574,409
408,Vongnes,1456,01,15,0,0,40,0,40,15
409,Vonnas,1457,01,407,755,251,824,551,1626,1162
410,Abbécourt,2001,02,35,140,40,180,100,320,175
411,Achery,2002,02,75,155,45,205,110,360,230
412,Acy,2003,02,100,275,80,370,180,630,375
413,Agnicourt-et-Séchelles,2004,02,20,40,20,95,20,135,60
414,Aguilcourt,2005,02,28,88,52,144,72,268,116
415,Aisonville-et-Bernoville,2006,02,30,50,20,105,40,165,80
416,Aizelles,2007,02,12,28,8,44,28,80,40
417,Aizy-Jouy,2008,02,5,115,35,60,110,205,120
418,Alaincourt,2009,02,28,160,24,180,140,344,188
419,Allemant,2010,02,0,46,9,58,26,93,46
420,Ambleny,2011,02,99,286,61,378,218,657,385
421,Ambrief,2012,02,5,0,10,35,10,55,5
422,Amifontaine,2013,02,60,105,60,120,60,240,165
423,Amigny-Rouy,2014,02,70,170,35,320,110,465,240
424,Ancienville,2015,02,0,15,20,30,10,60,15
425,Andelain,2016,02,30,60,10,70,50,130,90
426,Anguilcourt-le-Sart,2017,02,20,93,13,68,73,154,113
427,Anizy-le-Château,2018,02,271,479,142,691,270,1103,750
428,Annois,2019,02,40,65,30,145,65,240,105
429,Any-Martin-Rieux,2020,02,50,125,40,160,90,290,175
430,Archon,2021,02,0,21,4,32,16,52,21
431,Arcy-Sainte-Restitue,2022,02,34,120,47,122,63,232,154
432,Armentières-sur-Ourcq,2023,02,6,19,0,28,22,50,25
433,Arrancy,2024,02,10,15,5,15,15,35,25
434,Artemps,2025,02,20,96,40,144,64,248,116
435,Assis-sur-Serre,2027,02,30,40,40,85,25,150,70
436,Athies-sous-Laon,2028,02,291,648,268,915,495,1678,939
437,Attilly,2029,02,25,80,45,154,65,264,105
438,Aubencheul-aux-Bois,2030,02,21,78,12,102,40,154,99
439,Aubenton,2031,02,93,138,63,191,100,354,231
440,Aubigny-aux-Kaisnes,2032,02,20,64,24,68,60,152,84
441,Aubigny-en-Laonnois,2033,02,12,20,8,48,12,68,32
442,Audignicourt,2034,02,3,19,13,27,13,53,22
443,Audigny,2035,02,25,95,40,70,45,155,120
444,Augy,2036,02,15,15,0,25,20,45,30
445,Aulnois-sous-Laon,2037,02,95,435,130,509,265,904,530
446,Les Autels,2038,02,10,10,5,10,15,30,20
447,Autremencourt,2039,02,19,40,13,31,29,73,59
448,Autreppes,2040,02,44,40,12,32,32,76,84
449,Autreville,2041,02,80,224,44,300,176,520,304
450,Azy-sur-Marne,2042,02,25,85,15,180,80,275,110
451,Bagneux,2043,02,5,20,5,35,0,40,25
452,Bancigny,2044,02,0,5,0,5,10,15,5
453,Barenton-Bugny,2046,02,52,127,43,185,91,319,179
454,Barenton-Cel,2047,02,5,30,15,65,10,90,35
455,Barenton-sur-Serre,2048,02,4,28,17,40,12,69,32
456,Barisis-aux-Bois,2049,02,80,176,76,256,152,484,256
457,Barzy-en-Thiérache,2050,02,21,102,34,92,54,180,123
458,Barzy-sur-Marne,2051,02,34,65,50,165,50,265,99
459,Bassoles-Aulers,2052,02,4,52,0,52,44,96,56
460,Vallées en Champagne,2053,02,96,143,29,195,107,331,239
461,Bazoches-sur-Vesles,2054,02,60,130,30,135,125,290,190
462,Beaumé,2055,02,15,19,7,31,9,47,34
463,Beaumont-en-Beine,2056,02,12,52,12,48,48,108,64
464,Beaurevoir,2057,02,125,387,131,383,282,796,512
465,Beaurieux,2058,02,92,260,84,168,185,437,352
466,Beautor,2059,02,345,616,346,866,462,1674,961
467,Beauvois-en-Vermandois,2060,02,22,86,13,71,51,135,108
468,Becquigny,2061,02,20,104,48,48,60,156,124
469,Belleau,2062,02,15,20,5,55,20,80,35
470,Bellenglise,2063,02,36,92,32,124,88,244,128
471,Belleu,2064,02,666,738,306,1249,585,2140,1404
472,Bellicourt,2065,02,50,180,50,205,110,365,230
473,Benay,2066,02,5,35,40,75,40,155,40
474,Bergues-sur-Sambre,2067,02,30,40,10,80,35,125,70
475,Berlancourt,2068,02,5,30,0,20,45,65,35
476,Berlise,2069,02,9,27,6,24,28,58,36
477,Bernot,2070,02,30,115,40,155,85,280,145
478,Berny-Rivière,2071,02,40,167,38,225,117,380,207
479,Berrieux,2072,02,4,30,16,70,32,118,34
480,Berry-au-Bac,2073,02,62,125,76,201,63,340,187
481,Bertaucourt-Epourdon,2074,02,55,175,40,175,165,380,230
482,Berthenicourt,2075,02,28,52,3,51,34,88,80
483,Bertricourt,2076,02,3,62,3,43,43,89,65
484,Berzy-le-Sec,2077,02,13,87,36,122,85,243,100
485,Besmé,2078,02,15,47,12,15,44,71,62
486,Besmont,2079,02,36,24,20,36,32,88,60
487,Besny-et-Loizy,2080,02,40,90,45,129,55,229,130
488,Béthancourt-en-Vaux,2081,02,60,107,56,132,70,258,167
489,Beugneux,2082,02,10,20,12,19,20,51,30
490,Beuvardes,2083,02,71,149,59,237,119,415,220
491,Bézu-le-Guéry,2084,02,18,78,12,56,65,133,96
492,Bézu-Saint-Germain,2085,02,40,404,96,232,252,580,444
493,Bichancourt,2086,02,105,267,98,365,232,695,372
494,Bieuxy,2087,02,5,10,0,10,10,20,15
495,Bièvres,2088,02,20,16,8,8,24,40,36
496,Billy-sur-Aisne,2089,02,224,228,80,408,200,688,452
497,Billy-sur-Ourcq,2090,02,8,71,8,68,36,112,79
498,Blanzy-lès-Fismes,2091,02,30,35,15,15,25,55,65
499,Blérancourt,2093,02,156,352,76,388,264,728,508
500,Blesmes,2094,02,60,96,28,140,72,240,156
501,Bohain-en-Vermandois,2095,02,753,1484,662,1672,888,3222,2237
502,Bois-lès-Pargny,2096,02,4,44,8,71,33,112,48
503,Boncourt,2097,02,33,75,25,56,52,133,108
504,Bonneil,2098,02,19,99,38,121,71,230,118
505,Bonnesvalyn,2099,02,10,65,45,80,55,180,75
506,Bony,2100,02,5,35,20,40,20,80,40
507,Bosmont-sur-Serre,2101,02,30,50,15,70,20,105,80
508,Bouconville-Vauclair,2102,02,15,55,5,65,30,100,70
509,Boué,2103,02,148,337,102,388,247,737,485
510,Bouffignereux,2104,02,20,10,5,50,5,60,30
511,Bouresches,2105,02,15,40,10,85,45,140,55
512,Bourg-et-Comin,2106,02,84,248,100,220,116,436,332
513,Bourguignon-sous-Coucy,2107,02,8,32,8,28,20,56,40
514,Bourguignon-sous-Montbavin,2108,02,24,44,4,56,16,76,68
515,La Bouteille,2109,02,69,130,65,154,95,314,199
516,Braine,2110,02,292,610,224,625,399,1248,902
517,Brancourt-en-Laonnois,2111,02,80,168,56,232,148,436,248
518,Brancourt-le-Grand,2112,02,55,150,50,215,115,380,205
519,Brasles,2114,02,180,304,96,424,272,792,484
520,Braye-en-Laonnois,2115,02,23,52,16,70,19,105,75
521,Braye-en-Thiérache,2116,02,21,29,4,29,30,63,50
522,Bray-Saint-Christophe,2117,02,6,14,15,32,6,53,20
523,Braye,2118,02,20,33,4,33,20,57,53
524,Brécy,2119,02,38,63,25,86,69,180,101
525,Brenelle,2120,02,15,30,15,105,20,140,45
526,Breny,2121,02,12,69,28,81,37,146,81
527,Brie,2122,02,10,20,0,35,0,35,30
528,Brissay-Choigny,2123,02,53,70,17,68,48,133,123
529,Brissy-Hamégicourt,2124,02,56,140,60,220,160,440,196
530,Brumetz,2125,02,10,85,15,70,30,115,95
531,Brunehamel,2126,02,92,113,30,122,91,243,205
532,Bruyères-sur-Fère,2127,02,23,32,16,53,23,92,55
533,Bruyères-et-Montbérault,2128,02,220,330,170,580,225,975,550
534,Bruys,2129,02,0,0,0,8,4,12,0
535,Bucilly,2130,02,20,35,15,69,13,97,55
536,Bucy-le-Long,2131,02,246,440,152,621,331,1104,686
537,Bucy-lès-Cerny,2132,02,24,64,4,64,44,112,88
538,Bucy-lès-Pierrepont,2133,02,84,92,36,115,49,200,176
539,Buire,2134,02,100,204,84,384,108,576,304
540,Buironfosse,2135,02,135,267,91,414,173,678,402
541,Burelles,2136,02,0,45,10,70,15,95,45
542,Bussiares,2137,02,8,41,20,36,24,80,49
543,Buzancy,2138,02,4,44,8,96,28,132,48
544,Caillouël-Crépigny,2139,02,25,121,0,143,113,256,146
545,Camelin,2140,02,64,120,16,136,88,240,184
546,La Capelle,2141,02,280,348,161,573,290,1024,628
547,Castres,2142,02,24,54,13,53,63,129,78
548,Le Catelet,2143,02,24,56,8,68,56,132,80
549,Caulaincourt,2144,02,20,30,5,20,50,75,50
550,Caumont,2145,02,80,125,65,200,95,360,205
551,Celles-lès-Condé,2146,02,19,15,6,21,0,27,34
552,Celles-sur-Aisne,2148,02,6,51,34,75,52,161,57
553,Cerizy,2149,02,12,12,4,8,8,20,24
554,Cerny-en-Laonnois,2150,02,0,10,15,35,5,55,10
555,Cerny-lès-Bucy,2151,02,16,32,4,44,20,68,48
556,Cerseuil,2152,02,5,15,20,20,25,65,20
557,Cessières,2153,02,20,75,55,200,105,360,95
558,Chacrise,2154,02,35,105,35,105,55,195,140
559,Chaillevois,2155,02,50,35,20,60,35,115,85
560,Chalandry,2156,02,12,52,28,100,44,172,64
561,Chambry,2157,02,119,191,50,295,125,470,310
562,Chamouille,2158,02,15,100,50,70,60,180,115
563,Champs,2159,02,40,70,30,90,40,160,110
564,Chaourse,2160,02,73,142,25,130,105,260,215
565,La Chapelle-sur-Chézy,2162,02,45,90,25,60,45,130,135
566,Charly-sur-Marne,2163,02,224,707,279,830,532,1641,931
567,Le Charmel,2164,02,50,80,35,105,65,205,130
568,Charmes,2165,02,246,361,95,481,323,899,607
569,Chartèves,2166,02,44,75,55,138,40,233,119
570,Chassemy,2167,02,50,270,70,275,180,525,320
571,Château-Thierry,2168,02,1808,3426,1890,4157,2727,8774,5234
572,Châtillon-lès-Sons,2169,02,16,20,4,32,16,52,36
573,Châtillon-sur-Oise,2170,02,13,17,4,52,16,72,30
574,Chaudardes,2171,02,9,22,6,15,26,47,31
575,Chaudun,2172,02,36,76,8,72,56,136,112
576,Chauny,2173,02,1467,2857,1483,3671,1967,7121,4324
577,Chavignon,2174,02,85,206,47,241,173,461,291
578,Chavigny,2175,02,16,30,3,43,18,64,46
579,Chavonne,2176,02,20,60,25,65,30,120,80
580,Chérêt,2177,02,35,55,10,45,10,65,90
581,Chermizy-Ailles,2178,02,12,32,16,24,28,68,44
582,Chéry-Chartreuve,2179,02,20,83,25,125,75,225,103
583,Chéry-lès-Pouilly,2180,02,69,194,75,166,139,380,263
584,Chéry-lès-Rozoy,2181,02,15,11,10,25,10,45,26
585,Chevennes,2182,02,8,52,16,52,20,88,60
586,Chevregny,2183,02,16,44,36,80,28,144,60
587,Chevresis-Monceau,2184,02,10,86,25,82,61,168,96
588,Chézy-en-Orxois,2185,02,30,115,45,130,75,250,145
589,Chézy-sur-Marne,2186,02,153,223,126,457,212,795,376
590,Chierry,2187,02,183,221,53,408,153,614,404
591,Chigny,2188,02,24,20,4,60,16,80,44
592,Chivres-en-Laonnois,2189,02,68,92,32,96,84,212,160
593,Chivres-Val,2190,02,80,165,60,187,86,333,245
594,Chivy-lès-Étouvelles,2191,02,38,109,71,177,55,303,147
595,Chouy,2192,02,20,125,5,135,100,240,145
596,Cierges,2193,02,22,6,3,16,9,28,28
597,Cilly,2194,02,36,54,9,67,33,109,90
598,Ciry-Salsogne,2195,02,43,232,94,316,164,574,275
599,Clacy-et-Thierret,2196,02,35,75,5,110,100,215,110
600,Clairfontaine,2197,02,60,158,69,175,114,358,218
601,Clamecy,2198,02,28,56,8,104,24,136,84
602,Clastres,2199,02,50,185,50,175,185,410,235
603,Clermont-les-Fermes,2200,02,15,35,15,30,20,65,50
604,Coeuvres-et-Valsery,2201,02,45,76,40,100,70,210,121
605,Coincy,2203,02,136,408,140,356,260,756,544
606,Coingt,2204,02,10,10,0,25,20,45,20
607,Colligis-Crandelain,2205,02,4,77,25,68,39,132,81
608,Colonfay,2206,02,12,20,12,28,8,48,32
609,Commenchon,2207,02,8,82,20,42,56,118,90
610,Concevreux,2208,02,26,58,26,77,62,165,84
611,Condé-en-Brie,2209,02,70,170,67,193,127,387,240
612,Condé-sur-Aisne,2210,02,10,85,20,145,90,255,95
613,Condé-sur-Suippe,2211,02,24,44,28,100,24,152,68
614,Condren,2212,02,80,166,35,290,115,440,246
615,Connigis,2213,02,40,68,52,100,56,208,108
616,Contescourt,2214,02,0,25,10,25,10,45,25
617,Corbeny,2215,02,41,182,38,202,175,415,223
618,Corcy,2216,02,12,65,33,131,39,203,77
619,Coucy-le-Château-Auffrique,2217,02,130,265,92,241,157,490,395
620,Coucy-lès-Eppes,2218,02,84,141,36,194,141,371,225
621,Coucy-la-Ville,2219,02,20,49,8,29,39,76,69
622,Coulonges-Cohan,2220,02,44,120,36,140,88,264,164
623,Coupru,2221,02,15,56,10,40,47,97,71
624,Courbes,2222,02,0,5,0,10,10,20,5
625,Courboin,2223,02,5,85,25,100,80,205,90
626,Courcelles-sur-Vesle,2224,02,32,96,60,92,84,236,128
627,Courchamps,2225,02,15,35,0,15,25,40,50
628,Courmelles,2226,02,215,418,193,623,292,1108,633
629,Courmont,2227,02,15,40,20,74,5,99,55
630,Courtemont-Varennes,2228,02,66,62,36,36,36,108,128
631,Courtrizy-et-Fussigny,2229,02,8,18,9,33,0,42,26
632,Couvrelles,2230,02,6,39,13,55,51,119,45
633,Couvron-et-Aumencourt,2231,02,40,264,111,227,173,511,304
634,Coyolles,2232,02,40,45,5,71,30,106,85
635,Cramaille,2233,02,21,23,3,15,37,55,44
636,Craonne,2234,02,8,8,4,33,12,49,16
637,Craonnelle,2235,02,8,21,8,24,16,48,29
638,Crécy-au-Mont,2236,02,10,115,34,133,70,237,125
639,Crécy-sur-Serre,2237,02,136,336,136,526,224,886,472
640,Crépy,2238,02,144,563,233,514,341,1088,707
641,Crézancy,2239,02,84,326,160,274,279,713,410
642,Croix-Fonsomme,2240,02,16,64,26,52,37,115,80
643,La Croix-sur-Ourcq,2241,02,20,30,10,30,15,55,50
644,Crouttes-sur-Marne,2242,02,42,157,76,175,131,382,199
645,Crouy,2243,02,387,650,262,960,404,1626,1037
646,Crupilly,2244,02,5,20,5,15,15,35,25
647,Cuffies,2245,02,188,492,268,524,316,1108,680
648,Cugny,2246,02,46,126,29,209,116,354,172
649,Cuirieux,2248,02,12,50,3,29,41,73,62
650,Cuiry-Housse,2249,02,10,16,3,39,15,57,26
651,Cuiry-lès-Chaudardes,2250,02,6,9,7,12,16,35,15
652,Cuiry-lès-Iviers,2251,02,0,0,0,10,10,20,0
653,Cuissy-et-Geny,2252,02,8,12,4,24,12,40,20
654,Cuisy-en-Almont,2253,02,36,76,32,152,52,236,112
655,Cutry,2254,02,4,28,16,48,28,92,32
656,Cys-la-Commune,2255,02,30,45,15,45,20,80,75
657,Dagny-Lambercy,2256,02,18,33,3,30,30,63,51
658,Dallon,2257,02,44,92,32,164,76,272,136
659,Dammard,2258,02,44,92,28,160,80,268,136
660,Dampleux,2259,02,29,109,9,147,70,226,138
661,Danizy,2260,02,72,169,66,141,80,287,241
662,Dercy,2261,02,65,85,30,127,85,242,150
663,Deuillet,2262,02,40,70,10,60,45,115,110
664,Dhuizel,2263,02,10,40,0,50,25,75,50
665,Dizy-le-Gros,2264,02,80,190,60,275,155,490,270
666,Dohis,2265,02,45,15,5,25,10,40,60
667,Dolignon,2266,02,9,7,0,18,0,18,16
668,Dommiers,2267,02,30,75,24,55,94,173,105
669,Domptin,2268,02,60,196,60,224,124,408,256
670,Dorengt,2269,02,12,32,3,53,26,82,44
671,Douchy,2270,02,8,56,12,40,28,80,64
672,Dravegny,2271,02,13,35,13,43,17,73,48
673,Droizy,2272,02,4,20,8,29,4,41,24
674,Dury,2273,02,24,39,8,44,62,114,63
675,Ébouleau,2274,02,15,53,26,47,44,117,68
676,Effry,2275,02,35,90,35,105,75,215,125
677,Englancourt,2276,02,24,48,4,28,40,72,72
678,Épagny,2277,02,50,92,47,64,53,164,142
679,Éparcy,2278,02,0,6,0,30,0,30,6
680,Épaux-Bézu,2279,02,65,110,70,185,120,375,175
681,Épieds,2280,02,50,105,40,120,70,230,155
682,L'Épine-aux-Bois,2281,02,30,75,25,89,35,149,105
683,Eppes,2282,02,29,95,16,143,71,230,124
684,Erlon,2283,02,35,90,20,95,50,165,125
685,Erloy,2284,02,19,13,6,9,21,36,32
686,Esquéhéries,2286,02,78,189,59,280,157,496,267
687,Essigny-le-Grand,2287,02,108,246,42,436,169,647,354
688,Essigny-le-Petit,2288,02,60,90,40,105,60,205,150
689,Essises,2289,02,35,80,55,185,60,300,115
690,Essômes-sur-Marne,2290,02,357,765,213,846,587,1646,1122
691,Estrées,2291,02,60,110,40,115,100,255,170
692,Étampes-sur-Marne,2292,02,128,286,115,431,211,757,414
693,Étaves-et-Bocquiaux,2293,02,56,184,32,168,144,344,240
694,Étouvelles,2294,02,12,32,19,81,22,122,44
695,Étréaupont,2295,02,85,234,100,303,146,549,319
696,Étreillers,2296,02,95,295,95,350,240,685,390
697,Étrépilly,2297,02,4,22,4,20,31,55,26
698,Étreux,2298,02,150,320,225,550,224,999,470
699,Évergnicourt,2299,02,40,155,55,170,180,405,195
700,Faucoucourt,2301,02,24,81,26,70,66,162,105
701,Faverolles,2302,02,19,84,15,72,66,153,103
702,Fayet,2303,02,100,192,32,232,132,396,292
703,La Fère,2304,02,220,722,471,671,522,1664,942
704,Fère-en-Tardenois,2305,02,389,779,310,1030,529,1869,1168
705,La Ferté-Chevresis,2306,02,60,154,49,165,162,376,214
706,La Ferté-Milon,2307,02,196,476,265,729,414,1408,672
707,Fesmy-le-Sart,2308,02,45,130,15,200,105,320,175
708,Festieux,2309,02,43,185,70,180,142,392,228
709,Fieulaine,2310,02,40,44,48,96,44,188,84
710,Filain,2311,02,12,40,4,28,40,72,52
711,La Flamengrie,2312,02,121,358,136,365,180,681,479
712,Flavigny-le-Grand-et-Beaurain,2313,02,50,125,65,130,90,285,175
713,Flavy-le-Martel,2315,02,198,432,93,499,256,848,630
714,Fleury,2316,02,29,15,10,64,15,89,44
715,Fluquières,2317,02,9,49,8,78,47,133,58
716,Folembray,2318,02,157,348,156,432,243,831,505
717,Fonsomme,2319,02,40,95,55,205,70,330,135
718,Fontaine-lès-Clercs,2320,02,18,72,13,82,67,162,90
719,Fontaine-lès-Vervins,2321,02,65,259,114,298,194,606,324
720,Fontaine-Notre-Dame,2322,02,30,105,50,150,55,255,135
721,Fontaine-Uterte,2323,02,0,45,5,40,35,80,45
722,Fontenelle,2324,02,32,68,16,92,64,172,100
723,Fontenoy,2326,02,80,105,60,150,90,300,185
724,Foreste,2327,02,12,48,16,60,48,124,60
725,Fossoy,2328,02,29,96,45,252,85,382,125
726,Fourdrain,2329,02,48,104,32,120,96,248,152
727,Francilly-Selency,2330,02,58,88,19,133,60,212,146
728,Franqueville,2331,02,9,23,9,31,27,67,32
729,Fresnes-en-Tardenois,2332,02,40,70,15,90,45,150,110
730,Fresnes,2333,02,8,39,16,50,30,96,47
731,Fresnoy-le-Grand,2334,02,399,765,319,1017,474,1810,1164
732,Fressancourt,2335,02,15,50,20,90,25,135,65
733,Frières-Faillouël,2336,02,50,298,125,305,218,648,348
734,Froidestrées,2337,02,5,41,10,111,15,136,46
735,Froidmont-Cohartille,2338,02,25,60,30,90,45,165,85
736,Gandelu,2339,02,64,187,49,206,132,387,251
737,Gauchy,2340,02,725,1290,515,2035,750,3300,2015
738,Gercy,2341,02,28,72,40,96,48,184,100
739,Gergny,2342,02,30,45,5,35,30,70,75
740,Germaine,2343,02,5,15,0,30,30,60,20
741,Gernicourt,2344,02,4,12,0,24,8,32,16
742,Gibercourt,2345,02,0,5,15,5,5,25,5
743,Gizy,2346,02,93,123,37,219,126,382,216
744,Gland,2347,02,50,99,36,151,67,254,149
745,Goudelancourt-lès-Berrieux,2349,02,3,10,3,22,6,31,13
746,Goudelancourt-lès-Pierrepont,2350,02,10,25,10,60,25,95,35
747,Goussancourt,2351,02,16,44,0,20,52,72,60
748,Gouy,2352,02,80,150,40,175,120,335,230
749,Grandlup-et-Fay,2353,02,40,100,15,105,65,185,140
750,Grandrieux,2354,02,16,24,8,24,16,48,40
751,Gricourt,2355,02,55,295,70,320,240,630,350
752,Grisolles,2356,02,4,82,22,60,38,120,86
753,Gronard,2357,02,16,28,0,16,16,32,44
754,Grougis,2358,02,20,85,15,130,100,245,105
755,Grugies,2359,02,59,344,147,393,259,799,403
756,Guignicourt,2360,02,236,554,190,729,464,1383,790
757,Guise,2361,02,789,1143,517,1586,771,2874,1932
758,Guivry,2362,02,25,65,15,100,45,160,90
759,Guny,2363,02,45,100,55,125,75,255,145
760,Guyencourt,2364,02,18,66,8,90,35,133,84
761,Hannapes,2366,02,25,110,40,80,70,190,135
762,Happencourt,2367,02,35,10,0,35,45,80,45
763,Haramont,2368,02,84,142,41,176,93,310,226
764,Harcigny,2369,02,36,44,28,80,44,152,80
765,Hargicourt,2370,02,29,179,16,229,87,332,208
766,Harly,2371,02,312,325,131,581,205,917,637
767,Hartennes-et-Taux,2372,02,32,108,52,120,68,240,140
768,Hary,2373,02,24,60,8,92,48,148,84
769,Lehaucourt,2374,02,64,236,136,232,182,550,300
770,Hautevesnes,2375,02,30,68,10,25,58,93,98
771,Hauteville,2376,02,29,39,15,49,44,108,68
772,Haution,2377,02,10,35,0,75,25,100,45
773,La Hérie,2378,02,30,30,0,55,30,85,60
774,Le Hérie-la-Viéville,2379,02,40,65,35,85,15,135,105
775,Hinacourt,2380,02,0,5,0,25,0,25,5
776,Hirson,2381,02,1169,2334,1220,2898,1444,5562,3503
777,Holnon,2382,02,136,344,168,552,200,920,480
778,Homblières,2383,02,125,375,120,565,290,975,500
779,Houry,2384,02,0,9,3,6,9,18,9
780,Housset,2385,02,15,30,20,60,15,95,45
781,Iron,2386,02,45,75,25,75,40,140,120
782,Itancourt,2387,02,88,274,109,331,194,634,362
783,Iviers,2388,02,16,52,0,74,43,117,68
784,Jaulgonne,2389,02,85,135,70,260,80,410,220
785,Jeancourt,2390,02,24,72,28,80,60,168,96
786,Jeantes,2391,02,25,45,25,70,40,135,70
787,Joncourt,2392,02,50,75,25,115,50,190,125
788,Jouaignes,2393,02,9,37,6,26,46,78,46
789,Jumencourt,2395,02,16,40,8,60,20,88,56
790,Jumigny,2396,02,8,16,0,12,24,36,24
791,Jussy,2397,02,120,312,85,388,241,714,432
792,Juvigny,2398,02,45,75,15,95,40,150,120
793,Juvincourt-et-Damary,2399,02,36,189,52,151,126,329,225
794,Laffaux,2400,02,5,35,25,55,20,100,40
795,Laigny,2401,02,15,45,15,85,35,135,60
796,Lanchy,2402,02,10,15,0,5,20,25,25
797,Landifay-et-Bertaignemont,2403,02,44,57,14,61,58,133,101
798,Landouzy-la-Cour,2404,02,5,45,5,90,25,120,50
799,Landouzy-la-Ville,2405,02,76,159,28,191,113,332,235
800,Landricourt,2406,02,12,49,8,40,26,74,61
801,Laniscourt,2407,02,16,44,17,45,40,102,60
802,Laon,2408,02,2772,5981,3522,7472,4103,15097,8753
803,Lappion,2409,02,15,60,5,132,56,193,75
804,Largny-sur-Automne,2410,02,15,40,15,120,30,165,55
805,Latilly,2411,02,22,52,26,51,30,107,74
806,Launoy,2412,02,3,25,6,25,16,47,28
807,Laval-en-Laonnois,2413,02,9,62,16,64,53,133,71
808,Lavaqueresse,2414,02,10,65,15,75,45,135,75
809,Laversine,2415,02,0,50,10,45,45,100,50
810,Lemé,2416,02,110,70,55,95,80,230,180
811,Lempire,2417,02,18,15,0,45,20,65,33
812,Lerzy,2418,02,30,70,35,65,20,120,100
813,Leschelle,2419,02,55,54,25,98,45,168,109
814,Lesdins,2420,02,56,211,25,329,145,499,267
815,Lesges,2421,02,8,37,4,20,24,48,45
816,Lesquielles-Saint-Germain,2422,02,75,201,92,253,123,468,276
817,Leuilly-sous-Coucy,2423,02,41,111,7,111,80,198,152
818,Leury,2424,02,16,24,8,48,8,64,40
819,Leuze,2425,02,25,35,16,42,20,78,60
820,Levergies,2426,02,50,130,70,230,80,380,180
821,Lhuys,2427,02,14,50,10,20,50,80,64
822,Licy-Clignon,2428,02,9,25,3,9,15,27,34
823,Lierval,2429,02,16,32,20,28,24,72,48
824,Liesse-Notre-Dame,2430,02,150,260,115,430,205,750,410
825,Liez,2431,02,47,92,29,135,60,224,139
826,Limé,2432,02,15,35,10,65,40,115,50
827,Lislet,2433,02,15,65,25,95,30,150,80
828,Lizy,2434,02,20,65,15,110,45,170,85
829,Logny-lès-Aubenton,2435,02,30,30,0,10,20,30,60
830,Longpont,2438,02,20,65,30,115,55,200,85
831,Les Septvallons,2439,02,44,316,115,356,232,703,360
832,Lor,2440,02,28,36,16,24,32,72,64
833,Louâtre,2441,02,16,48,12,60,52,124,64
834,Loupeigne,2442,02,0,28,16,24,32,72,28
835,Lucy-le-Bocage,2443,02,20,55,15,60,45,120,75
836,Lugny,2444,02,6,18,6,40,12,58,24
837,Luzoir,2445,02,65,65,30,75,55,160,130
838,Ly-Fontaine,2446,02,5,30,5,45,30,80,35
839,Maast-et-Violaine,2447,02,3,38,20,33,25,78,41
840,Mâchecourt,2448,02,24,38,8,49,4,61,62
841,Macogny,2449,02,15,35,0,0,25,25,50
842,Macquigny,2450,02,35,109,29,106,53,188,144
843,Magny-la-Fosse,2451,02,3,26,23,38,16,77,29
844,Maissemy,2452,02,5,70,0,80,85,165,75
845,Maizy,2453,02,30,95,25,115,120,260,125
846,La Malmaison,2454,02,44,144,48,96,100,244,188
847,Malzy,2455,02,25,46,8,47,37,92,71
848,Manicamp,2456,02,44,60,36,124,44,204,104
849,Marchais,2457,02,34,100,64,102,68,234,134
850,Dhuys et Morin-en-Brie,2458,02,98,228,58,240,155,453,326
851,Marcy,2459,02,28,60,8,44,44,96,88
852,Marcy-sous-Marle,2460,02,35,25,25,95,15,135,60
853,Marest-Dampcourt,2461,02,38,82,71,68,57,196,120
854,Mareuil-en-Dôle,2462,02,50,50,20,70,50,140,100
855,Marfontaine,2463,02,8,29,8,4,22,34,37
856,Margival,2464,02,64,104,32,100,80,212,168
857,Marigny-en-Orxois,2465,02,22,115,33,153,97,283,137
858,Marizy-Sainte-Geneviève,2466,02,4,26,16,33,16,65,30
859,Marizy-Saint-Mard,2467,02,0,10,15,35,5,55,10
860,Marle,2468,02,330,526,210,840,305,1355,856
861,Marly-Gomont,2469,02,104,112,32,136,72,240,216
862,Martigny,2470,02,19,93,50,119,80,249,112
863,Martigny-Courpierre,2471,02,19,35,5,50,5,60,54
864,Mauregny-en-Haye,2472,02,60,125,60,95,80,235,185
865,Mayot,2473,02,28,56,16,44,52,112,84
866,Mennessis,2474,02,36,136,36,108,108,252,172
867,Menneville,2475,02,48,125,48,96,104,248,173
868,Mennevret,2476,02,57,160,62,158,125,345,217
869,Mercin-et-Vaux,2477,02,156,241,32,341,172,545,397
870,Merlieux-et-Fouquerolles,2478,02,10,85,15,105,55,175,95
871,Mesbrecourt-Richecourt,2480,02,49,62,25,70,51,146,111
872,Mesnil-Saint-Laurent,2481,02,27,98,20,166,102,288,125
873,Meurival,2482,02,5,5,0,10,20,30,10
874,Mézières-sur-Oise,2483,02,85,95,50,225,50,325,180
875,Mézy-Moulins,2484,02,60,140,30,235,70,335,200
876,Missy-aux-Bois,2485,02,0,27,20,50,0,70,27
877,Missy-lès-Pierrepont,2486,02,28,36,12,20,16,48,64
878,Missy-sur-Aisne,2487,02,40,115,65,325,85,475,155
879,Molain,2488,02,12,29,16,58,16,90,41
880,Molinchart,2489,02,10,110,10,125,80,215,120
881,Monampteuil,2490,02,0,25,15,65,20,100,25
882,Monceau-le-Neuf-et-Faucouzy,2491,02,44,75,40,94,80,214,119
883,Monceau-lès-Leups,2492,02,33,128,53,124,86,263,161
884,Monceau-le-Waast,2493,02,14,66,24,55,49,128,80
885,Monceau-sur-Oise,2494,02,39,26,0,24,24,48,65
886,Mondrepuis,2495,02,100,260,116,300,192,608,360
887,Monnes,2496,02,0,40,5,20,50,75,40
888,Mons-en-Laonnois,2497,02,112,368,72,376,280,728,480
889,Montaigu,2498,02,57,175,98,237,120,455,232
890,Montbavin,2499,02,0,12,8,16,8,32,12
891,Montbrehain,2500,02,104,266,80,236,158,474,370
892,Montchâlons,2501,02,6,3,3,21,6,30,9
893,Montcornet,2502,02,185,334,154,493,226,873,519
894,Mont-d'Origny,2503,02,72,189,84,310,90,484,261
895,Montescourt-Lizerolles,2504,02,145,495,240,454,330,1024,640
896,Montfaucon,2505,02,12,40,24,68,44,136,52
897,Montgobert,2506,02,35,35,5,75,55,135,70
898,Montgru-Saint-Hilaire,2507,02,5,15,5,5,15,25,20
899,Monthenault,2508,02,20,40,4,48,32,84,60
900,Monthiers,2509,02,4,54,20,61,24,105,58
901,Monthurel,2510,02,8,39,0,51,26,77,47
902,Montigny-en-Arrouaise,2511,02,25,70,35,105,50,190,95
903,Montigny-l'Allier,2512,02,28,84,28,84,52,164,112
904,Montigny-le-Franc,2513,02,29,27,9,42,22,73,56
905,Montigny-Lengrain,2514,02,43,177,57,193,170,420,220
906,Montigny-lès-Condé,2515,02,5,30,5,15,15,35,35
907,Montigny-sous-Marle,2516,02,12,10,3,12,6,21,22
908,Montigny-sur-Crécy,2517,02,48,92,40,92,64,196,140
909,Montlevon,2518,02,52,72,24,92,60,176,124
910,Montloué,2519,02,10,45,25,80,15,120,55
911,Mont-Notre-Dame,2520,02,32,188,88,264,160,512,220
912,Montreuil-aux-Lions,2521,02,103,381,156,402,265,823,484
913,Mont-Saint-Jean,2522,02,3,17,9,21,0,30,20
914,Mont-Saint-Martin,2523,02,10,30,0,30,20,50,40
915,Mont-Saint-Père,2524,02,65,175,45,245,165,455,240
916,Morcourt,2525,02,70,95,30,265,100,395,165
917,Morgny-en-Thiérache,2526,02,15,23,9,25,19,53,38
918,Morsain,2527,02,30,117,23,105,111,239,147
919,Mortefontaine,2528,02,22,40,6,99,33,138,62
920,Mortiers,2529,02,25,35,25,80,20,125,60
921,Moulins,2530,02,5,15,10,40,0,50,20
922,Moussy-Verneuil,2531,02,15,30,25,45,15,85,45
923,Moÿ-de-l'Aisne,2532,02,108,228,80,368,196,644,336
924,Muret-et-Crouttes,2533,02,12,36,0,56,36,92,48
925,Muscourt,2534,02,4,16,4,12,12,28,20
926,Nampcelles-la-Cour,2535,02,6,12,10,47,12,69,18
927,Nampteuil-sous-Muret,2536,02,8,20,12,20,28,60,28
928,Nanteuil-la-Fosse,2537,02,12,52,24,40,52,116,64
929,Nanteuil-Notre-Dame,2538,02,5,10,10,20,10,40,15
930,Nauroy,2539,02,72,196,60,228,148,436,268
931,Nesles-la-Montagne,2540,02,120,332,50,460,241,751,452
932,Neufchâtel-sur-Aisne,2541,02,35,84,29,143,57,229,119
933,Neuflieux,2542,02,15,25,0,30,20,50,40
934,Neuilly-Saint-Front,2543,02,161,569,242,673,421,1336,730
935,Neuve-Maison,2544,02,57,153,51,164,100,315,210
936,La Neuville-Bosmont,2545,02,24,32,20,64,12,96,56
937,La Neuville-en-Beine,2546,02,16,64,8,88,28,124,80
938,La Neuville-Housset,2547,02,8,16,4,16,20,40,24
939,La Neuville-lès-Dorengt,2548,02,55,80,35,135,55,225,135
940,Neuville-Saint-Amand,2549,02,110,175,80,345,150,575,285
941,Neuville-sur-Ailette,2550,02,4,20,16,37,8,61,24
942,Neuville-sur-Margival,2551,02,3,47,20,15,27,62,50
943,Neuvillette,2552,02,8,44,20,72,32,124,52
944,Nizy-le-Comte,2553,02,28,57,10,82,47,139,85
945,Nogentel,2554,02,185,215,85,365,145,595,400
946,Nogent-l'Artaud,2555,02,263,535,214,651,409,1274,798
947,Noircourt,2556,02,10,25,15,30,20,65,35
948,Noroy-sur-Ourcq,2557,02,12,37,0,15,45,60,49
949,Le Nouvion-en-Thiérache,2558,02,307,590,273,962,429,1664,897
950,Nouvion-et-Catillon,2559,02,50,99,72,180,86,338,149
951,Nouvion-le-Comte,2560,02,20,50,30,80,60,170,70
952,Nouvion-le-Vineux,2561,02,9,30,12,46,28,86,39
953,Nouvron-Vingré,2562,02,5,80,35,75,45,155,85
954,Noyales,2563,02,20,72,16,56,32,104,92
955,Noyant-et-Aconin,2564,02,28,144,60,188,88,336,172
956,Oeuilly,2565,02,13,61,16,96,58,170,74
957,Ognes,2566,02,140,270,125,445,170,740,410
958,Ohis,2567,02,10,100,30,125,65,220,110
959,Oigny-en-Valois,2568,02,20,30,15,65,20,100,50
960,Oisy,2569,02,60,128,68,136,72,276,188
961,Ollezy,2570,02,20,70,5,45,60,110,90
962,Omissy,2571,02,86,133,33,191,124,348,219
963,Orainville,2572,02,40,156,52,168,112,332,196
964,Orgeval,2573,02,20,10,0,25,5,30,30
965,Origny-en-Thiérache,2574,02,128,368,144,485,243,872,496
966,Origny-Sainte-Benoite,2575,02,204,420,220,544,292,1056,624
967,Osly-Courtil,2576,02,12,92,28,96,80,204,104
968,Ostel,2577,02,20,25,5,20,20,45,45
969,Oulches-la-Vallée-Foulon,2578,02,0,38,4,28,24,56,38
970,Oulchy-la-Ville,2579,02,9,29,9,34,23,66,38
971,Oulchy-le-Château,2580,02,109,190,60,228,188,476,299
972,Paars,2581,02,0,63,37,104,74,215,63
973,Paissy,2582,02,16,6,10,6,12,28,22
974,Pancy-Courtecon,2583,02,4,20,0,36,12,48,24
975,Papleux,2584,02,4,41,8,34,22,64,45
976,Parcy-et-Tigny,2585,02,12,56,34,78,47,159,68
977,Parfondeval,2586,02,34,26,6,38,13,57,60
978,Parfondru,2587,02,40,95,15,120,80,215,135
979,Pargnan,2588,02,25,15,5,15,10,30,40
980,Pargny-Filain,2589,02,32,68,24,48,72,144,100
981,Pargny-la-Dhuys,2590,02,28,52,4,48,44,96,80
982,Pargny-les-Bois,2591,02,28,32,12,52,20,84,60
983,Parpeville,2592,02,36,36,10,45,40,95,72
984,Pasly,2593,02,200,210,60,395,125,580,410
985,Passy-en-Valois,2594,02,0,40,35,35,35,105,40
986,Passy-sur-Marne,2595,02,25,30,5,50,25,80,55
987,Pavant,2596,02,93,210,55,275,145,475,303
988,Pernant,2598,02,45,150,45,275,130,450,195
989,Pierremande,2599,02,48,60,20,100,40,160,108
990,Pierrepont,2600,02,54,99,30,91,63,184,153
991,Pignicourt,2601,02,0,58,12,59,38,109,58
992,Pinon,2602,02,235,470,170,530,345,1045,705
993,Pithon,2604,02,12,16,4,12,20,36,28
994,Pleine-Selve,2605,02,38,55,5,65,25,95,93
995,Le Plessier-Huleu,2606,02,8,20,0,32,20,52,28
996,Ploisy,2607,02,15,25,0,25,25,50,40
997,Plomion,2608,02,75,85,45,160,85,290,160
998,Ployart-et-Vaurseine,2609,02,5,0,0,10,5,15,5
999,Pommiers,2610,02,37,123,50,272,77,399,160
1000,Pont-Arcy,2612,02,5,30,10,55,25,90,35
1001,Pontavert,2613,02,58,152,47,151,128,326,210
1002,Pontru,2614,02,15,65,35,85,60,180,80
1003,Pontruet,2615,02,36,98,8,123,50,181,134
1004,Pont-Saint-Mard,2616,02,12,69,4,70,32,106,81
1005,Pouilly-sur-Serre,2617,02,67,100,41,152,65,258,167
1006,Prémont,2618,02,60,235,65,180,160,405,295
1007,Prémontré,2619,02,81,94,46,195,61,302,175
1008,Presles-et-Boves,2620,02,52,92,28,128,52,208,144
1009,Presles-et-Thierny,2621,02,40,90,30,180,50,260,130
1010,Priez,2622,02,5,15,5,10,5,20,20
1011,Prisces,2623,02,8,28,0,52,16,68,36
1012,Proisy,2624,02,15,76,3,113,59,175,91
1013,Proix,2625,02,9,35,9,24,48,81,44
1014,Prouvais,2626,02,25,75,20,129,75,224,100
1015,Proviseux-et-Plesnoy,2627,02,0,25,8,40,22,70,25
1016,Puiseux-en-Retz,2628,02,15,40,28,80,45,153,55
1017,Puisieux-et-Clanlieu,2629,02,22,93,16,77,52,145,115
1018,Quierzy,2631,02,37,115,31,143,56,230,152
1019,Quincy-Basse,2632,02,0,25,10,40,0,50,25
1020,Quincy-sous-le-Mont,2633,02,10,20,5,5,20,30,30
1021,Raillimont,2634,02,9,13,3,22,6,31,22
1022,Ramicourt,2635,02,5,50,5,65,25,95,55
1023,Regny,2636,02,15,38,26,67,24,117,53
1024,Remaucourt,2637,02,28,57,18,136,27,181,85
1025,Remies,2638,02,27,45,23,69,42,134,72
1026,Remigny,2639,02,20,115,30,125,90,245,135
1027,Renansart,2640,02,24,40,20,56,32,108,64
1028,Renneval,2641,02,16,36,20,36,28,84,52
1029,Résigny,2642,02,71,26,13,41,13,67,97
1030,Ressons-le-Long,2643,02,124,187,45,176,168,389,311
1031,Retheuil,2644,02,34,140,20,118,41,179,174
1032,Reuilly-Sauvigny,2645,02,20,68,24,56,56,136,88
1033,Ribeauville,2647,02,13,6,3,26,12,41,19
1034,Ribemont,2648,02,191,484,198,640,322,1160,675
1035,Rocourt-Saint-Martin,2649,02,16,65,23,87,33,143,81
1036,Rocquigny,2650,02,65,97,25,126,45,196,162
1037,Rogécourt,2651,02,12,44,0,28,20,48,56
1038,Rogny,2652,02,0,30,10,65,15,90,30
1039,Romeny-sur-Marne,2653,02,68,136,24,152,92,268,204
1040,Romery,2654,02,12,24,0,44,16,60,36
1041,Ronchères,2655,02,35,45,10,20,20,50,80
1042,Roucy,2656,02,35,108,12,94,89,195,143
1043,Rougeries,2657,02,12,58,37,56,35,128,70
1044,Roupy,2658,02,28,76,4,100,40,144,104
1045,Rouvroy,2659,02,50,130,55,180,115,350,180
1046,Rouvroy-sur-Serre,2660,02,3,3,0,9,9,18,6
1047,Royaucourt-et-Chailvet,2661,02,29,44,12,75,34,121,73
1048,Rozet-Saint-Albin,2662,02,37,86,30,86,33,149,123
1049,Rozières-sur-Crise,2663,02,4,56,28,80,52,160,60
1050,Rozoy-Bellevalle,2664,02,0,30,15,55,15,85,30
1051,Grand-Rozoy,2665,02,16,84,44,100,56,200,100
1052,Rozoy-sur-Serre,2666,02,141,282,80,315,166,561,423
1053,Saconin-et-Breuil,2667,02,10,60,30,110,30,170,70
1054,Sains-Richaumont,2668,02,175,265,140,260,210,610,440
1055,Saint-Algis,2670,02,48,48,4,40,32,76,96
1056,Saint-Aubin,2671,02,5,75,35,135,45,215,80
1057,Saint-Bandry,2672,02,30,77,30,75,51,156,107
1058,Saint-Christophe-à-Berry,2673,02,75,107,26,90,87,203,182
1059,Saint-Clément,2674,02,8,24,4,8,16,28,32
1060,Sainte-Croix,2675,02,9,26,3,48,12,63,35
1061,Saint-Erme-Outre-et-Ramecourt,2676,02,190,445,229,595,299,1123,635
1062,Saint-Eugène,2677,02,30,65,25,80,30,135,95
1063,Sainte-Geneviève,2678,02,8,20,4,40,4,48,28
1064,Saint-Gengoulph,2679,02,0,34,12,55,17,84,34
1065,Saint-Gobain,2680,02,309,429,175,642,376,1193,738
1066,Saint-Gobert,2681,02,25,60,40,100,30,170,85
1067,Saint-Mard,2682,02,8,28,8,32,36,76,36
1068,Saint-Martin-Rivière,2683,02,24,32,20,28,24,72,56
1069,Saint-Michel,2684,02,383,955,330,1153,599,2082,1338
1070,Saint-Nicolas-aux-Bois,2685,02,12,16,8,52,16,76,28
1071,Saint-Paul-aux-Bois,2686,02,35,80,25,170,65,260,115
1072,Saint-Pierre-Aigle,2687,02,22,69,3,129,61,193,91
1073,Saint-Pierre-lès-Franqueville,2688,02,0,21,0,30,0,30,21
1074,Saint-Pierremont,2689,02,12,9,3,6,13,22,21
1075,Sainte-Preuve,2690,02,15,15,0,35,20,55,30
1076,Saint-Quentin,2691,02,7163,13580,7257,16805,9660,33722,20743
1077,Saint-Rémy-Blanzy,2693,02,3,47,18,67,51,136,50
1078,Saint-Simon,2694,02,25,130,102,169,119,390,155
1079,Saint-Thibaut,2695,02,3,10,0,24,9,33,13
1080,Saint-Thomas,2696,02,25,10,0,35,20,55,35
1081,Samoussy,2697,02,30,85,35,160,55,250,115
1082,Sancy-les-Cheminots,2698,02,5,30,10,35,25,70,35
1083,Saponay,2699,02,8,67,20,93,51,164,75
1084,Saulchery,2701,02,80,192,105,200,143,448,272
1085,Savy,2702,02,44,122,50,260,79,389,166
1086,Seboncourt,2703,02,124,288,108,320,200,628,412
1087,Selens,2704,02,4,57,12,81,45,138,61
1088,La Selve,2705,02,10,60,50,80,25,155,70
1089,Septmonts,2706,02,60,140,45,180,120,345,200
1090,Septvaux,2707,02,12,40,3,52,31,86,52
1091,Sequehart,2708,02,35,45,10,105,20,135,80
1092,Serain,2709,02,44,96,52,164,56,272,140
1093,Seraucourt-le-Grand,2710,02,95,230,80,255,150,485,325
1094,Serches,2711,02,25,85,55,75,70,200,110
1095,Sergy,2712,02,10,40,10,55,30,95,50
1096,Seringes-et-Nesles,2713,02,15,62,21,93,52,166,77
1097,Sermoise,2714,02,19,84,40,126,30,196,103
1098,Serval,2715,02,10,5,10,5,10,25,15
1099,Servais,2716,02,30,61,20,105,71,196,91
1100,Séry-lès-Mézières,2717,02,80,150,45,210,100,355,230
1101,Silly-la-Poterie,2718,02,9,25,0,47,26,73,34
1102,Sinceny,2719,02,314,481,146,744,366,1256,795
1103,Sissonne,2720,02,241,490,135,618,311,1064,731
1104,Sissy,2721,02,52,87,23,189,63,275,139
1105,Soissons,2722,02,3879,6827,3526,8374,4880,16780,10706
1106,Soize,2723,02,4,25,29,28,8,65,29
1107,Sommelans,2724,02,0,12,4,32,8,44,12
1108,Sommeron,2725,02,8,35,12,33,39,84,43
1109,Sommette-Eaucourt,2726,02,30,48,8,51,22,81,78
1110,Sons-et-Ronchères,2727,02,20,30,25,79,29,133,50
1111,Sorbais,2728,02,40,88,8,96,64,168,128
1112,Soucy,2729,02,20,20,10,40,10,60,40
1113,Soupir,2730,02,19,63,26,79,43,148,82
1114,Le Sourd,2731,02,15,24,9,49,32,90,39
1115,Surfontaine,2732,02,9,31,6,22,17,45,40
1116,Suzy,2733,02,12,80,20,140,44,204,92
1117,Taillefontaine,2734,02,36,49,6,78,58,142,85
1118,Tannières,2735,02,8,0,0,4,0,4,8
1119,Tartiers,2736,02,15,50,15,55,40,110,65
1120,Tavaux-et-Pontséricourt,2737,02,50,140,55,220,105,380,190
1121,Tergnier,2738,02,1749,3456,1554,4425,2379,8358,5205
1122,Terny-Sorny,2739,02,32,92,16,80,88,184,124
1123,Thenailles,2740,02,15,55,10,130,40,180,70
1124,Thenelles,2741,02,85,150,75,150,105,330,235
1125,Thiernu,2742,02,15,6,13,38,6,57,21
1126,Le Thuel,2743,02,24,52,8,60,24,92,76
1127,Torcy-en-Valois,2744,02,4,20,24,48,8,80,24
1128,Toulis-et-Attencourt,2745,02,5,30,10,60,20,90,35
1129,Travecy,2746,02,75,180,75,190,160,425,255
1130,Trefcon,2747,02,12,20,8,40,12,60,32
1131,Trélou-sur-Marne,2748,02,120,195,80,355,190,625,315
1132,Troësnes,2749,02,10,55,20,90,55,165,65
1133,Trosly-Loire,2750,02,83,165,34,157,95,286,248
1134,Trucy,2751,02,40,30,20,20,30,70,70
1135,Tugny-et-Pont,2752,02,35,85,45,70,55,170,120
1136,Tupigny,2753,02,31,89,42,98,39,179,120
1137,Ugny-le-Gay,2754,02,52,17,14,37,8,59,69
1138,Urcel,2755,02,62,140,72,159,89,320,202
1139,Urvillers,2756,02,84,152,36,216,132,384,236
1140,Vadencourt,2757,02,83,149,76,153,72,301,232
1141,Vailly-sur-Aisne,2758,02,378,480,115,663,370,1148,858
1142,La Vallée-au-Blé,2759,02,35,80,35,50,75,160,115
1143,La Vallée-Mulâtre,2760,02,16,44,8,60,32,100,60
1144,Variscourt,2761,02,10,60,25,50,45,120,70
1145,Vassens,2762,02,15,45,45,66,5,116,60
1146,Vasseny,2763,02,9,60,9,46,48,103,69
1147,Vassogne,2764,02,0,4,16,29,8,53,4
1148,Vaucelles-et-Beffecourt,2765,02,12,62,4,80,56,140,74
1149,Vaudesson,2766,02,30,55,20,85,50,155,85
1150,Vauxrezis,2767,02,40,75,40,145,35,220,115
1151,Vauxaillon,2768,02,43,150,28,142,100,270,193
1152,Vaux-Andigny,2769,02,80,190,110,320,130,560,270
1153,Vauxbuin,2770,02,84,168,48,346,112,506,252
1154,Vaux-en-Vermandois,2772,02,13,17,12,45,20,77,30
1155,Vauxtin,2773,02,0,0,5,30,5,40,0
1156,Vendelles,2774,02,0,26,20,33,17,70,26
1157,Vendeuil,2775,02,77,210,72,339,130,541,287
1158,Vendhuile,2776,02,56,173,20,184,112,316,229
1159,Vendières,2777,02,10,55,5,60,40,105,65
1160,Vendresse-Beaulne,2778,02,18,26,3,18,26,47,44
1161,Vénérolles,2779,02,13,59,15,78,34,127,72
1162,Venizel,2780,02,119,380,129,343,308,780,499
1163,Verdilly,2781,02,15,110,29,217,95,341,125
1164,Le Verguier,2782,02,12,43,23,52,47,122,55
1165,Grand-Verly,2783,02,10,50,25,35,30,90,60
1166,Petit-Verly,2784,02,5,56,15,40,51,106,61
1167,Vermand,2785,02,139,236,62,338,198,598,375
1168,Verneuil-sous-Coucy,2786,02,10,15,20,40,25,85,25
1169,Verneuil-sur-Serre,2787,02,21,81,12,46,55,113,102
1170,Versigny,2788,02,70,120,45,170,65,280,190
1171,Vervins,2789,02,335,610,293,745,408,1446,945
1172,Vesles-et-Caumont,2790,02,20,65,10,60,75,145,85
1173,Veslud,2791,02,35,60,30,70,55,155,95
1174,Veuilly-la-Poterie,2792,02,32,40,4,48,24,76,72
1175,Vézaponin,2793,02,20,28,8,52,16,76,48
1176,Vézilly,2794,02,5,55,15,45,50,110,60
1177,Vic-sur-Aisne,2795,02,165,380,230,545,360,1135,545
1178,Vichel-Nanteuil,2796,02,8,30,4,16,20,40,38
1179,Viel-Arcy,2797,02,15,55,20,50,35,105,70
1180,Viels-Maisons,2798,02,92,321,112,277,270,659,413
1181,Vierzy,2799,02,30,130,35,115,125,275,160
1182,Viffort,2800,02,39,115,25,105,65,195,154
1183,Vigneux-Hocquet,2801,02,35,50,45,90,35,170,85
1184,La Ville-aux-Bois-lès-Dizy,2802,02,20,53,20,50,39,109,73
1185,La Ville-aux-Bois-lès-Pontavert,2803,02,6,38,6,44,27,77,44
1186,Villemontoire,2804,02,12,42,26,61,30,117,54
1187,Villeneuve-Saint-Germain,2805,02,294,627,298,775,465,1538,921
1188,Villeneuve-sur-Fère,2806,02,18,44,9,84,59,152,62
1189,Villequier-Aumont,2807,02,110,135,30,190,130,350,245
1190,Villeret,2808,02,45,95,25,105,45,175,140
1191,Villers-Agron-Aiguizy,2809,02,13,24,3,13,15,31,37
1192,Villers-Cotterêts,2810,02,1066,2921,1453,3191,2015,6659,3987
1193,Villers-Hélon,2812,02,10,70,20,90,45,155,80
1194,Villers-le-Sec,2813,02,44,104,36,40,48,124,148
1195,Villers-lès-Guise,2814,02,20,40,20,55,45,120,60
1196,Villers-Saint-Christophe,2815,02,60,90,45,165,70,280,150
1197,Villers-sur-Fère,2816,02,20,136,72,172,100,344,156
1198,Ville-Savoye,2817,02,4,12,8,40,0,48,16
1199,Villiers-Saint-Denis,2818,02,56,216,96,300,168,564,272
1200,Vincy-Reuil-et-Magny,2819,02,5,25,30,51,10,91,30
1201,Viry-Noureuil,2820,02,215,400,180,704,235,1119,615
1202,Vivaise,2821,02,75,202,55,236,151,442,277
1203,Vivières,2822,02,10,95,30,170,80,280,105
1204,Voharies,2823,02,25,20,10,20,10,40,45
1205,Vorges,2824,02,40,75,55,150,64,269,115
1206,Voulpaix,2826,02,28,120,40,124,92,256,148
1207,Voyenne,2827,02,42,73,17,57,67,141,115
1208,Vregny,2828,02,12,21,0,20,26,46,33
1209,Vuillery,2829,02,0,32,0,8,20,28,32
1210,Wassigny,2830,02,80,284,80,312,196,588,364
1211,Watigny,2831,02,15,88,33,129,55,217,103
1212,Wiège-Faty,2832,02,20,56,32,72,32,136,76
1213,Wimy,2833,02,60,124,39,120,71,230,184
1214,Wissignicourt,2834,02,13,38,13,32,22,67,51
1215,Abrest,3001,03,355,652,182,996,581,1759,1007
1216,Agonges,3002,03,40,75,30,130,50,210,115
1217,Ainay-le-Château,3003,03,184,164,88,388,148,624,348
1218,Andelaroche,3004,03,75,85,15,80,30,125,160
1219,Archignat,3005,03,40,80,45,108,60,213,120
1220,Arfeuilles,3006,03,100,136,52,296,104,452,236
1221,Arpheuilles-Saint-Priest,3007,03,60,72,16,132,76,224,132
1222,Arronnes,3008,03,62,62,8,137,34,179,124
1223,Aubigny,3009,03,25,40,20,10,30,60,65
1224,Audes,3010,03,85,70,35,155,80,270,155
1225,Aurouër,3011,03,36,128,32,104,112,248,164
1226,Autry-Issards,3012,03,30,60,20,160,55,235,90
1227,Avermes,3013,03,631,770,334,1500,580,2414,1401
1228,Avrilly,3014,03,83,20,5,15,20,40,103
1229,Bagneux,3015,03,30,120,25,70,95,190,150
1230,Barberier,3016,03,15,30,15,60,15,90,45
1231,Barrais-Bussolles,3017,03,20,35,40,65,25,130,55
1232,Bayet,3018,03,80,200,45,215,125,385,280
1233,Beaulon,3019,03,308,344,148,560,288,996,652
1234,Beaune-d'Allier,3020,03,24,59,16,94,64,174,83
1235,Bègues,3021,03,9,49,15,87,40,142,58
1236,Bellenaves,3022,03,200,185,60,410,130,600,385
1237,Bellerive-sur-Allier,3023,03,2015,1575,540,2747,1186,4473,3590
1238,Bert,3024,03,56,52,12,92,32,136,108
1239,Bessay-sur-Allier,3025,03,140,298,110,569,220,899,438
1240,Besson,3026,03,106,183,41,178,191,410,289
1241,Bézenet,3027,03,148,268,52,296,228,576,416
1242,Billezois,3028,03,40,110,15,125,95,235,150
1243,Billy,3029,03,170,159,46,305,111,462,329
1244,Biozat,3030,03,78,214,84,201,182,467,292
1245,Bizeneuille,3031,03,55,55,5,120,45,170,110
1246,Blomard,3032,03,16,44,12,92,52,156,60
1247,Bost,3033,03,5,65,40,40,50,130,70
1248,Boucé,3034,03,81,116,47,140,65,252,197
1249,Le Bouchaud,3035,03,42,39,16,71,17,104,81
1250,Bourbon-l'Archambault,3036,03,368,404,239,936,323,1498,772
1251,Braize,3037,03,24,68,12,112,52,176,92
1252,Bransat,3038,03,104,100,56,148,88,292,204
1253,Bresnay,3039,03,45,87,13,81,74,168,132
1254,Bressolles,3040,03,168,222,48,428,140,616,390
1255,Le Brethon,3041,03,80,60,5,125,65,195,140
1256,Le Breuil,3042,03,100,95,50,250,40,340,195
1257,Broût-Vernet,3043,03,208,290,76,376,212,664,498
1258,Brugheas,3044,03,194,336,92,506,292,890,530
1259,Busset,3045,03,85,225,55,394,165,614,310
1260,Buxières-les-Mines,3046,03,185,167,68,371,162,601,352
1261,La Celle,3047,03,64,52,61,162,37,260,116
1262,Cérilly,3048,03,309,166,69,423,182,674,475
1263,Cesset,3049,03,68,88,44,148,56,248,156
1264,La Chabanne,3050,03,52,52,8,48,36,92,104
1265,Chambérat,3051,03,45,80,20,125,55,200,125
1266,Chamblet,3052,03,96,288,80,428,204,712,384
1267,Chantelle,3053,03,199,163,65,289,134,488,362
1268,Chapeau,3054,03,45,60,20,45,50,115,105
1269,La Chapelaude,3055,03,93,238,96,338,174,608,331
1270,La Chapelle,3056,03,60,75,15,160,55,230,135
1271,La Chapelle-aux-Chasses,3057,03,24,36,22,79,25,126,60
1272,Chappes,3058,03,12,52,40,76,24,140,64
1273,Chareil-Cintrat,3059,03,30,85,35,125,75,235,115
1274,Charmeil,3060,03,95,208,40,297,180,517,303
1275,Charmes,3061,03,50,105,25,120,100,245,155
1276,Charroux,3062,03,95,70,25,115,75,215,165
1277,Chassenard,3063,03,90,210,100,335,215,650,300
1278,Château-sur-Allier,3064,03,25,25,10,75,25,110,50
1279,Châtel-de-Neuvre,3065,03,92,136,28,160,140,328,228
1280,Châtel-Montagne,3066,03,105,40,25,149,40,214,145
1281,Châtelperron,3067,03,10,30,20,55,25,100,40
1282,Châtelus,3068,03,47,3,0,53,0,53,50
1283,Châtillon,3069,03,52,64,28,132,36,196,116
1284,Chavenon,3070,03,16,16,4,59,8,71,32
1285,Chavroches,3071,03,84,44,12,84,36,132,128
1286,Chazemais,3072,03,75,110,30,160,80,270,185
1287,Chemilly,3073,03,102,165,38,176,110,324,267
1288,Chevagnes,3074,03,113,148,21,208,116,345,261
1289,Chezelle,3075,03,16,56,3,57,29,89,72
1290,Chézy,3076,03,12,68,12,75,50,137,80
1291,Chirat-l'Église,3077,03,22,16,3,33,22,58,38
1292,Chouvigny,3078,03,41,18,15,84,15,114,59
1293,Cindré,3079,03,25,65,40,140,30,210,90
1294,Cognat-Lyonne,3080,03,72,172,88,232,156,476,244
1295,Colombier,3081,03,56,64,20,136,56,212,120
1296,Commentry,3082,03,1334,1112,496,2308,954,3758,2446
1297,Contigny,3083,03,69,117,29,246,83,358,186
1298,Cosne-d'Allier,3084,03,428,326,125,807,292,1224,754
1299,Coulandon,3085,03,55,135,70,293,100,463,190
1300,Coulanges,3086,03,12,84,8,137,52,197,96
1301,Couleuvre,3087,03,99,105,25,263,85,373,204
1302,Courçais,3088,03,75,55,45,120,35,200,130
1303,Coutansouze,3089,03,25,12,0,61,16,77,37
1304,Couzon,3090,03,30,54,12,99,39,150,84
1305,Créchy,3091,03,55,120,60,140,95,295,175
1306,Cressanges,3092,03,55,145,40,271,115,426,200
1307,Creuzier-le-Neuf,3093,03,120,287,94,397,237,728,407
1308,Creuzier-le-Vieux,3094,03,418,763,180,1367,553,2100,1181
1309,Cusset,3095,03,2160,2781,1199,4715,1934,7848,4941
1310,Deneuille-lès-Chantelle,3096,03,15,5,0,50,0,50,20
1311,Deneuille-les-Mines,3097,03,56,100,40,112,56,208,156
1312,Désertines,3098,03,836,771,229,1646,657,2532,1607
1313,Deux-Chaises,3099,03,84,88,32,152,56,240,172
1314,Diou,3100,03,220,297,90,488,271,849,517
1315,Domérat,3101,03,1695,1672,533,3378,1324,5235,3367
1316,Dompierre-sur-Besbre,3102,03,677,555,180,1077,480,1737,1232
1317,Le Donjon,3103,03,170,140,55,425,170,650,310
1318,Doyet,3104,03,175,253,128,412,194,734,428
1319,Droiturier,3105,03,40,55,20,148,70,238,95
1320,Durdat-Larequille,3106,03,145,300,70,525,235,830,445
1321,Ébreuil,3107,03,184,201,59,353,164,576,385
1322,Échassières,3108,03,50,95,35,125,40,200,145
1323,Escurolles,3109,03,61,206,48,225,149,422,267
1324,Espinasse-Vozelle,3110,03,75,210,65,365,208,638,285
1325,Estivareilles,3111,03,195,250,55,385,230,670,445
1326,Étroussat,3112,03,90,180,55,210,110,375,270
1327,Ferrières-sur-Sichon,3113,03,128,92,52,232,60,344,220
1328,La Ferté-Hauterive,3114,03,38,65,16,87,38,141,103
1329,Fleuriel,3115,03,55,70,5,150,55,210,125
1330,Fourilles,3116,03,36,33,0,36,49,85,69
1331,Franchesse,3117,03,73,77,50,111,78,239,150
1332,Gannat,3118,03,1006,1269,515,1616,1099,3230,2275
1333,Gannay-sur-Loire,3119,03,74,73,23,114,68,205,147
1334,Garnat-sur-Engièvre,3120,03,97,144,34,226,116,376,241
1335,Gennetines,3121,03,60,185,50,255,115,420,245
1336,Gipcy,3122,03,50,30,5,84,55,144,80
1337,Gouise,3124,03,50,55,5,45,57,107,105
1338,La Guillermie,3125,03,19,19,0,39,22,61,38
1339,Hauterive,3126,03,194,254,79,338,249,666,448
1340,Hérisson,3127,03,115,100,55,200,80,335,215
1341,Huriel,3128,03,400,624,224,876,553,1653,1024
1342,Hyds,3129,03,45,55,10,145,55,210,100
1343,Isle-et-Bardais,3130,03,62,34,13,86,22,121,96
1344,Isserpent,3131,03,104,96,60,164,84,308,200
1345,Jaligny-sur-Besbre,3132,03,137,100,35,168,72,275,237
1346,Jenzat,3133,03,90,105,35,180,100,315,195
1347,Laféline,3134,03,56,36,12,64,36,112,92
1348,Lalizolle,3135,03,59,62,9,109,37,155,121
1349,Lamaids,3136,03,20,52,20,62,38,120,72
1350,Langy,3137,03,28,52,36,100,52,188,80
1351,Lapalisse,3138,03,498,540,271,1059,401,1731,1038
1352,Laprugne,3139,03,58,40,25,145,26,196,98
1353,Lavault-Sainte-Anne,3140,03,245,220,55,375,180,610,465
1354,Lavoine,3141,03,36,28,8,52,44,104,64
1355,Lenax,3142,03,69,35,12,68,38,118,104
1356,Lételon,3143,03,30,25,0,20,25,45,55
1357,Liernolles,3144,03,40,24,6,79,19,104,64
1358,Lignerolles,3145,03,70,180,5,330,150,485,250
1359,Limoise,3146,03,20,15,25,80,20,125,35
1360,Loddes,3147,03,16,32,16,76,36,128,48
1361,Loriges,3148,03,17,94,37,71,83,191,111
1362,Louchy-Montfand,3149,03,26,79,17,168,90,275,105
1363,Louroux-Bourbonnais,3150,03,53,42,5,89,36,130,95
1364,Louroux-de-Beaune,3151,03,24,24,12,84,28,124,48
1365,Louroux-de-Bouble,3152,03,75,25,10,110,15,135,100
1366,Luneau,3154,03,20,69,45,135,30,210,89
1367,Lurcy-Lévis,3155,03,379,323,163,695,248,1106,702
1368,Lusigny,3156,03,205,430,80,615,360,1055,635
1369,Magnet,3157,03,66,244,67,304,189,560,310
1370,Haut-Bocage,3158,03,73,196,63,296,156,515,269
1371,Malicorne,3159,03,25,200,50,370,150,570,225
1372,Marcenat,3160,03,28,64,44,132,52,228,92
1373,Marcillat-en-Combraille,3161,03,124,193,52,314,128,494,317
1374,Marigny,3162,03,36,48,4,76,32,112,84
1375,Mariol,3163,03,78,172,64,273,158,495,250
1376,Le Mayet-d'École,3164,03,35,55,20,110,55,185,90
1377,Le Mayet-de-Montagne,3165,03,174,273,70,584,209,863,447
1378,Mazerier,3166,03,70,55,15,110,45,170,125
1379,Mazirat,3167,03,40,68,10,103,29,142,108
1380,Meaulne,3168,03,151,120,58,220,160,438,271
1381,Meillard,3169,03,33,58,33,104,36,173,91
1382,Meillers,3170,03,16,40,8,68,24,100,56
1383,Mercy,3171,03,36,46,29,85,16,130,82
1384,Mesples,3172,03,20,12,4,60,24,88,32
1385,Molinet,3173,03,192,252,136,428,176,740,444
1386,Molles,3174,03,104,208,84,244,212,540,312
1387,Monestier,3175,03,32,76,20,112,64,196,108
1388,Monétay-sur-Allier,3176,03,35,96,36,164,91,291,131
1389,Monétay-sur-Loire,3177,03,90,35,10,105,20,135,125
1390,Montaiguët-en-Forez,3178,03,60,50,15,155,25,195,110
1391,Montaigu-le-Blin,3179,03,60,45,10,160,40,210,105
1392,Montbeugny,3180,03,55,230,50,215,155,420,285
1393,Montcombroux-les-Mines,3181,03,65,55,10,165,25,200,120
1394,Monteignet-sur-l'Andelot,3182,03,25,60,0,125,55,180,85
1395,Le Montet,3183,03,58,71,28,107,78,213,129
1396,Montilly,3184,03,55,118,26,170,111,307,173
1397,Montluçon,3185,03,7134,7043,4136,11198,5691,21025,14177
1398,Montmarault,3186,03,345,276,134,391,203,728,621
1399,Montoldre,3187,03,52,124,56,152,84,292,176
1400,Montord,3188,03,16,39,37,82,12,131,55
1401,Montvicq,3189,03,116,142,27,237,111,375,258
1402,Moulins,3190,03,2978,3914,2646,5949,3309,11904,6892
1403,Murat,3191,03,29,53,4,117,44,165,82
1404,Nades,3192,03,32,32,8,16,36,60,64
1405,Nassigny,3193,03,10,70,15,60,40,115,80
1406,Naves,3194,03,25,9,0,46,9,55,34
1407,Néris-les-Bains,3195,03,432,477,142,1009,387,1538,909
1408,Neuilly-en-Donjon,3196,03,66,17,0,74,28,102,83
1409,Neuilly-le-Réal,3197,03,165,370,125,492,295,912,535
1410,Neure,3198,03,37,38,17,48,29,94,75
1411,Neuvy,3200,03,222,318,47,594,253,894,540
1412,Nizerolles,3201,03,72,84,12,80,96,188,156
1413,Noyant-d'Allier,3202,03,104,148,56,293,88,437,252
1414,Paray-le-Frésil,3203,03,63,55,19,171,45,235,118
1415,Paray-sous-Briailles,3204,03,55,170,30,200,165,395,225
1416,Périgny,3205,03,62,112,47,135,63,245,174
1417,La Petite-Marche,3206,03,25,37,12,55,15,82,62
1418,Pierrefitte-sur-Loire,3207,03,78,107,25,147,110,282,185
1419,Le Pin,3208,03,55,140,15,115,90,220,195
1420,Poëzat,3209,03,20,25,0,45,40,85,45
1421,Pouzy-Mésangy,3210,03,66,81,56,81,64,201,147
1422,Prémilhat,3211,03,453,429,113,931,329,1373,882
1423,Quinssaines,3212,03,130,370,80,591,315,986,500
1424,Reugny,3213,03,70,50,25,75,40,140,120
1425,Rocles,3214,03,22,87,20,123,38,181,109
1426,Rongères,3215,03,70,115,45,210,135,390,185
1427,Ronnet,3216,03,24,40,16,72,24,112,64
1428,Saint-Angel,3217,03,100,180,45,240,160,445,280
1429,Saint-Aubin-le-Monial,3218,03,35,50,40,120,30,190,85
1430,Saint-Bonnet-de-Four,3219,03,15,26,15,85,19,119,41
1431,Saint-Bonnet-de-Rochefort,3220,03,100,144,47,195,121,363,244
1432,Saint-Bonnet-Tronçais,3221,03,208,102,39,303,58,400,310
1433,Saint-Caprais,3222,03,9,23,3,42,3,48,32
1434,Saint-Christophe,3223,03,64,110,30,204,80,314,174
1435,Saint-Clément,3224,03,62,58,6,112,44,162,120
1436,Saint-Désiré,3225,03,64,96,32,180,56,268,160
1437,Saint-Didier-en-Donjon,3226,03,28,80,24,104,40,168,108
1438,Saint-Didier-la-Forêt,3227,03,52,88,16,128,92,236,140
1439,Saint-Éloy-d'Allier,3228,03,0,0,5,40,0,45,0
1440,Saint-Ennemond,3229,03,92,160,84,192,120,396,252
1441,Saint-Étienne-de-Vicq,3230,03,75,135,40,140,115,295,210
1442,Saint-Fargeol,3231,03,50,30,5,55,35,95,80
1443,Saint-Félix,3232,03,24,112,12,132,64,208,136
1444,Saint-Genest,3233,03,25,94,25,126,90,241,119
1445,Saint-Gérand-de-Vaux,3234,03,33,67,25,171,44,240,100
1446,Saint-Gérand-le-Puy,3235,03,148,228,44,264,212,520,376
1447,Saint-Germain-des-Fossés,3236,03,588,810,342,1265,619,2226,1398
1448,Saint-Germain-de-Salles,3237,03,70,95,15,165,85,265,165
1449,Saint-Hilaire,3238,03,71,112,34,128,98,260,183
1450,Saint-Léger-sur-Vouzance,3239,03,53,31,12,96,24,132,84
1451,Saint-Léon,3240,03,116,128,48,220,96,364,244
1452,Saint-Léopardin-d'Augy,3241,03,80,80,20,92,64,176,160
1453,Saint-Loup,3242,03,33,111,18,203,110,331,144
1454,Saint-Marcel-en-Murat,3243,03,25,25,5,66,15,86,50
1455,Saint-Marcel-en-Marcillat,3244,03,36,16,8,56,28,92,52
1456,Saint-Martin-des-Lais,3245,03,10,25,25,40,15,80,35
1457,Saint-Martinien,3246,03,48,160,52,176,152,380,208
1458,Saint-Menoux,3247,03,129,245,65,318,224,607,374
1459,Saint-Nicolas-des-Biefs,3248,03,20,32,4,76,28,108,52
1460,Saint-Palais,3249,03,50,20,0,75,10,85,70
1461,Saint-Pierre-Laval,3250,03,52,80,24,176,56,256,132
1462,Saint-Plaisir,3251,03,50,95,20,170,60,250,145
1463,Saint-Pont,3252,03,52,200,40,160,164,364,252
1464,Saint-Pourçain-sur-Besbre,3253,03,55,90,60,170,60,290,145
1465,Saint-Pourçain-sur-Sioule,3254,03,915,986,457,1618,646,2721,1901
1466,Saint-Priest-d'Andelot,3255,03,20,30,5,55,15,75,50
1467,Saint-Priest-en-Murat,3256,03,4,42,17,102,29,148,46
1468,Saint-Prix,3257,03,123,123,58,242,139,439,246
1469,Saint-Rémy-en-Rollat,3258,03,150,390,94,667,267,1028,540
1470,Saint-Sauvier,3259,03,80,72,24,136,60,220,152
1471,Saint-Sornin,3260,03,40,50,30,80,35,145,90
1472,Sainte-Thérence,3261,03,10,45,15,80,45,140,55
1473,Saint-Victor,3262,03,184,456,136,868,396,1400,640
1474,Saint-Voir,3263,03,10,50,15,65,40,120,60
1475,Saint-Yorre,3264,03,555,585,186,955,450,1591,1140
1476,Saligny-sur-Roudon,3265,03,145,124,67,218,84,369,269
1477,Sanssat,3266,03,39,49,26,65,39,130,88
1478,Saulcet,3267,03,85,190,30,295,105,430,275
1479,Saulzet,3268,03,40,88,12,148,72,232,128
1480,Sauvagny,3269,03,4,20,4,44,24,72,24
1481,Sazeret,3270,03,10,40,20,65,5,90,50
1482,Serbannes,3271,03,70,170,65,325,160,550,240
1483,Servilly,3272,03,21,48,37,103,39,179,69
1484,Seuillet,3273,03,17,135,30,193,84,307,152
1485,Sorbier,3274,03,55,90,5,110,60,175,145
1486,Souvigny,3275,03,227,416,172,703,254,1129,643
1487,Sussat,3276,03,12,20,8,56,16,80,32
1488,Target,3277,03,30,55,35,115,25,175,85
1489,Taxat-Senat,3278,03,56,48,20,64,32,116,104
1490,Teillet-Argenty,3279,03,85,165,60,110,140,310,250
1491,Terjat,3280,03,36,48,12,84,40,136,84
1492,Le Theil,3281,03,95,70,45,153,45,243,165
1493,Theneuille,3282,03,65,65,20,190,30,240,130
1494,Thiel-sur-Acolin,3283,03,81,232,78,441,188,707,313
1495,Thionne,3284,03,75,79,20,108,40,168,154
1496,Tortezais,3285,03,25,40,0,70,50,120,65
1497,Toulon-sur-Allier,3286,03,110,250,105,430,230,765,360
1498,Treban,3287,03,50,70,32,136,52,220,120
1499,Treignat,3288,03,76,112,36,136,84,256,188
1500,Treteau,3289,03,68,144,28,184,128,340,212
1501,Trévol,3290,03,201,400,100,656,257,1013,601
1502,Trézelles,3291,03,56,88,8,156,53,217,144
1503,Tronget,3292,03,134,165,95,314,125,534,299
1504,Urçay,3293,03,55,45,30,105,45,180,100
1505,Ussel-d'Allier,3294,03,32,12,28,52,16,96,44
1506,Valignat,3295,03,15,20,10,20,5,35,35
1507,Valigny,3296,03,62,64,9,162,46,217,126
1508,Vallon-en-Sully,3297,03,263,266,110,652,221,983,529
1509,Varennes-sur-Allier,3298,03,691,654,299,1249,442,1990,1345
1510,Varennes-sur-Tèche,3299,03,35,70,30,70,60,160,105
1511,Vaumas,3300,03,85,115,35,194,95,324,200
1512,Vaux,3301,03,95,275,100,379,200,679,370
1513,Veauce,3302,03,12,0,0,12,4,16,12
1514,Venas,3303,03,28,80,16,92,32,140,108
1515,Vendat,3304,03,275,530,90,855,425,1370,805
1516,Verneix,3305,03,85,150,45,180,120,345,235
1517,Le Vernet,3306,03,185,420,105,790,305,1200,605
1518,Verneuil-en-Bourbonnais,3307,03,32,56,16,100,44,160,88
1519,Vernusse,3308,03,55,35,20,30,35,85,90
1520,Le Veurdre,3309,03,90,125,50,140,60,250,215
1521,Vichy,3310,03,5530,4410,3198,7555,3892,14645,9940
1522,Vicq,3311,03,45,55,15,145,50,210,100
1523,Vieure,3312,03,50,55,5,95,55,155,105
1524,Le Vilhain,3313,03,46,36,6,79,46,131,82
1525,Villebret,3314,03,144,346,88,450,285,823,490
1526,Villefranche-d'Allier,3315,03,215,325,120,425,240,785,540
1527,Villeneuve-sur-Allier,3316,03,156,223,92,305,205,602,379
1528,Viplaix,3317,03,94,42,30,94,13,137,136
1529,Vitray,3318,03,13,9,6,31,15,52,22
1530,Voussac,3319,03,59,85,36,122,101,259,144
1531,Ygrande,3320,03,140,175,65,225,160,450,315
1532,Yzeure,3321,03,2105,2677,938,4557,1943,7438,4782
1533,Aiglun,4001,04,124,324,128,456,224,808,448
1534,Allemagne-en-Provence,4004,04,55,120,33,190,74,297,175
1535,Allons,4005,04,40,24,8,56,12,76,64
1536,Allos,4006,04,72,94,56,213,118,387,166
1537,Angles,4007,04,6,3,9,21,9,39,9
1538,Annot,4008,04,139,226,92,314,204,610,365
1539,Archail,4009,04,0,0,0,15,0,15,0
1540,Aubenas-les-Alpes,4012,04,10,20,10,35,15,60,30
1541,Aubignosc,4013,04,55,115,60,184,135,379,170
1542,Authon,4016,04,3,0,6,27,6,39,3
1543,Auzet,4017,04,4,24,4,48,12,64,28
1544,Banon,4018,04,181,175,85,369,131,585,356
1545,Barcelonnette,4019,04,398,453,276,828,516,1620,851
1546,Barles,4020,04,30,25,9,31,22,62,55
1547,Barras,4021,04,6,36,0,49,23,72,42
1548,Barrême,4022,04,39,100,55,192,65,312,139
1549,Bayons,4023,04,30,30,9,90,20,119,60
1550,Beaujeu,4024,04,15,15,35,60,20,115,30
1551,Beauvezer,4025,04,61,61,8,166,34,208,122
1552,Bellaffaire,4026,04,25,15,10,75,15,100,40
1553,Bevons,4027,04,10,40,45,130,10,185,50
1554,Beynes,4028,04,20,8,9,62,4,75,28
1555,Blieux,4030,04,20,0,0,30,5,35,20
1556,Bras-d'Asse,4031,04,96,152,40,180,124,344,248
1557,Braux,4032,04,42,9,0,32,9,41,51
1558,La Bréole,4033,04,56,63,19,79,43,141,119
1559,La Brillanne,4034,04,64,345,135,349,219,703,409
1560,Brunet,4035,04,21,64,16,83,43,142,85
1561,Le Brusquet,4036,04,115,230,85,429,115,629,345
1562,Le Caire,4037,04,8,0,16,44,0,60,8
1563,Castellane,4039,04,249,288,140,575,191,906,537
1564,Le Castellard-Mélan,4040,04,12,16,0,28,12,40,28
1565,Le Castellet,4041,04,20,70,10,134,50,194,90
1566,Castellet-lès-Sausses,4042,04,28,16,0,72,8,80,44
1567,Val-de-Chalvagne,4043,04,12,8,0,36,16,52,20
1568,Céreste,4045,04,292,270,55,384,175,614,562
1569,Le Chaffaut-Saint-Jurson,4046,04,55,160,55,270,135,460,215
1570,Champtercier,4047,04,75,168,48,216,138,402,243
1571,Château-Arnoux-Saint-Auban,4049,04,1101,1058,439,1741,789,2969,2159
1572,Châteaufort,4050,04,0,5,0,28,5,33,5
1573,Châteauneuf-Miravail,4051,04,12,12,12,20,8,40,24
1574,Châteauneuf-Val-Saint-Donat,4053,04,55,104,24,187,77,288,159
1575,Châteauredon,4054,04,3,9,15,35,6,56,12
1576,Chaudon-Norante,4055,04,48,24,16,64,24,104,72
1577,Clamensane,4057,04,40,60,0,55,35,90,100
1578,Claret,4058,04,29,77,29,65,52,146,106
1579,Clumanc,4059,04,16,57,4,73,40,117,73
1580,Colmars,4061,04,52,84,40,132,92,264,136
1581,La Condamine-Châtelard,4062,04,20,32,0,62,47,109,52
1582,Corbières,4063,04,144,283,84,344,204,632,427
1583,Cruis,4065,04,144,104,76,260,64,400,248
1584,Curbans,4066,04,38,123,60,193,104,357,161
1585,Curel,4067,04,4,16,0,44,0,44,20
1586,Dauphin,4068,04,75,182,33,339,117,489,257
1587,Demandolx,4069,04,25,20,8,29,28,65,45
1588,Digne-les-Bains,4070,04,2746,3485,1486,5435,2584,9505,6231
1589,Draix,4072,04,4,20,0,35,35,70,24
1590,Enchastrayes,4073,04,70,32,35,160,34,229,102
1591,Entrages,4074,04,6,12,9,47,9,65,18
1592,Entrepierres,4075,04,85,70,30,125,75,230,155
1593,Entrevaux,4076,04,115,170,40,345,144,529,285
1594,Entrevennes,4077,04,25,15,10,50,30,90,40
1595,L'Escale,4079,04,184,324,96,512,272,880,508
1596,Esparron-de-Verdon,4081,04,112,52,36,176,52,264,164
1597,Estoublon,4084,04,93,99,39,221,50,310,192
1598,Faucon-du-Caire,4085,04,0,25,5,20,10,35,25
1599,Faucon-de-Barcelonnette,4086,04,20,75,30,120,40,190,95
1600,Fontienne,4087,04,0,25,25,70,15,110,25
1601,Forcalquier,4088,04,851,975,374,1681,690,2745,1826
1602,Le Fugeret,4090,04,12,31,12,73,30,115,43
1603,Ganagobie,4091,04,3,12,9,32,6,47,15
1604,La Garde,4092,04,10,5,5,25,20,50,15
1605,Gigors,4093,04,15,5,0,20,0,20,20
1606,Gréoux-les-Bains,4094,04,510,570,200,925,385,1510,1080
1607,L'Hospitalet,4095,04,12,12,4,60,4,68,24
1608,Jausiers,4096,04,137,250,123,391,174,688,387
1609,La Javie,4097,04,50,90,35,130,70,235,140
1610,Lambruisse,4099,04,20,15,0,55,15,70,35
1611,Lardiers,4101,04,16,18,3,31,21,55,34
1612,Le Lauzet-Ubaye,4102,04,23,46,17,71,38,126,69
1613,Limans,4104,04,21,37,12,106,40,158,58
1614,Lurs,4106,04,83,80,30,165,35,230,163
1615,Majastres,4107,04,3,0,0,0,0,0,3
1616,Malijai,4108,04,210,520,165,670,345,1180,730
1617,Mallefougasse-Augès,4109,04,20,64,16,120,80,216,84
1618,Mallemoisson,4110,04,99,225,93,355,178,626,324
1619,Mane,4111,04,151,253,118,486,205,809,404
1620,Manosque,4112,04,3895,4901,2132,6679,3641,12452,8796
1621,Marcoux,4113,04,64,112,16,216,96,328,176
1622,Méailles,4115,04,15,25,10,55,15,80,40
1623,Les Mées,4116,04,470,882,390,1120,685,2195,1352
1624,Melve,4118,04,0,13,6,63,9,78,13
1625,Val d'Oronaye,4120,04,18,11,12,59,0,71,29
1626,Mézel,4121,04,65,186,45,250,135,430,251
1627,Mirabeau,4122,04,70,100,50,145,125,320,170
1628,Mison,4123,04,126,220,76,403,204,683,346
1629,Montagnac-Montpezat,4124,04,103,67,35,141,39,215,170
1630,Montclar,4126,04,60,90,30,168,90,288,150
1631,Montfort,4127,04,90,60,20,100,55,175,150
1632,Montfuron,4128,04,16,59,8,60,53,121,75
1633,Montjustin,4129,04,20,12,0,20,4,24,32
1634,Montlaux,4130,04,31,36,5,51,25,81,67
1635,Montsalier,4132,04,20,8,4,69,8,81,28
1636,Moriez,4133,04,48,28,16,96,24,136,76
1637,La Motte-du-Caire,4134,04,65,106,63,152,98,313,171
1638,Moustiers-Sainte-Marie,4135,04,107,115,63,228,96,387,222
1639,La Mure-Argens,4136,04,64,72,4,140,52,196,136
1640,Nibles,4137,04,0,0,5,30,10,45,0
1641,Niozelles,4138,04,36,68,12,88,68,168,104
1642,Noyers-sur-Jabron,4139,04,32,117,24,200,85,309,149
1643,Les Omergues,4140,04,25,25,0,58,15,73,50
1644,Ongles,4141,04,64,35,17,177,18,212,99
1645,Oppedette,4142,04,15,0,5,15,0,20,15
1646,Oraison,4143,04,963,1274,520,1820,977,3317,2237
1647,La Palud-sur-Verdon,4144,04,56,48,20,136,68,224,104
1648,Peipin,4145,04,145,360,115,535,240,890,505
1649,Peyroules,4148,04,39,60,5,94,35,134,99
1650,Peyruis,4149,04,422,656,293,909,411,1613,1078
1651,Piégut,4150,04,15,55,15,30,45,90,70
1652,Pierrerue,4151,04,59,90,25,204,85,314,149
1653,Pierrevert,4152,04,559,746,255,1472,600,2327,1305
1654,Pontis,4154,04,18,0,17,24,4,45,18
1655,Prads-Haute-Bléone,4155,04,60,16,4,72,24,100,76
1656,Puimichel,4156,04,22,23,15,97,25,137,45
1657,Puimoisson,4157,04,83,160,64,241,130,435,243
1658,Quinson,4158,04,84,76,32,196,64,292,160
1659,Redortiers,4159,04,0,0,16,36,0,52,0
1660,Reillanne,4160,04,266,299,145,613,193,951,565
1661,Méolans-Revel,4161,04,25,57,8,132,49,189,82
1662,Revest-des-Brousses,4162,04,44,52,24,112,36,172,96
1663,Revest-du-Bion,4163,04,125,90,10,210,90,310,215
1664,Revest-Saint-Martin,4164,04,3,9,0,35,3,38,12
1665,Riez,4166,04,342,347,129,547,273,949,689
1666,La Robine-sur-Galabre,4167,04,30,57,13,107,38,158,87
1667,La Rochegiron,4169,04,16,12,12,52,4,68,28
1668,La Rochette,4170,04,20,15,0,35,5,40,35
1669,Rougon,4171,04,20,15,0,50,15,65,35
1670,Roumoules,4172,04,86,155,61,257,123,441,241
1671,Saint-André-les-Alpes,4173,04,167,163,59,353,93,505,330
1672,Saint-Benoît,4174,04,17,20,13,38,34,85,37
1673,Sainte-Croix-à-Lauze,4175,04,8,18,0,42,8,50,26
1674,Sainte-Croix-du-Verdon,4176,04,15,15,0,49,24,73,30
1675,Hautes-Duyes,4177,04,0,8,0,20,8,28,8
1676,Saint-Étienne-les-Orgues,4178,04,276,236,44,520,160,724,512
1677,Saint-Geniez,4179,04,19,5,5,55,0,60,24
1678,Saint-Jacques,4180,04,12,32,0,24,8,32,44
1679,Saint-Jeannet,4181,04,4,8,4,36,8,48,12
1680,Saint-Julien-d'Asse,4182,04,52,12,24,76,16,116,64
1681,Saint-Julien-du-Verdon,4183,04,30,20,15,70,20,105,50
1682,Saint-Jurs,4184,04,31,12,3,61,6,70,43
1683,Saint-Laurent-du-Verdon,4186,04,12,8,4,38,16,58,20
1684,Saint-Lions,4187,04,10,0,5,30,0,35,10
1685,Saint-Maime,4188,04,92,188,84,292,152,528,280
1686,Saint-Martin-de-Brômes,4189,04,94,115,25,238,95,358,209
1687,Saint-Martin-les-Eaux,4190,04,4,32,12,60,16,88,36
1688,Saint-Martin-lès-Seyne,4191,04,0,0,0,9,0,9,0
1689,Saint-Michel-l'Observatoire,4192,04,148,256,108,508,192,808,404
1690,Saint-Paul-sur-Ubaye,4193,04,52,25,12,61,9,82,77
1691,Saint-Pierre,4194,04,10,13,6,34,9,49,23
1692,Saint-Pons,4195,04,75,110,64,269,128,461,185
1693,Sainte-Tulle,4197,04,467,796,342,1040,551,1933,1263
1694,Saint-Vincent-les-Forts,4198,04,16,100,20,124,72,216,116
1695,Saint-Vincent-sur-Jabron,4199,04,30,50,5,65,50,120,80
1696,Salignac,4200,04,52,136,88,244,104,436,188
1697,Saumane,4201,04,23,9,3,34,15,52,32
1698,Sausses,4202,04,10,20,10,65,10,85,30
1699,Selonnet,4203,04,56,84,44,176,64,284,140
1700,Senez,4204,04,24,37,4,48,20,72,61
1701,Seyne,4205,04,261,240,65,514,195,774,501
1702,Sigonce,4206,04,24,76,18,185,57,260,100
1703,Sigoyer,4207,04,4,30,12,41,16,69,34
1704,Simiane-la-Rotonde,4208,04,75,123,26,221,89,336,198
1705,Sisteron,4209,04,1333,1499,729,2507,1069,4305,2832
1706,Soleilhas,4210,04,9,12,16,53,13,82,21
1707,Sourribes,4211,04,15,25,20,70,40,130,40
1708,Tartonne,4214,04,28,20,16,52,20,88,48
1709,Thèze,4216,04,36,36,20,80,44,144,72
1710,Thoard,4217,04,65,165,35,240,135,410,230
1711,Thorame-Basse,4218,04,40,49,0,87,21,108,89
1712,Thorame-Haute,4219,04,36,28,12,104,40,156,64
1713,Les Thuiles,4220,04,38,100,30,90,93,213,138
1714,Turriers,4222,04,65,30,25,85,45,155,95
1715,Ubraye,4224,04,20,10,0,55,10,65,30
1716,Uvernet-Fours,4226,04,98,94,42,211,86,339,192
1717,Vachères,4227,04,57,40,6,107,23,136,97
1718,Valavoire,4228,04,4,0,0,28,4,32,4
1719,Valbelle,4229,04,20,62,26,89,37,152,82
1720,Valensole,4230,04,495,716,250,1081,565,1896,1211
1721,Valernes,4231,04,15,62,10,93,32,135,77
1722,Vaumeilh,4233,04,45,80,25,100,35,160,125
1723,Venterol,4234,04,20,55,30,64,68,162,75
1724,Verdaches,4235,04,13,0,0,25,4,29,13
1725,Vergons,4236,04,17,23,3,38,22,63,40
1726,Le Vernet,4237,04,4,50,0,58,30,88,54
1727,Villars-Colmars,4240,04,21,25,28,139,8,175,46
1728,Villemus,4241,04,20,28,12,80,24,116,48
1729,Villeneuve,4242,04,443,1046,344,1335,835,2514,1489
1730,Volonne,4244,04,340,330,145,620,215,980,670
1731,Volx,4245,04,485,730,335,1060,490,1885,1215
1732,Abriès,5001,05,30,40,39,135,64,238,70
1733,Aiguilles,5003,05,35,63,45,112,55,212,98
1734,Ancelle,5004,05,136,192,80,312,164,556,328
1735,L'Argentière-la-Bessée,5006,05,311,512,226,712,433,1371,823
1736,Arvieux,5007,05,80,60,30,125,65,220,140
1737,Aspremont,5008,05,52,81,29,78,61,168,133
1738,Aspres-lès-Corps,5009,05,30,20,5,55,5,65,50
1739,Aspres-sur-Buëch,5010,05,183,163,90,249,137,476,346
1740,Avançon,5011,05,15,95,45,135,105,285,110
1741,Baratier,5012,05,90,119,68,155,81,304,209
1742,Barcillonnette,5013,05,16,28,16,56,36,108,44
1743,Barret-sur-Méouge,5014,05,35,15,5,101,15,121,50
1744,La Bâtie-Montsaléon,5016,05,12,44,8,128,28,164,56
1745,La Bâtie-Neuve,5017,05,249,632,229,795,522,1546,881
1746,La Bâtie-Vieille,5018,05,30,105,20,130,60,210,135
1747,La Beaume,5019,05,45,25,5,59,15,79,70
1748,Le Bersac,5021,05,20,20,10,70,20,100,40
1749,Bréziers,5022,05,29,49,6,50,43,99,78
1750,Briançon,5023,05,1277,2932,1177,3645,2426,7248,4209
1751,Bruis,5024,05,3,19,6,25,12,43,22
1752,Buissard,5025,05,16,52,16,53,45,114,68
1753,Ceillac,5026,05,28,45,27,103,46,176,73
1754,Cervières,5027,05,5,45,10,70,45,125,50
1755,Chabestan,5028,05,30,10,15,60,10,85,40
1756,Chabottes,5029,05,61,189,48,340,142,530,250
1757,Champcella,5031,05,21,29,8,75,21,104,50
1758,Champoléon,5032,05,28,44,4,20,52,76,72
1759,Chanousse,5033,05,10,5,0,15,10,25,15
1760,Châteauneuf-d'Oze,5035,05,8,0,8,4,0,12,8
1761,Châteauroux-les-Alpes,5036,05,136,268,96,344,260,700,404
1762,Châteauvieux,5037,05,40,116,28,209,76,313,156
1763,Château-Ville-Vieille,5038,05,45,80,55,95,50,200,125
1764,Chauffayer,5039,05,72,68,48,136,68,252,140
1765,Chorges,5040,05,352,664,208,980,556,1744,1016
1766,Les Costes,5043,05,24,44,4,72,24,100,68
1767,Crévoux,5044,05,12,36,0,56,24,80,48
1768,Crots,5045,05,120,252,76,372,184,632,372
1769,Embrun,5046,05,1068,1031,463,2314,851,3628,2099
1770,Éourres,5047,05,3,33,30,19,29,78,36
1771,L'Épine,5048,05,25,30,5,105,15,125,55
1772,Esparron,5049,05,6,6,6,22,0,28,12
1773,Espinasses,5050,05,117,125,60,175,95,330,242
1774,Étoile-Saint-Cyrice,5051,05,15,0,5,5,0,10,15
1775,Eygliers,5052,05,80,156,80,268,168,516,236
1776,Garde-Colombe,5053,05,161,74,18,203,49,270,235
1777,La Fare-en-Champsaur,5054,05,71,70,35,100,70,205,141
1778,La Faurie,5055,05,42,39,24,113,34,171,81
1779,Forest-Saint-Julien,5056,05,28,88,48,96,48,192,116
1780,Fouillouse,5057,05,12,56,12,85,42,139,68
1781,Freissinières,5058,05,40,45,20,55,50,125,85
1782,La Freissinouse,5059,05,39,230,78,255,165,498,269
1783,Furmeyer,5060,05,23,26,16,49,9,74,49
1784,Gap,5061,05,5942,9298,3965,12866,6855,23686,15240
1785,Le Glaizil,5062,05,45,20,25,65,25,115,65
1786,La Grave,5063,05,30,110,30,175,130,335,140
1787,La Chapelle-en-Valgaudémar,5064,05,22,10,0,43,0,43,32
1788,Guillestre,5065,05,415,515,240,720,345,1305,930
1789,La Haute-Beaume,5066,05,10,0,0,0,0,0,10
1790,Jarjayes,5068,05,19,89,18,137,95,250,108
1791,Laragne-Montéglin,5070,05,776,624,230,1085,494,1809,1400
1792,Lardier-et-Valença,5071,05,32,108,12,104,64,180,140
1793,Laye,5072,05,19,45,30,113,30,173,64
1794,Lazer,5073,05,20,65,30,200,35,265,85
1795,Lettret,5074,05,24,36,16,60,40,116,60
1796,Manteyer,5075,05,61,75,46,119,79,244,136
1797,Méreuil,5076,05,20,9,0,29,8,37,29
1798,Molines-en-Queyras,5077,05,90,35,20,125,45,190,125
1799,Monêtier-Allemont,5078,05,38,42,37,80,48,165,80
1800,Le Monêtier-les-Bains,5079,05,78,191,80,401,175,656,269
1801,Montbrand,5080,05,15,0,0,25,15,40,15
1802,Montclus,5081,05,5,20,10,25,10,45,25
1803,Mont-Dauphin,5082,05,0,30,9,30,39,78,30
1804,Montgardin,5084,05,50,105,20,170,90,280,155
1805,Montgenèvre,5085,05,36,144,76,168,108,352,180
1806,Montjay,5086,05,16,16,8,44,12,64,32
1807,Montmaur,5087,05,85,125,10,185,115,310,210
1808,Montmorin,5088,05,22,9,6,25,9,40,31
1809,Montrond,5089,05,3,11,3,30,12,45,14
1810,La Motte-en-Champsaur,5090,05,5,45,35,75,55,165,50
1811,Moydans,5091,05,15,5,0,20,5,25,20
1812,Neffes,5092,05,75,188,45,331,117,493,263
1813,Névache,5093,05,22,85,18,119,68,205,107
1814,Nossage-et-Bénévent,5094,05,0,8,0,8,4,12,8
1815,Le Noyer,5095,05,25,38,16,107,59,182,63
1816,Orcières,5096,05,70,133,57,250,136,443,203
1817,Orpierre,5097,05,84,21,28,121,45,194,105
1818,Les Orres,5098,05,93,120,75,201,65,341,213
1819,Oze,5099,05,0,24,0,48,28,76,24
1820,Pelleautier,5100,05,100,160,64,164,160,388,260
1821,Pelvoux,5101,05,56,96,44,144,124,312,152
1822,La Piarre,5102,05,9,18,3,15,18,36,27
1823,Le Poët,5103,05,134,170,60,269,90,419,304
1824,Poligny,5104,05,45,70,5,145,45,195,115
1825,Prunières,5106,05,56,48,8,144,52,204,104
1826,Puy-Saint-André,5107,05,40,130,5,205,95,305,170
1827,Puy-Saint-Eusèbe,5108,05,20,30,4,39,25,68,50
1828,Puy-Saint-Pierre,5109,05,52,140,36,156,106,298,192
1829,Puy-Saint-Vincent,5110,05,30,55,21,72,53,146,85
1830,Puy-Sanières,5111,05,24,52,20,101,36,157,76
1831,Rabou,5112,05,34,10,0,25,20,45,44
1832,Rambaud,5113,05,52,96,12,128,80,220,148
1833,Réallon,5114,05,47,44,16,72,33,121,91
1834,Remollon,5115,05,45,150,45,125,90,260,195
1835,Réotier,5116,05,15,45,10,100,45,155,60
1836,Ribeyret,5117,05,8,8,8,52,16,76,16
1837,Val Buëch-Méouge,5118,05,237,250,80,532,175,787,487
1838,Risoul,5119,05,39,108,43,320,96,459,147
1839,Ristolas,5120,05,0,15,3,15,27,45,15
1840,Rochebrune,5121,05,15,50,15,65,35,115,65
1841,La Roche-de-Rame,5122,05,80,205,40,300,205,545,285
1842,La Roche-des-Arnauds,5123,05,111,363,129,548,275,952,474
1843,La Rochette,5124,05,64,120,76,108,116,300,184
1844,Rosans,5126,05,58,63,16,167,51,234,121
1845,Rousset,5127,05,40,21,4,53,25,82,61
1846,Saint-André-d'Embrun,5128,05,118,135,29,240,119,388,253
1847,Saint-André-de-Rosans,5129,05,28,8,8,58,16,82,36
1848,Saint-Apollinaire,5130,05,17,31,4,50,24,78,48
1849,Saint-Auban-d'Oze,5131,05,8,18,13,33,4,50,26
1850,Saint-Bonnet-en-Champsaur,5132,05,210,545,120,755,385,1260,755
1851,Saint-Chaffrey,5133,05,165,354,89,601,367,1057,519
1852,Saint-Clément-sur-Durance,5134,05,17,63,13,107,57,177,80
1853,Sainte-Colombe,5135,05,30,0,0,15,0,15,30
1854,Saint-Crépin,5136,05,56,159,46,253,123,422,215
1855,Dévoluy,5139,05,130,160,95,411,221,727,290
1856,Saint-Étienne-le-Laus,5140,05,55,60,15,70,65,150,115
1857,Saint-Eusèbe-en-Champsaur,5141,05,18,26,3,53,22,78,44
1858,Saint-Firmin,5142,05,68,113,25,153,85,263,181
1859,Saint-Jacques-en-Valgodemard,5144,05,47,21,8,36,12,56,68
1860,Saint-Jean-Saint-Nicolas,5145,05,136,180,64,340,184,588,316
1861,Saint-Julien-en-Beauchêne,5146,05,43,10,10,54,15,79,53
1862,Saint-Julien-en-Champsaur,5147,05,76,100,16,112,60,188,176
1863,Saint-Laurent-du-Cros,5148,05,57,118,47,143,89,279,175
1864,Saint-Léger-les-Mélèzes,5149,05,59,55,30,80,50,160,114
1865,Sainte-Marie,5150,05,19,0,0,20,5,25,19
1866,Saint-Martin-de-Queyrières,5151,05,81,291,93,350,239,682,372
1867,Saint-Maurice-en-Valgodemard,5152,05,31,10,5,90,10,105,41
1868,Saint-Michel-de-Chaillol,5153,05,25,45,19,129,49,197,70
1869,Saint-Pierre-d'Argençon,5154,05,20,45,0,55,35,90,65
1870,Saint-Pierre-Avez,5155,05,0,0,0,18,0,18,0
1871,Saint-Sauveur,5156,05,48,108,36,180,64,280,156
1872,Saint-Véran,5157,05,56,45,15,85,30,130,101
1873,Le Saix,5158,05,20,5,0,44,10,54,25
1874,Saléon,5159,05,5,20,5,35,15,55,25
1875,Salérans,5160,05,6,14,6,40,9,55,20
1876,La Salle-les-Alpes,5161,05,143,230,73,353,189,615,373
1877,La Saulce,5162,05,147,365,107,339,231,677,512
1878,Le Sauze-du-Lac,5163,05,22,25,16,28,20,64,47
1879,Savines-le-Lac,5164,05,190,260,25,325,190,540,450
1880,Savournon,5165,05,34,55,12,78,35,125,89
1881,Serres,5166,05,320,219,80,363,163,606,539
1882,Sigottier,5167,05,4,27,8,28,12,48,31
1883,Sigoyer,5168,05,93,142,12,231,99,342,235
1884,Sorbiers,5169,05,10,5,5,15,10,30,15
1885,Tallard,5170,05,229,435,173,703,360,1236,664
1886,Théus,5171,05,50,30,15,65,55,135,80
1887,Trescléoux,5172,05,65,48,12,101,43,156,113
1888,Upaix,5173,05,76,53,67,154,33,254,129
1889,Val-des-Prés,5174,05,64,174,55,227,115,397,238
1890,Vallouise,5175,05,68,153,51,270,132,453,221
1891,Valserres,5176,05,12,60,12,76,72,160,72
1892,Vars,5177,05,70,134,75,174,143,392,204
1893,Ventavon,5178,05,43,110,26,161,88,275,153
1894,Veynes,5179,05,573,617,281,1019,529,1829,1190
1895,Les Vigneaux,5180,05,52,100,16,221,83,320,152
1896,Villar-d'Arêne,5181,05,20,88,20,88,96,204,108
1897,Villar-Loubière,5182,05,10,5,0,20,0,20,15
1898,Villar-Saint-Pancrace,5183,05,199,261,79,513,250,842,460
1899,Vitrolles,5184,05,20,52,28,64,36,128,72
1900,Aiglun,6001,06,12,12,4,32,20,56,24
1901,Amirat,6002,06,10,5,5,30,15,50,15
1902,Andon,6003,06,58,110,54,164,103,321,168
1903,Antibes,6004,06,14033,14423,8305,23429,14089,45823,28456
1904,Ascros,6005,06,25,25,10,50,45,105,50
1905,Aspremont,6006,06,234,426,257,976,265,1498,660
1906,Auribeau-sur-Siagne,6007,06,283,686,263,1227,519,2009,969
1907,Auvare,6008,06,6,0,6,18,0,24,6
1908,Bairols,6009,06,25,40,5,30,30,65,65
1909,Le Bar-sur-Loup,6010,06,372,650,312,987,572,1871,1022
1910,Beaulieu-sur-Mer,6011,06,781,609,384,1248,644,2276,1390
1911,Beausoleil,6012,06,1369,3159,1648,4333,2853,8834,4528
1912,Belvédère,6013,06,127,114,48,244,90,382,241
1913,Bendejun,6014,06,84,218,80,312,162,554,302
1914,Berre-les-Alpes,6015,06,190,283,100,518,215,833,473
1915,Beuil,6016,06,85,75,70,190,75,335,160
1916,Bézaudun-les-Alpes,6017,06,30,65,5,85,55,145,95
1917,Biot,6018,06,810,2549,1128,3272,2081,6481,3359
1918,Blausasc,6019,06,176,336,124,552,260,936,512
1919,La Bollène-Vésubie,6020,06,109,104,41,161,95,297,213
1920,Bonson,6021,06,88,216,36,220,184,440,304
1921,Bouyon,6022,06,28,136,36,140,140,316,164
1922,Breil-sur-Roya,6023,06,390,451,120,794,438,1352,841
1923,Briançonnet,6024,06,65,15,25,85,15,125,80
1924,Le Broc,6025,06,166,375,132,422,206,760,541
1925,Cabris,6026,06,268,250,73,561,135,769,518
1926,Cagnes-sur-Mer,6027,06,9394,8828,4640,15345,8611,28596,18222
1927,Caille,6028,06,44,100,24,196,64,284,144
1928,Cannes,6029,06,15890,13346,6853,23205,12160,42218,29236
1929,Le Cannet,6030,06,7979,8137,4109,13189,7935,25233,16116
1930,Cantaron,6031,06,208,248,156,504,204,864,456
1931,Cap-d'Ail,6032,06,658,998,365,1511,882,2758,1656
1932,Carros,6033,06,1113,3313,1115,3945,2337,7397,4426
1933,Castagniers,6034,06,216,317,128,581,252,961,533
1934,Castellar,6035,06,112,232,64,341,212,617,344
1935,Castillon,6036,06,45,70,35,170,60,265,115
1936,Caussols,6037,06,12,67,9,57,72,138,79
1937,Châteauneuf-Grasse,6038,06,465,712,240,1136,472,1848,1177
1938,Châteauneuf-Villevieille,6039,06,81,203,66,339,172,577,284
1939,Châteauneuf-d'Entraunes,6040,06,4,12,4,12,8,24,16
1940,Cipières,6041,06,42,76,8,131,74,213,118
1941,Clans,6042,06,124,164,24,152,108,284,288
1942,Coaraze,6043,06,80,176,48,332,188,568,256
1943,La Colle-sur-Loup,6044,06,965,1870,561,2932,1392,4885,2835
1944,Collongues,6045,06,12,24,0,44,12,56,36
1945,Colomars,6046,06,430,748,274,1291,551,2116,1178
1946,Conségudes,6047,06,4,20,8,40,24,72,24
1947,Contes,6048,06,904,1617,671,2457,1217,4345,2521
1948,Courmes,6049,06,10,10,30,75,5,110,20
1949,Coursegoules,6050,06,20,144,44,204,108,356,164
1950,La Croix-sur-Roudoule,6051,06,21,6,13,43,0,56,27
1951,Cuébris,6052,06,20,20,16,68,8,92,40
1952,Daluis,6053,06,35,25,15,55,20,90,60
1953,Drap,6054,06,484,1200,461,1137,800,2398,1684
1954,Duranus,6055,06,25,25,0,81,20,101,50
1955,Entraunes,6056,06,9,10,6,57,6,69,19
1956,L'Escarène,6057,06,346,524,236,740,415,1391,870
1957,Escragnolles,6058,06,70,125,60,245,115,420,195
1958,Èze,6059,06,345,436,219,909,468,1596,781
1959,Falicon,6060,06,345,430,180,730,240,1150,775
1960,Les Ferres,6061,06,17,8,20,24,8,52,25
1961,Fontan,6062,06,95,75,25,115,35,175,170
1962,Gars,6063,06,28,4,0,24,8,32,32
1963,Gattières,6064,06,500,1015,435,1395,705,2535,1515
1964,La Gaude,6065,06,789,1562,512,2568,1049,4129,2351
1965,Gilette,6066,06,145,375,133,512,282,927,520
1966,Gorbio,6067,06,140,232,124,444,196,764,372
1967,Gourdon,6068,06,40,100,40,131,80,251,140
1968,Grasse,6069,06,5504,12346,5255,15226,9825,30306,17850
1969,Gréolières,6070,06,44,132,36,268,112,416,176
1970,Guillaumes,6071,06,110,115,55,270,75,400,225
1971,Ilonse,6072,06,42,21,12,84,12,108,63
1972,Isola,6073,06,103,130,65,254,145,464,233
1973,Lantosque,6074,06,160,250,90,465,260,815,410
1974,Levens,6075,06,562,1199,345,1673,827,2845,1761
1975,Lieuche,6076,06,0,0,4,20,0,24,0
1976,Lucéram,6077,06,196,248,57,435,215,707,444
1977,Malaussène,6078,06,28,64,34,59,87,180,92
1978,Mandelieu-la-Napoule,6079,06,4868,3816,2385,7202,4092,13679,8684
1979,Marie,6080,06,10,20,15,60,15,90,30
1980,Le Mas,6081,06,25,25,15,75,20,110,50
1981,Massoins,6082,06,16,12,7,24,22,53,28
1982,Menton,6083,06,5567,5562,2413,9565,4889,16867,11129
1983,Mouans-Sartoux,6084,06,1448,2011,623,3430,1621,5674,3459
1984,Mougins,6085,06,2369,3904,1854,5708,3781,11343,6273
1985,Moulinet,6086,06,40,40,15,145,25,185,80
1986,Les Mujouls,6087,06,8,8,4,4,8,16,16
1987,Nice,6088,06,54973,72317,41952,103165,62524,207641,127290
1988,Opio,6089,06,302,519,201,839,363,1403,821
1989,Pégomas,6090,06,739,1837,757,2454,1666,4877,2576
1990,Peille,6091,06,214,535,184,759,451,1394,749
1991,Peillon,6092,06,205,322,133,507,286,926,527
1992,La Penne,6093,06,42,43,25,131,36,192,85
1993,Péone,6094,06,127,162,57,374,143,574,289
1994,Peymeinade,6095,06,1421,1808,592,2946,1182,4720,3229
1995,Pierlas,6096,06,18,0,16,33,16,65,18
1996,Pierrefeu,6097,06,32,56,24,132,48,204,88
1997,Puget-Rostang,6098,06,16,20,4,64,20,88,36
1998,Puget-Théniers,6099,06,174,449,252,533,320,1105,623
1999,Revest-les-Roches,6100,06,8,32,13,58,41,112,40
2000,Rigaud,6101,06,40,30,5,80,40,125,70
2001,Rimplas,6102,06,21,0,28,56,7,91,21
2002,Roquebillière,6103,06,316,292,168,628,216,1012,608
2003,Roquebrune-Cap-Martin,6104,06,2285,2478,1205,4194,2598,7997,4763
2004,Roquefort-les-Pins,6105,06,851,1671,406,2512,978,3896,2522
2005,Roquestéron,6106,06,90,163,79,180,93,352,253
2006,La Roque-en-Provence,6107,06,20,15,5,25,10,40,35
2007,La Roquette-sur-Siagne,6108,06,558,1352,455,1817,1038,3310,1910
2008,La Roquette-sur-Var,6109,06,66,186,71,307,199,577,252
2009,Roubion,6110,06,30,30,15,20,40,75,60
2010,Roure,6111,06,69,0,15,115,5,135,69
2011,Le Rouret,6112,06,511,1008,283,1366,704,2353,1519
2012,Sainte-Agnès,6113,06,97,247,101,451,173,725,344
2013,Saint-André-de-la-Roche,6114,06,575,1294,730,1548,1024,3302,1869
2014,Saint-Antonin,6115,06,37,5,0,58,0,58,42
2015,Saint-Auban,6116,06,72,36,12,80,32,124,108
2016,Saint-Blaise,6117,06,71,241,120,356,186,662,312
2017,Saint-Cézaire-sur-Siagne,6118,06,417,1050,287,1536,639,2462,1467
2018,Saint-Dalmas-le-Selvage,6119,06,35,15,0,45,15,60,50
2019,Saint-Étienne-de-Tinée,6120,06,196,220,114,441,277,832,416
2020,Saint-Jean-Cap-Ferrat,6121,06,321,276,103,634,256,993,597
2021,Saint-Jeannet,6122,06,452,921,324,1463,697,2484,1373
2022,Saint-Laurent-du-Var,6123,06,4532,5856,3025,9473,5853,18351,10388
2023,Saint-Léger,6124,06,24,4,0,32,0,32,28
2024,Saint-Martin-d'Entraunes,6125,06,24,16,16,36,12,64,40
2025,Saint-Martin-du-Var,6126,06,322,678,299,897,531,1727,1000
2026,Saint-Martin-Vésubie,6127,06,265,179,130,619,180,929,444
2027,Saint-Paul-de-Vence,6128,06,560,615,260,1421,505,2186,1175
2028,Saint-Sauveur-sur-Tinée,6129,06,76,72,20,112,60,192,148
2029,Saint-Vallier-de-Thiey,6130,06,252,967,318,1135,778,2231,1219
2030,Sallagriffon,6131,06,6,3,0,18,3,21,9
2031,Saorge,6132,06,80,52,32,154,25,211,132
2032,Sauze,6133,06,15,3,3,45,3,51,18
2033,Séranon,6134,06,52,112,36,164,112,312,164
2034,Sigale,6135,06,27,35,12,60,26,98,62
2035,Sospel,6136,06,377,966,217,1261,604,2082,1343
2036,Spéracèdes,6137,06,187,288,78,564,185,827,475
2037,Théoule-sur-Mer,6138,06,260,248,124,548,264,936,508
2038,Thiéry,6139,06,30,15,5,35,15,55,45
2039,Le Tignet,6140,06,469,768,254,1261,523,2038,1237
2040,Toudon,6141,06,32,76,20,116,72,208,108
2041,Touët-de-l'Escarène,6142,06,20,100,15,150,40,205,120
2042,Touët-sur-Var,6143,06,60,166,40,220,130,390,226
2043,La Tour,6144,06,72,164,32,192,92,316,236
2044,Tourette-du-Château,6145,06,29,16,8,28,21,57,45
2045,Tournefort,6146,06,8,34,16,42,25,83,42
2046,Tourrette-Levens,6147,06,499,1116,421,1700,788,2909,1615
2047,Tourrettes-sur-Loup,6148,06,573,733,335,1681,541,2557,1306
2048,La Trinité,6149,06,1270,2458,1007,3333,1893,6233,3728
2049,La Turbie,6150,06,391,647,262,1174,623,2059,1038
2050,Utelle,6151,06,109,193,85,218,179,482,302
2051,Valbonne,6152,06,806,3510,1960,4034,2234,8228,4316
2052,Valdeblore,6153,06,105,135,45,392,130,567,240
2053,Valderoure,6154,06,70,76,16,142,58,216,146
2054,Vallauris,6155,06,4645,5365,2680,8461,4680,15821,10010
2055,Venanson,6156,06,51,9,0,60,4,64,60
2056,Vence,6157,06,3159,3791,1629,6228,3061,10918,6950
2057,Villars-sur-Var,6158,06,78,158,45,210,143,398,236
2058,Villefranche-sur-Mer,6159,06,1169,877,316,1775,839,2930,2046
2059,Villeneuve-d'Entraunes,6160,06,32,0,4,28,0,32,32
2060,Villeneuve-Loubet,6161,06,1786,3015,1323,4524,2922,8769,4801
2061,La Brigue,6162,06,120,110,35,230,90,355,230
2062,Tende,6163,06,344,322,131,640,359,1130,666
2063,Accons,7001,07,50,85,25,165,65,255,135
2064,Ailhon,7002,07,60,136,33,195,111,339,196
2065,Aizac,7003,07,17,25,12,46,24,82,42
2066,Ajoux,7004,07,15,10,5,58,0,63,25
2067,Alba-la-Romaine,7005,07,215,365,91,419,229,739,580
2068,Albon-d'Ardèche,7006,07,56,36,8,40,24,72,92
2069,Alboussière,7007,07,132,302,36,304,220,560,434
2070,Alissas,7008,07,125,388,71,576,241,888,513
2071,Andance,7009,07,136,245,155,340,208,703,381
2072,Annonay,7010,07,2439,3487,1909,5149,2531,9589,5926
2073,Antraigues-sur-Volane,7011,07,57,65,22,215,60,297,122
2074,Arcens,7012,07,86,56,26,96,41,163,142
2075,Ardoix,7013,07,65,373,119,369,235,723,438
2076,Arlebosc,7014,07,61,58,16,96,48,160,119
2077,Arras-sur-Rhône,7015,07,40,170,35,155,105,295,210
2078,Asperjoc,7016,07,45,85,15,165,95,275,130
2079,Les Assions,7017,07,140,139,42,278,100,420,279
2080,Astet,7018,07,21,0,0,12,0,12,21
2081,Aubenas,7019,07,1988,2468,1332,3547,1797,6676,4456
2082,Aubignas,7020,07,44,124,40,148,112,300,168
2083,Baix,7022,07,103,278,110,284,251,645,381
2084,Balazuc,7023,07,72,44,12,164,80,256,116
2085,Banne,7024,07,135,100,25,295,85,405,235
2086,Barnas,7025,07,42,28,3,66,21,90,70
2087,Le Béage,7026,07,25,45,46,142,20,208,70
2088,Beauchastel,7027,07,248,470,100,467,401,968,718
2089,Beaulieu,7028,07,83,80,44,128,84,256,163
2090,Beaumont,7029,07,35,38,15,122,33,170,73
2091,Beauvène,7030,07,75,34,20,54,40,114,109
2092,Berrias-et-Casteljau,7031,07,100,196,24,248,152,424,296
2093,Berzème,7032,07,10,40,25,60,25,110,50
2094,Bessas,7033,07,25,33,28,55,38,121,58
2095,Bidon,7034,07,4,48,12,90,44,146,52
2096,Boffres,7035,07,80,148,68,236,124,428,228
2097,Bogy,7036,07,12,116,44,100,128,272,128
2098,Borée,7037,07,36,20,4,60,28,92,56
2099,Borne,7038,07,16,8,0,8,8,16,24
2100,Bozas,7039,07,45,55,20,90,40,150,100
2101,Boucieu-le-Roi,7040,07,55,55,10,134,35,179,110
2102,Boulieu-lès-Annonay,7041,07,276,536,176,739,393,1308,812
2103,Bourg-Saint-Andéol,7042,07,997,1704,778,2220,1131,4129,2701
2104,Brossainc,7044,07,0,77,8,59,73,140,77
2105,Burzet,7045,07,55,69,10,200,63,273,124
2106,Cellier-du-Luc,7047,07,35,15,0,20,10,30,50
2107,Chalencon,7048,07,49,65,15,115,69,199,114
2108,Le Chambon,7049,07,5,5,0,30,0,30,10
2109,Chambonas,7050,07,133,140,60,237,108,405,273
2110,Champagne,7051,07,48,184,64,148,144,356,232
2111,Champis,7052,07,32,148,64,208,128,400,180
2112,Chandolas,7053,07,116,68,36,156,88,280,184
2113,Chanéac,7054,07,30,40,25,110,35,170,70
2114,Charmes-sur-Rhône,7055,07,225,765,228,910,528,1666,990
2115,Charnas,7056,07,65,296,53,278,176,507,361
2116,Chassiers,7058,07,107,182,84,331,121,536,289
2117,Châteaubourg,7059,07,24,72,20,48,53,121,96
2118,Châteauneuf-de-Vernoux,7060,07,28,64,12,84,44,140,92
2119,Chauzon,7061,07,54,65,35,144,65,244,119
2120,Chazeaux,7062,07,28,20,0,24,24,48,48
2121,Cheminas,7063,07,10,105,35,120,100,255,115
2122,Le Cheylard,7064,07,448,560,210,1140,489,1839,1008
2123,Chirols,7065,07,29,40,22,82,44,148,69
2124,Chomérac,7066,07,301,697,284,1053,598,1935,998
2125,Colombier-le-Cardinal,7067,07,5,55,45,90,65,200,60
2126,Colombier-le-Jeune,7068,07,84,132,40,192,104,336,216
2127,Colombier-le-Vieux,7069,07,100,161,54,157,119,330,261
2128,Cornas,7070,07,314,535,185,783,387,1355,849
2129,Coucouron,7071,07,204,122,40,290,97,427,326
2130,Coux,7072,07,163,398,103,723,278,1104,561
2131,Le Crestet,7073,07,80,110,35,210,80,325,190
2132,Creysseilles,7074,07,8,35,4,63,18,85,43
2133,Cros-de-Géorand,7075,07,30,5,20,70,30,120,35
2134,Cruas,7076,07,303,769,330,750,642,1722,1072
2135,Darbres,7077,07,28,27,29,98,16,143,55
2136,Davézieux,7078,07,397,679,265,1227,412,1904,1076
2137,Désaignes,7079,07,145,229,133,395,199,727,374
2138,Devesset,7080,07,32,56,28,124,36,188,88
2139,Dompnac,7081,07,0,15,0,40,15,55,15
2140,Dornas,7082,07,30,55,15,74,40,129,85
2141,Dunière-sur-Eyrieux,7083,07,73,78,17,145,79,241,151
2142,Eclassan,7084,07,87,228,83,281,200,564,315
2143,Empurany,7085,07,94,114,23,183,97,303,208
2144,Étables,7086,07,64,256,76,272,168,516,320
2145,Fabras,7087,07,63,80,8,111,91,210,143
2146,Faugères,7088,07,16,8,16,48,16,80,24
2147,Félines,7089,07,108,410,176,519,295,990,518
2148,Flaviac,7090,07,160,272,140,420,184,744,432
2149,Fons,7091,07,12,66,22,140,58,220,78
2150,Freyssenet,7092,07,4,4,16,24,0,40,8
2151,Genestelle,7093,07,48,52,24,112,48,184,100
2152,Gilhac-et-Bruzac,7094,07,8,37,12,60,44,116,45
2153,Gilhoc-sur-Ormèze,7095,07,40,91,29,171,75,275,131
2154,Gluiras,7096,07,79,69,16,152,34,202,148
2155,Glun,7097,07,40,220,60,249,120,429,260
2156,Gourdon,7098,07,10,10,0,38,15,53,20
2157,Gras,7099,07,69,148,34,221,96,351,217
2158,Gravières,7100,07,75,80,15,145,80,240,155
2159,Grospierres,7101,07,160,180,56,288,172,516,340
2160,Guilherand-Granges,7102,07,2061,1982,1206,3648,1776,6630,4043
2161,Intres,7103,07,8,48,4,48,48,100,56
2162,Issamoulenc,7104,07,30,10,0,30,20,50,40
2163,Issanlas,7105,07,10,30,0,60,20,80,40
2164,Issarlès,7106,07,25,25,0,70,20,90,50
2165,Jaujac,7107,07,283,209,64,383,158,605,492
2166,Jaunac,7108,07,9,36,6,28,31,65,45
2167,Joannas,7109,07,41,55,15,110,36,161,96
2168,Joyeuse,7110,07,258,359,114,569,254,937,617
2169,Juvinas,7111,07,12,20,4,68,33,105,32
2170,Labastide-sur-Bésorgues,7112,07,32,62,4,72,46,122,94
2171,Labastide-de-Virac,7113,07,44,36,36,100,24,160,80
2172,Labatie-d'Andaure,7114,07,51,24,10,78,24,112,75
2173,Labeaume,7115,07,114,119,45,291,88,424,233
2174,Labégude,7116,07,315,304,114,429,222,765,619
2175,Lablachère,7117,07,328,364,176,816,276,1268,692
2176,Laboule,7118,07,35,25,0,55,25,80,60
2177,Le Lac-d'Issarlès,7119,07,49,45,15,75,55,145,94
2178,Lachamp-Raphaël,7120,07,36,12,0,28,12,40,48
2179,Lachapelle-Graillouse,7121,07,55,30,0,93,30,123,85
2180,Lachapelle-sous-Aubenas,7122,07,148,310,116,553,233,902,458
2181,Lachapelle-sous-Chanéac,7123,07,20,55,10,75,10,95,75
2182,Lafarre,7124,07,4,12,0,20,0,20,16
2183,Lagorce,7126,07,152,266,80,420,188,688,418
2184,Lalevade-d'Ardèche,7127,07,218,260,65,379,163,607,478
2185,Lalouvesc,7128,07,56,48,44,156,32,232,104
2186,Lamastre,7129,07,546,395,175,775,350,1300,941
2187,Lanarce,7130,07,21,8,13,92,38,143,29
2188,Lanas,7131,07,24,100,16,140,80,236,124
2189,Largentière,7132,07,214,391,101,542,244,887,605
2190,Larnas,7133,07,0,84,37,44,44,125,84
2191,Laurac-en-Vivarais,7134,07,184,230,75,314,160,549,414
2192,Laval-d'Aurelle,7135,07,12,12,6,24,0,30,24
2193,Laveyrune,7136,07,19,13,13,38,9,60,32
2194,Lavillatte,7137,07,19,3,6,27,6,39,22
2195,Lavilledieu,7138,07,249,494,154,745,346,1245,743
2196,Laviolle,7139,07,55,10,5,40,10,55,65
2197,Lemps,7140,07,47,236,38,302,123,463,283
2198,Lentillères,7141,07,45,50,5,65,60,130,95
2199,Lespéron,7142,07,28,60,40,132,52,224,88
2200,Limony,7143,07,80,176,56,276,128,460,256
2201,Loubaresse,7144,07,4,12,0,16,12,28,16
2202,Lussas,7145,07,122,263,66,433,175,674,385
2203,Lyas,7146,07,52,132,36,236,112,384,184
2204,Malarce-sur-la-Thines,7147,07,30,35,24,118,35,177,65
2205,Malbosc,7148,07,30,20,15,60,20,95,50
2206,Marcols-les-Eaux,7149,07,40,48,4,80,44,128,88
2207,Mariac,7150,07,96,86,45,275,75,395,182
2208,Mars,7151,07,40,65,15,80,50,145,105
2209,Mauves,7152,07,149,290,135,387,220,742,439
2210,Mayres,7153,07,74,40,5,114,30,149,114
2211,Mazan-l'Abbaye,7154,07,0,25,10,73,20,103,25
2212,Mercuer,7155,07,167,241,35,459,215,709,408
2213,Meyras,7156,07,104,216,82,360,188,630,320
2214,Meysse,7157,07,78,336,105,472,219,796,414
2215,Mézilhac,7158,07,25,0,0,55,0,55,25
2216,Mirabel,7159,07,28,135,90,218,125,433,163
2217,Monestier,7160,07,4,4,0,28,8,36,8
2218,Montpezat-sous-Bauzon,7161,07,156,137,57,261,132,450,293
2219,Montréal,7162,07,135,105,45,140,120,305,240
2220,Montselgues,7163,07,10,20,20,35,10,65,30
2221,Nonières,7165,07,25,55,15,81,45,141,80
2222,Nozières,7166,07,45,55,15,90,60,165,100
2223,Les Ollières-sur-Eyrieux,7167,07,117,205,59,335,153,547,322
2224,Orgnac-l'Aven,7168,07,78,85,48,248,58,354,163
2225,Ozon,7169,07,45,125,30,85,110,225,170
2226,Pailharès,7170,07,32,44,6,101,36,143,76
2227,Payzac,7171,07,133,100,5,179,101,285,233
2228,Peaugres,7172,07,144,493,152,794,374,1320,637
2229,Péreyres,7173,07,20,8,0,28,8,36,28
2230,Peyraud,7174,07,30,132,50,180,126,356,162
2231,Le Plagnal,7175,07,8,12,0,20,12,32,20
2232,Planzolles,7176,07,15,20,15,55,20,90,35
2233,Plats,7177,07,69,263,48,202,187,437,332
2234,Pont-de-Labeaume,7178,07,105,140,45,210,80,335,245
2235,Pourchères,7179,07,41,21,10,56,10,76,62
2236,Le Pouzin,7181,07,370,644,244,858,534,1636,1014
2237,Prades,7182,07,136,338,72,459,236,767,474
2238,Pradons,7183,07,79,75,16,174,62,252,154
2239,Pranles,7184,07,36,112,24,188,108,320,148
2240,Préaux,7185,07,52,176,46,242,88,376,228
2241,Privas,7186,07,1164,1643,810,2734,1244,4788,2807
2242,Prunet,7187,07,45,15,15,50,20,85,60
2243,Quintenas,7188,07,227,378,131,487,257,875,605
2244,Ribes,7189,07,71,63,12,67,58,137,134
2245,Rochecolombe,7190,07,25,50,20,75,50,145,75
2246,Rochemaure,7191,07,315,616,175,720,450,1345,931
2247,Rochepaule,7192,07,83,25,10,119,25,154,108
2248,Rocher,7193,07,36,27,19,54,12,85,63
2249,Rochessauve,7194,07,16,133,44,120,108,272,149
2250,La Rochette,7195,07,10,20,0,30,5,35,30
2251,Rocles,7196,07,15,75,23,100,55,178,90
2252,Roiffieux,7197,07,341,661,191,1020,495,1706,1002
2253,Rompon,7198,07,56,290,110,346,189,645,346
2254,Rosières,7199,07,315,255,70,360,190,620,570
2255,Le Roux,7200,07,23,5,0,14,10,24,28
2256,Ruoms,7201,07,527,299,163,675,241,1079,826
2257,Sablières,7202,07,25,20,0,49,30,79,45
2258,Sagnes-et-Goudoulet,7203,07,35,20,5,45,10,60,55
2259,Saint-Agrève,7204,07,358,401,299,934,362,1595,759
2260,Saint-Alban-d'Ay,7205,07,108,336,140,468,256,864,444
2261,Saint-Alban-en-Montagne,7206,07,16,8,0,33,8,41,24
2262,Saint-Alban-Auriolles,7207,07,170,170,134,410,140,684,340
2263,Saint-Andéol-de-Berg,7208,07,13,19,15,42,9,66,32
2264,Saint-Andéol-de-Fourchades,7209,07,20,8,4,24,4,32,28
2265,Saint-Andéol-de-Vals,7210,07,96,128,36,176,92,304,224
2266,Saint-André-de-Cruzières,7211,07,88,65,9,273,59,341,153
2267,Saint-André-en-Vivarais,7212,07,30,45,15,120,15,150,75
2268,Saint-André-Lachamp,7213,07,12,30,4,71,27,102,42
2269,Saint-Apollinaire-de-Rias,7214,07,8,32,36,72,32,140,40
2270,Saint-Barthélemy-le-Meil,7215,07,40,15,15,91,50,156,55
2271,Saint-Barthélemy-Grozon,7216,07,88,95,60,195,65,320,183
2272,Saint-Barthélemy-le-Plain,7217,07,70,215,115,300,125,540,285
2273,Saint-Basile,7218,07,20,57,12,131,52,195,77
2274,Saint-Bauzile,7219,07,4,76,53,76,76,205,80
2275,Saint-Christol,7220,07,19,22,0,45,14,59,41
2276,Saint-Cierge-la-Serre,7221,07,50,75,10,75,50,135,125
2277,Saint-Cierge-sous-le-Cheylard,7222,07,20,40,10,95,30,135,60
2278,Saint-Cirgues-de-Prades,7223,07,21,29,16,34,17,67,50
2279,Saint-Cirgues-en-Montagne,7224,07,30,70,20,76,39,135,100
2280,Saint-Clair,7225,07,142,268,56,340,176,572,410
2281,Saint-Clément,7226,07,30,25,10,35,5,50,55
2282,Saint-Cyr,7227,07,84,360,155,484,260,899,444
2283,Saint-Désirat,7228,07,115,180,115,330,120,565,295
2284,Saint-Didier-sous-Aubenas,7229,07,114,235,80,314,200,594,349
2285,Saint-Étienne-de-Boulogne,7230,07,20,100,16,172,72,260,120
2286,Saint-Étienne-de-Fontbellon,7231,07,452,543,184,942,432,1558,995
2287,Saint-Étienne-de-Lugdarès,7232,07,64,76,16,108,72,196,140
2288,Saint-Étienne-de-Serre,7233,07,16,76,12,72,56,140,92
2289,Saint-Étienne-de-Valoux,7234,07,28,92,28,60,72,160,120
2290,Sainte-Eulalie,7235,07,30,45,25,80,35,140,75
2291,Saint-Félicien,7236,07,261,172,48,358,148,554,433
2292,Saint-Fortunat-sur-Eyrieux,7237,07,96,202,64,236,140,440,298
2293,Saint-Genest-de-Beauzon,7238,07,44,44,28,104,68,200,88
2294,Saint-Genest-Lachamp,7239,07,26,14,3,38,0,41,40
2295,Saint-Georges-les-Bains,7240,07,221,568,127,734,408,1269,789
2296,Saint-Germain,7241,07,30,146,55,265,136,456,176
2297,Saint-Gineis-en-Coiron,7242,07,16,20,12,40,20,72,36
2298,Saint-Jacques-d'Atticieux,7243,07,30,93,15,100,83,198,123
2299,Saint-Jean-Chambre,7244,07,40,76,32,96,40,168,116
2300,Saint-Jean-de-Muzols,7245,07,409,495,181,958,318,1457,904
2301,Saint-Jean-le-Centenier,7247,07,95,154,57,174,131,362,249
2302,Saint-Jean-Roure,7248,07,28,92,12,80,72,164,120
2303,Saint-Jeure-d'Andaure,7249,07,40,24,0,0,32,32,64
2304,Saint-Jeure-d'Ay,7250,07,72,124,56,126,88,270,196
2305,Saint-Joseph-des-Bancs,7251,07,20,52,16,48,48,112,72
2306,Saint-Julien-Boutières,7252,07,52,44,12,48,48,108,96
2307,Saint-Julien-du-Gua,7253,07,30,40,4,83,33,120,70
2308,Saint-Julien-du-Serre,7254,07,72,205,72,341,147,560,277
2309,Saint-Julien-en-Saint-Alban,7255,07,153,391,87,445,349,881,544
2310,Saint-Julien-Labrousse,7256,07,35,60,35,145,45,225,95
2311,Saint-Julien-le-Roux,7257,07,4,16,4,45,12,61,20
2312,Saint-Julien-Vocance,7258,07,47,31,21,90,8,119,78
2313,Saint-Just-d'Ardèche,7259,07,160,473,112,560,379,1051,633
2314,Saint-Lager-Bressac,7260,07,82,254,47,303,150,500,336
2315,Saint-Laurent-du-Pape,7261,07,235,360,170,510,280,960,595
2316,Saint-Laurent-les-Bains,7262,07,12,16,15,35,12,62,28
2317,Saint-Laurent-sous-Coiron,7263,07,15,10,10,45,5,60,25
2318,Saint-Marcel-d'Ardèche,7264,07,255,493,193,990,431,1614,748
2319,Saint-Marcel-lès-Annonay,7265,07,125,425,135,349,355,839,550
2320,Sainte-Marguerite-Lafigère,7266,07,35,25,0,44,10,54,60
2321,Saint-Martial,7267,07,30,50,0,110,35,145,80
2322,Saint-Martin-d'Ardèche,7268,07,175,185,60,305,195,560,360
2323,Saint-Martin-de-Valamas,7269,07,200,175,94,404,122,620,375
2324,Saint-Martin-sur-Lavezon,7270,07,61,80,30,129,65,224,141
2325,Saint-Maurice-d'Ardèche,7272,07,35,55,25,125,40,190,90
2326,Saint-Maurice-d'Ibie,7273,07,55,65,5,60,45,110,120
2327,Saint-Maurice-en-Chalencon,7274,07,39,39,16,65,50,131,78
2328,Saint-Mélany,7275,07,24,32,8,28,32,68,56
2329,Saint-Michel-d'Aurance,7276,07,20,85,5,90,65,160,105
2330,Saint-Michel-de-Boulogne,7277,07,5,40,25,30,35,90,45
2331,Saint-Michel-de-Chabrillanoux,7278,07,35,70,30,165,55,250,105
2332,Saint-Montan,7279,07,176,522,100,620,430,1150,698
2333,Saint-Paul-le-Jeune,7280,07,172,204,40,436,136,612,376
2334,Saint-Péray,7281,07,1052,1796,519,2481,1370,4370,2848
2335,Saint-Pierre-de-Colombier,7282,07,65,60,5,125,30,160,125
2336,Saint-Pierre-la-Roche,7283,07,8,20,12,20,12,44,28
2337,Saint-Pierre-Saint-Jean,7284,07,55,15,0,60,10,70,70
2338,Saint-Pierre-sur-Doux,7285,07,21,0,13,49,0,62,21
2339,Saint-Pierreville,7286,07,82,80,30,154,77,261,162
2340,Saint-Pons,7287,07,28,88,40,92,44,176,116
2341,Saint-Priest,7288,07,105,332,55,502,216,773,437
2342,Saint-Privat,7289,07,240,415,140,516,223,879,655
2343,Saint-Prix,7290,07,25,80,40,95,35,170,105
2344,Saint-Remèze,7291,07,100,215,75,385,120,580,315
2345,Saint-Romain-d'Ay,7292,07,85,345,81,354,231,666,430
2346,Saint-Romain-de-Lerps,7293,07,68,230,40,260,225,525,298
2347,Saint-Sauveur-de-Cruzières,7294,07,49,83,31,195,105,331,132
2348,Saint-Sauveur-de-Montagut,7295,07,210,205,65,375,160,600,415
2349,Saint-Sernin,7296,07,180,377,84,631,259,974,557
2350,Saint-Sylvestre,7297,07,60,136,52,152,104,308,196
2351,Saint-Symphorien-sous-Chomérac,7298,07,60,187,56,315,116,487,247
2352,Saint-Symphorien-de-Mahun,7299,07,21,16,5,63,10,78,37
2353,Saint-Thomé,7300,07,64,100,40,136,92,268,164
2354,Saint-Victor,7301,07,115,179,89,346,133,568,294
2355,Saint-Vincent-de-Barrès,7302,07,48,220,78,301,128,507,268
2356,Saint-Vincent-de-Durfort,7303,07,40,55,5,75,60,140,95
2357,Salavas,7304,07,116,92,56,280,64,400,208
2358,Les Salelles,7305,07,57,51,4,135,56,195,108
2359,Sampzon,7306,07,24,48,0,112,36,148,72
2360,Sanilhac,7307,07,72,88,4,156,104,264,160
2361,Sarras,7308,07,323,547,147,558,410,1115,870
2362,Satillieu,7309,07,253,300,90,574,299,963,553
2363,Savas,7310,07,70,260,69,336,162,567,330
2364,Sceautres,7311,07,4,36,16,52,32,100,40
2365,Sécheras,7312,07,35,181,21,134,135,290,216
2366,Serrières,7313,07,149,250,145,244,239,628,399
2367,Silhac,7314,07,27,57,37,141,50,228,84
2368,La Souche,7315,07,82,62,4,130,48,182,144
2369,Soyons,7316,07,148,505,205,877,317,1399,653
2370,Talencieux,7317,07,80,292,80,336,252,668,372
2371,Tauriers,7318,07,20,40,12,80,32,124,60
2372,Le Teil,7319,07,1146,2064,700,2630,1636,4966,3210
2373,Thorrenc,7321,07,20,64,4,84,68,156,84
2374,Thueyts,7322,07,190,215,100,430,155,685,405
2375,Toulaud,7323,07,104,456,96,608,368,1072,560
2376,Tournon-sur-Rhône,7324,07,1359,2506,1146,3181,1871,6198,3865
2377,Ucel,7325,07,311,497,84,705,369,1158,808
2378,Usclades-et-Rieutord,7326,07,19,13,13,47,15,75,32
2379,Uzer,7327,07,61,76,75,155,60,290,137
2380,Vagnas,7328,07,95,115,40,220,70,330,210
2381,Valgorge,7329,07,58,94,5,134,68,207,152
2382,Vallon-Pont-d'Arc,7330,07,416,420,171,730,445,1346,836
2383,Vals-les-Bains,7331,07,730,605,287,1058,515,1860,1335
2384,Valvignères,7332,07,60,136,20,164,104,288,196
2385,Vanosc,7333,07,128,224,92,300,192,584,352
2386,Les Vans,7334,07,563,541,154,975,372,1501,1104
2387,Vaudevant,7335,07,28,44,8,84,24,116,72
2388,Vernon,7336,07,51,45,5,93,45,143,96
2389,Vernosc-lès-Annonay,7337,07,278,681,195,758,477,1430,959
2390,Vernoux-en-Vivarais,7338,07,329,386,183,591,230,1004,715
2391,Vesseaux,7339,07,184,509,112,544,400,1056,693
2392,Veyras,7340,07,240,325,110,629,200,939,565
2393,Villeneuve-de-Berg,7341,07,325,627,199,745,537,1481,952
2394,Villevocance,7342,07,145,262,100,429,228,757,407
2395,Vinezac,7343,07,116,298,117,466,267,850,414
2396,Vinzieux,7344,07,56,108,36,112,104,252,164
2397,Vion,7345,07,100,250,60,345,180,585,350
2398,Viviers,7346,07,400,827,395,1342,598,2335,1227
2399,Vocance,7347,07,93,122,46,167,89,302,215
2400,Vogüé,7348,07,138,244,98,296,160,554,382
2401,La Voulte-sur-Rhône,7349,07,741,1151,513,1549,950,3012,1892
2402,Acy-Romance,8001,08,30,65,40,220,25,285,95
2403,Aiglemont,8003,08,236,389,104,638,305,1047,625
2404,Aire,8004,08,21,53,17,72,26,115,74
2405,Alincourt,8005,08,20,35,10,38,40,88,55
2406,Alland'Huy-et-Sausseuil,8006,08,40,80,0,50,70,120,120
2407,Amagne,8008,08,76,204,76,196,168,440,280
2408,Ambly-Fleury,8010,08,6,25,6,50,12,68,31
2409,Anchamps,8011,08,20,50,15,75,65,155,70
2410,Angecourt,8013,08,15,101,5,160,106,271,116
2411,Annelles,8014,08,18,43,18,30,12,60,61
2412,Antheny,8015,08,15,20,10,35,9,54,35
2413,Aouste,8016,08,32,48,4,92,28,124,80
2414,Apremont,8017,08,49,25,20,25,5,50,74
2415,Ardeuil-et-Montfauxelles,8018,08,15,15,5,25,10,40,30
2416,Les Grandes-Armoises,8019,08,4,21,0,16,18,34,25
2417,Les Petites-Armoises,8020,08,0,20,10,15,15,40,20
2418,Arnicourt,8021,08,0,40,5,70,35,110,40
2419,Arreux,8022,08,25,78,16,100,77,193,103
2420,Artaise-le-Vivier,8023,08,12,12,6,12,0,18,24
2421,Asfeld,8024,08,120,280,110,400,175,685,400
2422,Attigny,8025,08,186,261,65,417,150,632,447
2423,Aubigny-les-Pothées,8026,08,45,105,20,95,80,195,150
2424,Auboncourt-Vauzelles,8027,08,12,29,8,16,28,52,41
2425,Aubrives,8028,08,110,195,90,275,195,560,305
2426,Auflance,8029,08,16,4,4,16,16,36,20
2427,Auge,8030,08,15,0,10,30,0,40,15
2428,Aure,8031,08,5,10,0,25,10,35,15
2429,Aussonce,8032,08,27,39,39,34,41,114,66
2430,Authe,8033,08,10,20,10,40,15,65,30
2431,Autrecourt-et-Pourron,8034,08,64,76,44,104,56,204,140
2432,Autruche,8035,08,12,8,0,12,8,20,20
2433,Autry,8036,08,30,35,5,55,10,70,65
2434,Auvillers-les-Forges,8037,08,76,252,96,256,144,496,328
2435,Avançon,8038,08,20,104,36,80,72,188,124
2436,Avaux,8039,08,30,114,35,133,104,272,144
2437,Les Ayvelles,8040,08,96,258,46,280,232,558,354
2438,Baâlons,8041,08,32,60,24,84,44,152,92
2439,Balaives-et-Butz,8042,08,15,60,10,80,45,135,75
2440,Balan,8043,08,188,336,192,604,264,1060,524
2441,Balham,8044,08,22,20,16,19,18,53,42
2442,Ballay,8045,08,16,63,22,96,55,173,79
2443,Banogne-Recouvrance,8046,08,35,50,10,30,40,80,85
2444,Barbaise,8047,08,12,8,8,52,4,64,20
2445,Barby,8048,08,48,100,25,140,44,209,148
2446,Bar-lès-Buzancy,8049,08,16,40,8,40,28,76,56
2447,Bayonville,8052,08,0,25,5,50,20,75,25
2448,Bazeilles,8053,08,224,513,196,594,349,1139,737
2449,Beaumont-en-Argonne,8055,08,50,110,20,195,65,280,160
2450,Beffu-et-le-Morthomme,8056,08,10,20,5,10,10,25,30
2451,Belleville-et-Châtillon-sur-Bar,8057,08,20,70,20,115,35,170,90
2452,Belval,8058,08,37,48,9,49,50,108,85
2453,Belval-Bois-des-Dames,8059,08,5,5,5,20,5,30,10
2454,Bergnicourt,8060,08,16,80,48,60,80,188,96
2455,La Berlière,8061,08,4,20,0,8,16,24,24
2456,Bertoncourt,8062,08,4,32,16,56,24,96,36
2457,La Besace,8063,08,20,13,20,37,8,65,33
2458,Biermes,8064,08,26,68,38,81,50,169,94
2459,Bièvres,8065,08,10,20,10,20,5,35,30
2460,Bignicourt,8066,08,9,15,3,18,9,30,24
2461,Blagny,8067,08,194,328,127,360,223,710,522
2462,Blanchefosse-et-Bay,8069,08,32,44,0,44,52,96,76
2463,Blanzy-la-Salonnaise,8070,08,20,85,35,115,60,210,105
2464,Blombay,8071,08,8,30,20,33,22,75,38
2465,Bosseval-et-Briancourt,8072,08,29,96,25,138,82,245,125
2466,Bossus-lès-Rumigny,8073,08,30,20,5,30,15,50,50
2467,Bouconville,8074,08,5,5,0,25,10,35,10
2468,Boult-aux-Bois,8075,08,32,28,16,56,20,92,60
2469,Boulzicourt,8076,08,112,228,80,380,164,624,340
2470,Bourcq,8077,08,5,5,5,25,10,40,10
2471,Bourg-Fidèle,8078,08,70,250,65,245,220,530,320
2472,Boutancourt,8079,08,0,70,35,125,55,215,70
2473,Bouvellemont,8080,08,20,28,4,8,36,48,48
2474,Bogny-sur-Meuse,8081,08,643,1309,560,1608,954,3122,1952
2475,Brécy-Brières,8082,08,12,8,8,16,8,32,20
2476,Brévilly,8083,08,60,96,30,125,75,230,156
2477,Brienne-sur-Aisne,8084,08,24,52,16,28,60,104,76
2478,Brieulles-sur-Bar,8085,08,32,54,24,36,45,105,86
2479,Briquenay,8086,08,3,26,6,37,27,70,29
2480,Brognon,8087,08,15,25,15,55,30,100,40
2481,Bulson,8088,08,21,27,20,16,22,58,48
2482,Buzancy,8089,08,40,75,25,140,70,235,115
2483,Carignan,8090,08,500,647,228,963,479,1670,1147
2484,Cauroy,8092,08,20,55,5,45,60,110,75
2485,Cernion,8094,08,20,0,0,30,5,35,20
2486,Chagny,8095,08,14,50,10,45,50,105,64
2487,Chalandry-Elaire,8096,08,60,150,45,240,135,420,210
2488,Challerange,8097,08,86,101,45,146,75,266,187
2489,Champigneulle,8098,08,20,15,0,29,10,39,35
2490,Champigneul-sur-Vence,8099,08,10,35,10,35,20,65,45
2491,Champlin,8100,08,5,25,5,25,15,45,30
2492,La Chapelle,8101,08,15,35,5,75,35,115,50
2493,Chappes,8102,08,15,15,0,40,15,55,30
2494,Charbogne,8103,08,8,52,8,84,48,140,60
2495,Chardeny,8104,08,3,3,6,18,0,24,6
2496,Charleville-Mézières,8105,08,6307,11227,5927,14916,8405,29248,17534
2497,Charnois,8106,08,10,10,5,55,0,60,20
2498,Château-Porcien,8107,08,108,372,112,384,265,761,480
2499,Chatel-Chéhéry,8109,08,19,22,0,59,23,82,41
2500,Le Châtelet-sur-Sormonne,8110,08,20,30,25,75,20,120,50
2501,Le Châtelet-sur-Retourne,8111,08,56,239,57,194,179,430,295
2502,Chaumont-Porcien,8113,08,92,104,80,124,104,308,196
2503,Chémery-Chéhéry,8115,08,49,140,59,179,107,345,189
2504,Bairon et ses environs,8116,08,175,230,135,318,200,653,405
2505,Chesnois-Auboncourt,8117,08,9,40,20,75,35,130,49
2506,Cheveuges,8119,08,40,80,55,175,70,300,120
2507,Chevières,8120,08,6,6,0,18,6,24,12
2508,Chilly,8121,08,15,34,12,34,23,69,49
2509,Chooz,8122,08,99,147,61,214,150,425,246
2510,Chuffilly-Roche,8123,08,0,30,0,45,20,65,30
2511,Clavy-Warby,8124,08,30,85,54,124,65,243,115
2512,Cliron,8125,08,4,69,36,150,57,243,73
2513,Condé-lès-Herpy,8126,08,8,44,40,68,44,152,52
2514,Condé-lès-Autry,8128,08,0,20,16,28,28,72,20
2515,Contreuve,8130,08,16,8,8,16,16,40,24
2516,Cornay,8131,08,35,0,0,20,0,20,35
2517,Corny-Machéroménil,8132,08,20,45,15,70,15,100,65
2518,Coucy,8133,08,38,155,38,159,81,278,193
2519,Coulommes-et-Marqueny,8134,08,28,16,8,24,12,44,44
2520,La Croix-aux-Bois,8135,08,24,24,16,52,12,80,48
2521,Daigny,8136,08,32,80,36,116,88,240,112
2522,Damouzy,8137,08,36,87,8,164,64,236,123
2523,Les Deux-Villes,8138,08,20,90,30,70,40,140,110
2524,Deville,8139,08,189,270,130,355,115,600,459
2525,Dom-le-Mesnil,8140,08,155,234,128,299,157,584,389
2526,Dommery,8141,08,30,55,0,75,40,115,85
2527,Donchery,8142,08,257,527,194,670,442,1306,784
2528,Doumely-Bégny,8143,08,9,17,6,18,13,37,26
2529,Doux,8144,08,12,35,12,16,13,41,47
2530,Douzy,8145,08,212,653,168,540,495,1203,865
2531,Draize,8146,08,25,16,4,25,8,37,41
2532,Dricourt,8147,08,10,25,5,25,15,45,35
2533,L'Écaille,8148,08,12,80,12,48,76,136,92
2534,L'Échelle,8149,08,29,23,0,21,26,47,52
2535,Écly,8150,08,10,45,10,90,35,135,55
2536,Écordal,8151,08,21,78,36,105,48,189,99
2537,Élan,8152,08,5,30,0,20,25,45,35
2538,Escombres-et-le-Chesnois,8153,08,36,100,16,96,100,212,136
2539,Estrebay,8154,08,10,15,0,40,5,45,25
2540,Étalle,8155,08,8,26,4,37,8,49,34
2541,Éteignières,8156,08,45,125,60,165,110,335,170
2542,Étrépigny,8158,08,13,51,13,113,38,164,64
2543,Euilly-et-Lombut,8159,08,20,25,25,20,20,65,45
2544,Évigny,8160,08,30,35,25,58,50,133,65
2545,Exermont,8161,08,10,10,0,5,5,10,20
2546,Fagnon,8162,08,15,60,38,113,53,204,75
2547,Faissault,8163,08,28,60,28,92,36,156,88
2548,Falaise,8164,08,52,51,22,99,42,163,103
2549,Faux,8165,08,15,10,0,10,15,25,25
2550,Fépin,8166,08,45,85,5,90,45,140,130
2551,La Férée,8167,08,10,15,0,35,25,60,25
2552,La Ferté-sur-Chiers,8168,08,20,60,20,60,44,124,80
2553,Flaignes-Havys,8169,08,12,36,8,34,17,59,48
2554,Fleigneux,8170,08,16,55,4,79,39,122,71
2555,Fléville,8171,08,16,36,12,24,24,60,52
2556,Fligny,8172,08,30,35,25,60,15,100,65
2557,Flize,8173,08,107,262,114,393,190,697,369
2558,Floing,8174,08,373,513,251,880,373,1504,886
2559,Foisches,8175,08,20,50,0,115,35,150,70
2560,Fossé,8176,08,0,13,4,12,21,37,13
2561,Fraillicourt,8178,08,41,35,9,42,30,81,76
2562,Francheval,8179,08,32,160,41,200,126,367,192
2563,La Francheville,8180,08,169,381,139,676,225,1040,550
2564,Le Fréty,8182,08,10,15,10,20,10,40,25
2565,Fromelennes,8183,08,130,261,100,290,225,615,391
2566,Fromy,8184,08,20,25,5,30,15,50,45
2567,Fumay,8185,08,538,815,291,1208,528,2027,1353
2568,Germont,8186,08,0,10,0,25,10,35,10
2569,Gernelle,8187,08,18,78,12,106,61,179,96
2570,Gespunsart,8188,08,130,245,95,440,155,690,375
2571,Girondelle,8189,08,16,32,13,22,34,69,48
2572,Givet,8190,08,741,1523,904,2106,1212,4222,2264
2573,Givonne,8191,08,60,266,75,450,215,740,326
2574,Givron,8192,08,31,20,5,25,10,40,51
2575,Givry,8193,08,28,92,36,68,52,156,120
2576,Glaire,8194,08,83,180,55,340,150,545,263
2577,Gomont,8195,08,15,91,20,140,55,215,106
2578,Grandchamp,8196,08,12,8,9,29,16,54,20
2579,Grandham,8197,08,20,0,0,20,0,20,20
2580,Grandpré,8198,08,87,123,47,179,122,348,210
2581,La Grandville,8199,08,84,212,60,280,196,536,296
2582,Grivy-Loisy,8200,08,13,32,23,57,27,107,45
2583,Gruyères,8201,08,15,20,0,30,25,55,35
2584,Gué-d'Hossus,8202,08,30,105,30,225,105,360,135
2585,Guignicourt-sur-Vence,8203,08,0,95,35,90,100,225,95
2586,Guincourt,8204,08,10,15,5,45,15,65,25
2587,Hagnicourt,8205,08,0,26,0,12,24,36,26
2588,Ham-les-Moines,8206,08,20,95,15,155,60,230,115
2589,Ham-sur-Meuse,8207,08,20,50,10,120,40,170,70
2590,Hannappes,8208,08,18,26,6,44,15,65,44
2591,Hannogne-Saint-Martin,8209,08,28,128,21,134,121,276,156
2592,Hannogne-Saint-Rémy,8210,08,18,27,9,19,20,48,45
2593,Haraucourt,8211,08,112,168,68,244,152,464,280
2594,Harcy,8212,08,45,150,25,140,150,315,195
2595,Hargnies,8214,08,63,97,26,145,63,234,160
2596,Harricourt,8215,08,6,0,0,15,6,21,6
2597,Haudrecy,8216,08,40,76,16,84,72,172,116
2598,Haulmé,8217,08,17,26,0,10,32,42,43
2599,Les Hautes-Rivières,8218,08,262,300,125,589,232,946,562
2600,Hauteville,8219,08,10,25,10,25,25,60,35
2601,Hauviné,8220,08,32,92,28,92,64,184,124
2602,Haybes,8222,08,221,442,200,685,374,1259,663
2603,Herbeuval,8223,08,12,36,4,20,36,60,48
2604,Herpy-l'Arlésienne,8225,08,15,65,5,65,55,125,80
2605,Hierges,8226,08,34,45,20,65,30,115,79
2606,La Horgne,8228,08,0,70,20,70,45,135,70
2607,Houdilcourt,8229,08,12,36,12,48,40,100,48
2608,Houldizy,8230,08,0,100,35,153,85,273,100
2609,Illy,8232,08,42,71,33,158,54,245,113
2610,Imécourt,8233,08,0,10,0,20,15,35,10
2611,Inaumont,8234,08,0,12,17,20,21,58,12
2612,Issancourt-et-Rumel,8235,08,46,94,20,174,62,256,140
2613,Jandun,8236,08,30,75,30,90,65,185,105
2614,Joigny-sur-Meuse,8237,08,90,160,50,270,115,435,250
2615,Jonval,8238,08,8,22,8,25,18,51,30
2616,Juniville,8239,08,164,360,104,324,248,676,524
2617,Justine-Herbigny,8240,08,8,29,13,62,25,100,37
2618,Laifour,8242,08,75,60,25,210,85,320,135
2619,Lalobbe,8243,08,40,30,5,85,20,110,70
2620,Lametz,8244,08,10,10,15,35,5,55,20
2621,Lançon,8245,08,10,10,0,10,15,25,20
2622,Landres-et-Saint-Georges,8246,08,30,10,0,25,10,35,40
2623,Landrichamps,8247,08,26,15,9,41,25,75,41
2624,Launois-sur-Vence,8248,08,50,195,45,180,175,400,245
2625,Laval-Morency,8249,08,32,45,19,58,43,120,77
2626,Leffincourt,8250,08,31,53,4,43,40,87,84
2627,Lépron-les-Vallées,8251,08,0,28,8,40,24,72,28
2628,Létanne,8252,08,15,45,0,50,25,75,60
2629,Liart,8254,08,96,157,40,172,98,310,253
2630,Linay,8255,08,20,90,5,55,80,140,110
2631,Liry,8256,08,16,18,9,18,10,37,34
2632,Logny-Bogny,8257,08,24,40,48,56,20,124,64
2633,Longwé,8259,08,20,32,12,20,24,56,52
2634,Lonny,8260,08,17,173,89,195,91,375,190
2635,Lucquy,8262,08,53,163,89,135,110,334,216
2636,Lumes,8263,08,102,284,88,412,204,704,386
2637,Machault,8264,08,48,132,52,152,104,308,180
2638,Maisoncelle-et-Villers,8268,08,6,20,0,18,14,32,26
2639,Malandry,8269,08,8,20,12,24,12,48,28
2640,Manre,8271,08,38,22,4,17,16,37,60
2641,Maranwez,8272,08,5,10,15,15,10,40,15
2642,Marby,8273,08,20,10,10,25,5,40,30
2643,Marcq,8274,08,30,15,15,45,5,65,45
2644,Margny,8275,08,12,52,16,32,60,108,64
2645,Margut,8276,08,40,225,60,300,150,510,265
2646,Marlemont,8277,08,20,45,0,25,45,70,65
2647,Marquigny,8278,08,20,20,4,28,16,48,40
2648,Mars-sous-Bourcq,8279,08,5,15,10,15,5,30,20
2649,Marvaux-Vieux,8280,08,5,25,0,35,15,50,30
2650,Matton-et-Clémency,8281,08,66,82,55,131,44,230,148
2651,Maubert-Fontaine,8282,08,108,285,120,296,208,624,393
2652,Mazerny,8283,08,25,25,15,45,15,75,50
2653,Les Mazures,8284,08,96,246,88,251,183,522,342
2654,Ménil-Annelles,8286,08,9,15,12,33,6,51,24
2655,Ménil-Lépinois,8287,08,20,45,5,35,30,70,65
2656,Mesmont,8288,08,0,15,5,45,30,80,15
2657,Messincourt,8289,08,32,200,64,188,128,380,232
2658,Mogues,8291,08,4,53,24,40,32,96,57
2659,Moiry,8293,08,40,50,10,40,35,85,90
2660,La Moncelle,8294,08,9,17,8,72,8,88,26
2661,Mondigny,8295,08,5,45,20,65,30,115,50
2662,Montcheutin,8296,08,8,44,12,56,24,92,52
2663,Montcornet,8297,08,10,85,25,85,70,180,95
2664,Montcy-Notre-Dame,8298,08,188,372,88,672,304,1064,560
2665,Le Mont-Dieu,8300,08,0,0,0,10,0,10,0
2666,Montgon,8301,08,15,10,0,25,15,40,25
2667,Monthermé,8302,08,336,537,200,859,326,1385,873
2668,Monthois,8303,08,50,75,40,115,70,225,125
2669,Montigny-sur-Meuse,8304,08,0,35,0,40,20,60,35
2670,Montigny-sur-Vence,8305,08,12,65,26,65,44,135,77
2671,Mont-Laurent,8306,08,25,30,5,5,10,20,55
2672,Montmeillant,8307,08,30,15,10,30,5,45,45
2673,Mont-Saint-Martin,8308,08,13,19,6,15,14,35,32
2674,Mont-Saint-Remy,8309,08,16,12,0,12,8,20,28
2675,Mouron,8310,08,28,8,8,12,20,40,36
2676,Mouzon,8311,08,297,414,278,810,338,1426,711
2677,Murtin-et-Bogny,8312,08,13,45,20,22,45,87,58
2678,Nanteuil-sur-Aisne,8313,08,4,26,4,39,31,74,30
2679,Neuflize,8314,08,64,228,20,284,152,456,292
2680,Neufmaison,8315,08,4,16,12,20,20,52,20
2681,Neufmanil,8316,08,99,257,107,369,202,678,356
2682,La Neuville-à-Maire,8317,08,4,44,12,36,24,72,48
2683,La Neuville-aux-Joûtes,8318,08,24,77,8,153,45,206,101
2684,Neuville-lez-Beaulieu,8319,08,57,85,12,70,72,154,142
2685,La Neuville-en-Tourne-à-Fuy,8320,08,85,175,90,160,105,355,260
2686,Neuville-Day,8321,08,30,30,10,40,25,75,60
2687,Neuville-lès-This,8322,08,37,99,8,136,64,208,136
2688,La Neuville-lès-Wasigny,8323,08,36,51,10,50,30,90,87
2689,Neuvizy,8324,08,24,28,24,16,24,64,52
2690,Noirval,8325,08,15,5,0,10,0,10,20
2691,Nouart,8326,08,5,30,0,90,10,100,35
2692,Nouvion-sur-Meuse,8327,08,256,525,265,779,350,1394,781
2693,Nouzonville,8328,08,713,1495,513,2052,1116,3681,2208
2694,Novion-Porcien,8329,08,70,130,40,140,105,285,200
2695,Novy-Chevrières,8330,08,80,162,48,197,130,375,242
2696,Noyers-Pont-Maugis,8331,08,70,139,56,286,86,428,209
2697,Oches,8332,08,0,13,0,25,8,33,13
2698,Olizy-Primat,8333,08,21,57,29,48,41,118,78
2699,Omicourt,8334,08,0,4,4,22,0,26,4
2700,Omont,8335,08,12,13,3,21,10,34,25
2701,Osnes,8336,08,33,49,3,60,42,105,82
2702,Pauvres,8338,08,15,60,30,60,35,125,75
2703,Perthes,8339,08,45,85,35,80,65,180,130
2704,Poilcourt-Sydney,8340,08,15,65,30,65,25,120,80
2705,Poix-Terron,8341,08,80,205,75,230,190,495,285
2706,Pouru-aux-Bois,8342,08,12,88,16,97,54,167,100
2707,Pouru-Saint-Remy,8343,08,195,318,89,318,223,630,513
2708,Prez,8344,08,8,36,12,32,40,84,44
2709,Prix-lès-Mézières,8346,08,215,265,80,615,185,880,480
2710,Puilly-et-Charbeaux,8347,08,48,76,6,70,43,119,124
2711,Puiseux,8348,08,12,28,16,28,24,68,40
2712,Pure,8349,08,64,168,60,192,148,400,232
2713,Quatre-Champs,8350,08,24,55,10,79,44,133,79
2714,Quilly,8351,08,20,25,0,5,25,30,45
2715,Raillicourt,8352,08,30,25,20,95,25,140,55
2716,Rancennes,8353,08,50,180,35,260,185,480,230
2717,Raucourt-et-Flaba,8354,08,116,200,116,260,176,552,316
2718,Regniowez,8355,08,56,92,40,116,80,236,148
2719,Remaucourt,8356,08,5,45,10,55,40,105,50
2720,Remilly-Aillicourt,8357,08,55,200,95,315,120,530,255
2721,Remilly-les-Pothées,8358,08,16,64,16,63,49,128,80
2722,Renneville,8360,08,32,32,16,92,24,132,64
2723,Renwez,8361,08,165,440,230,520,350,1100,605
2724,Rethel,8362,08,1060,1751,901,2316,1431,4648,2811
2725,Revin,8363,08,1038,1475,652,2117,1133,3902,2513
2726,Rilly-sur-Aisne,8364,08,21,38,21,12,21,54,59
2727,Rimogne,8365,08,106,427,125,402,297,824,533
2728,Rocquigny,8366,08,97,170,48,251,61,360,267
2729,Rocroi,8367,08,277,568,184,778,487,1449,845
2730,Roizy,8368,08,35,40,25,90,40,155,75
2731,La Romagne,8369,08,15,40,5,40,40,85,55
2732,Rouvroy-sur-Audry,8370,08,56,160,52,184,120,356,216
2733,Rubécourt-et-Lamécourt,8371,08,7,13,6,72,3,81,20
2734,Rubigny,8372,08,10,7,3,19,12,34,17
2735,Rumigny,8373,08,79,100,30,100,45,175,179
2736,La Sabotterie,8374,08,4,12,12,44,0,56,16
2737,Sachy,8375,08,20,45,20,75,35,130,65
2738,Sailly,8376,08,40,60,20,85,35,140,100
2739,Saint-Aignan,8377,08,4,34,12,44,44,100,38
2740,Saint-Clément-à-Arnes,8378,08,16,20,8,40,20,68,36
2741,Saint-Étienne-à-Arnes,8379,08,45,65,30,80,35,145,110
2742,Saint-Fergeux,8380,08,20,50,10,65,50,125,70
2743,Saint-Germainmont,8381,08,95,200,35,273,150,458,295
2744,Saint-Jean-aux-Bois,8382,08,26,23,6,39,13,58,49
2745,Saint-Juvin,8383,08,5,20,15,40,15,70,25
2746,Saint-Lambert-et-Mont-de-Jeux,8384,08,12,12,16,49,22,87,24
2747,Saint-Laurent,8385,08,154,235,85,378,180,643,389
2748,Saint-Loup-en-Champagne,8386,08,12,68,20,76,64,160,80
2749,Saint-Loup-Terrier,8387,08,8,56,8,44,48,100,64
2750,Saint-Marceau,8388,08,40,64,12,145,57,214,104
2751,Saint-Marcel,8389,08,24,76,32,168,64,264,100
2752,Sainte-Marie,8390,08,0,15,20,25,15,60,15
2753,Saint-Menges,8391,08,95,260,105,314,219,638,355
2754,Saint-Morel,8392,08,10,40,20,120,30,170,50
2755,Saint-Pierre-à-Arnes,8393,08,8,12,8,21,8,37,20
2756,Saint-Pierremont,8394,08,16,8,12,28,8,48,24
2757,Saint-Pierre-sur-Vence,8395,08,30,20,0,75,10,85,50
2758,Saint-Quentin-le-Petit,8396,08,27,9,12,40,16,68,36
2759,Saint-Remy-le-Petit,8397,08,0,10,0,0,30,30,10
2760,Sainte-Vaubourg,8398,08,20,9,3,38,0,41,29
2761,Sapogne-sur-Marche,8399,08,23,31,10,21,24,55,54
2762,Sapogne-et-Feuchères,8400,08,35,130,65,175,105,345,165
2763,Saulces-Champenoises,8401,08,8,58,8,51,66,125,66
2764,Saulces-Monclin,8402,08,48,220,21,259,150,430,268
2765,Sault-lès-Rethel,8403,08,243,455,267,728,250,1245,698
2766,Sault-Saint-Remy,8404,08,4,59,4,67,47,118,63
2767,Sauville,8405,08,32,72,28,80,52,160,104
2768,Savigny-sur-Aisne,8406,08,40,96,52,120,68,240,136
2769,Séchault,8407,08,5,15,5,20,10,35,20
2770,Sécheval,8408,08,56,145,48,188,96,332,201
2771,Sedan,8409,08,2168,4202,2349,5721,2912,10982,6370
2772,Semide,8410,08,35,45,0,85,30,115,80
2773,Semuy,8411,08,34,4,0,22,8,30,38
2774,Senuc,8412,08,40,17,21,42,4,67,57
2775,Seraincourt,8413,08,37,72,30,60,43,133,109
2776,Sery,8415,08,50,80,33,65,71,169,130
2777,Seuil,8416,08,16,12,12,76,12,100,28
2778,Sévigny-la-Forêt,8417,08,20,88,24,72,56,152,108
2779,Sévigny-Waleppe,8418,08,20,55,30,110,20,160,75
2780,Signy-l'Abbaye,8419,08,261,306,90,465,160,715,567
2781,Signy-le-Petit,8420,08,134,325,115,429,195,739,459
2782,Signy-Montlibert,8421,08,8,13,16,12,20,48,21
2783,Singly,8422,08,16,32,20,32,36,88,48
2784,Sommauthe,8424,08,25,20,10,35,15,60,45
2785,Sommerance,8425,08,15,10,0,15,10,25,25
2786,Son,8426,08,8,34,0,32,12,44,42
2787,Sorbon,8427,08,15,35,10,120,10,140,50
2788,Sorcy-Bauthémont,8428,08,16,26,8,58,8,74,42
2789,Sormonne,8429,08,48,128,56,236,76,368,176
2790,Stonne,8430,08,9,10,0,6,3,9,19
2791,Sugny,8431,08,10,25,0,30,30,60,35
2792,Sury,8432,08,4,17,0,34,21,55,21
2793,Suzanne,8433,08,10,20,5,30,5,40,30
2794,Sy,8434,08,0,4,16,0,8,24,4
2795,Tagnon,8435,08,83,236,47,248,223,518,319
2796,Taillette,8436,08,32,100,28,124,68,220,132
2797,Tailly,8437,08,36,44,4,68,36,108,80
2798,Taizy,8438,08,16,36,12,40,12,64,52
2799,Tannay,8439,08,15,45,30,75,20,125,60
2800,Tarzy,8440,08,15,40,35,35,40,110,55
2801,Terron-sur-Aisne,8443,08,16,20,4,52,12,68,36
2802,Tétaigne,8444,08,8,12,16,28,16,60,20
2803,Thelonne,8445,08,38,106,24,126,65,215,144
2804,Thénorgues,8446,08,10,5,5,35,20,60,15
2805,Thilay,8448,08,116,232,76,412,224,712,348
2806,Thin-le-Moutier,8449,08,47,150,43,187,143,373,197
2807,This,8450,08,12,33,44,76,20,140,45
2808,Le Thour,8451,08,60,95,25,120,50,195,155
2809,Thugny-Trugny,8452,08,9,82,8,67,76,151,91
2810,Toges,8453,08,15,18,12,31,6,49,33
2811,Touligny,8454,08,8,17,4,30,21,55,25
2812,Tourcelles-Chaumont,8455,08,16,20,8,24,16,48,36
2813,Tournavaux,8456,08,0,62,17,77,48,142,62
2814,Tournes,8457,08,120,246,101,321,204,626,366
2815,Tourteron,8458,08,24,16,9,74,13,96,40
2816,Tremblois-lès-Carignan,8459,08,12,25,8,73,16,97,37
2817,Tremblois-lès-Rocroi,8460,08,6,34,6,60,29,95,40
2818,Vandy,8461,08,5,40,30,105,35,170,45
2819,Vaux-Champagne,8462,08,20,28,24,32,28,84,48
2820,Vaux-en-Dieulet,8463,08,15,15,5,20,10,35,30
2821,Vaux-lès-Mouron,8464,08,15,55,10,25,5,40,70
2822,Vaux-lès-Rubigny,8465,08,4,12,8,16,8,32,16
2823,Vaux-lès-Mouzon,8466,08,20,20,0,32,20,52,40
2824,Vaux-Montreuil,8467,08,5,35,15,30,25,70,40
2825,Vaux-Villaine,8468,08,13,36,12,68,22,102,49
2826,Vendresse,8469,08,56,132,64,156,112,332,188
2827,Verpel,8470,08,20,15,0,25,15,40,35
2828,Verrières,8471,08,6,3,0,9,3,12,9
2829,Viel-Saint-Remy,8472,08,24,89,16,80,85,181,113
2830,Vieux-lès-Asfeld,8473,08,52,64,28,100,60,188,116
2831,Villers-Cernay,8475,08,27,68,19,114,70,203,95
2832,Villers-devant-le-Thour,8476,08,50,100,20,90,140,250,150
2833,Villers-devant-Mouzon,8477,08,6,19,7,45,6,58,25
2834,Villers-le-Tilleul,8478,08,13,57,12,74,42,128,70
2835,Villers-le-Tourneur,8479,08,4,47,33,59,25,117,51
2836,Villers-Semeuse,8480,08,428,820,321,1375,556,2252,1248
2837,Villers-sur-Bar,8481,08,19,38,15,92,37,144,57
2838,Villers-sur-le-Mont,8482,08,0,17,8,49,17,74,17
2839,Ville-sur-Lumes,8483,08,47,126,38,167,96,301,173
2840,Ville-sur-Retourne,8484,08,12,21,20,12,12,44,33
2841,Villy,8485,08,17,49,4,80,25,109,66
2842,Vireux-Molhain,8486,08,161,356,166,474,315,955,517
2843,Vireux-Wallerand,8487,08,296,547,196,592,388,1176,843
2844,Vivier-au-Court,8488,08,304,807,302,974,513,1789,1111
2845,Voncq,8489,08,25,50,0,115,25,140,75
2846,Vouziers,8490,08,663,720,393,1292,594,2279,1383
2847,Vrigne-aux-Bois,8491,08,418,774,428,1071,530,2029,1192
2848,Vrigne-Meuse,8492,08,26,77,29,45,66,140,103
2849,Vrizy,8493,08,30,65,30,125,65,220,95
2850,Wadelincourt,8494,08,65,90,50,204,76,330,155
2851,Wagnon,8496,08,8,26,4,20,38,62,34
2852,Warcq,8497,08,135,240,105,505,200,810,375
2853,Warnécourt,8498,08,45,70,5,155,70,230,115
2854,Wasigny,8499,08,56,117,20,67,53,140,173
2855,Wignicourt,8500,08,9,9,6,9,15,30,18
2856,Williers,8501,08,5,5,5,21,0,26,10
2857,Yoncq,8502,08,24,28,12,32,16,60,52
2858,Yvernaumont,8503,08,5,35,30,45,15,90,40
2859,Aigues-Juntes,9001,09,0,16,0,20,24,44,16
2860,Aigues-Vives,9002,09,62,149,12,268,116,396,211
2861,L'Aiguillon,9003,09,78,67,16,145,66,227,145
2862,Albiès,9004,09,10,20,20,40,35,95,30
2863,Aleu,9005,09,32,10,0,55,0,55,42
2864,Alliat,9006,09,5,5,0,20,15,35,10
2865,Allières,9007,09,5,15,5,40,5,50,20
2866,Alos,9008,09,10,10,5,50,15,70,20
2867,Alzen,9009,09,12,65,17,70,56,143,77
2868,Antras,9011,09,4,12,4,12,20,36,16
2869,Appy,9012,09,0,12,0,0,18,18,12
2870,Arabaux,9013,09,8,4,4,12,16,32,12
2871,Argein,9014,09,65,35,15,53,30,98,100
2872,Arignac,9015,09,90,190,20,265,150,435,280
2873,Arnave,9016,09,25,54,30,55,34,119,79
2874,Arrien-en-Bethmale,9017,09,40,16,4,32,16,52,56
2875,Arrout,9018,09,15,15,5,35,5,45,30
2876,Artigat,9019,09,60,128,39,235,94,368,188
2877,Artigues,9020,09,22,4,0,8,8,16,26
2878,Artix,9021,09,15,40,10,70,15,95,55
2879,Arvigna,9022,09,25,55,25,85,35,145,80
2880,Ascou,9023,09,12,40,12,60,44,116,52
2881,Aston,9024,09,24,35,38,65,55,158,59
2882,Aucazein,9025,09,16,6,3,28,6,37,22
2883,Audressein,9026,09,12,16,8,45,21,74,28
2884,Augirein,9027,09,13,12,0,28,4,32,25
2885,Aulos,9028,09,10,20,10,15,10,35,30
2886,Aulus-les-Bains,9029,09,44,24,4,64,20,88,68
2887,Auzat,9030,09,66,95,62,219,74,355,161
2888,Axiat,9031,09,20,8,0,8,8,16,28
2889,Ax-les-Thermes,9032,09,199,208,125,408,190,723,407
2890,Bagert,9033,09,10,6,0,12,6,18,16
2891,Balacet,9034,09,0,4,0,8,8,16,4
2892,Balaguères,9035,09,26,37,6,68,28,102,63
2893,Barjac,9037,09,15,10,5,10,15,30,25
2894,La Bastide-de-Besplas,9038,09,65,95,0,140,85,225,160
2895,La Bastide-de-Bousignac,9039,09,32,76,24,124,72,220,108
2896,La Bastide-de-Lordat,9040,09,16,68,52,76,56,184,84
2897,La Bastide-du-Salat,9041,09,35,30,15,45,45,105,65
2898,La Bastide-de-Sérou,9042,09,175,235,55,300,155,510,410
2899,La Bastide-sur-l'Hers,9043,09,147,95,40,320,60,420,242
2900,Baulou,9044,09,16,24,4,54,24,82,40
2901,Bédeilhac-et-Aynat,9045,09,35,34,5,82,45,132,69
2902,Bédeille,9046,09,19,9,3,39,0,42,28
2903,Bélesta,9047,09,187,172,71,360,152,583,359
2904,Belloc,9048,09,8,16,8,20,8,36,24
2905,Bénac,9049,09,16,33,16,77,8,101,49
2906,Benagues,9050,09,32,116,36,176,84,296,148
2907,Bénaix,9051,09,20,30,5,60,30,95,50
2908,Besset,9052,09,19,40,10,69,25,104,59
2909,Bestiac,9053,09,0,6,0,12,0,12,6
2910,Betchat,9054,09,60,58,16,102,31,149,118
2911,Bethmale,9055,09,10,0,9,46,6,61,10
2912,Bézac,9056,09,8,90,32,131,56,219,98
2913,Biert,9057,09,88,64,12,100,44,156,152
2914,Bompas,9058,09,40,16,16,89,18,123,56
2915,Bonac-Irazein,9059,09,5,20,15,55,20,90,25
2916,Bonnac,9060,09,135,155,55,230,160,445,290
2917,Les Bordes-sur-Arize,9061,09,90,125,40,165,85,290,215
2918,Les Bordes-sur-Lez,9062,09,65,20,0,35,35,70,85
2919,Le Bosc,9063,09,5,25,0,60,15,75,30
2920,Bouan,9064,09,0,5,5,25,0,30,5
2921,Boussenac,9065,09,8,12,4,97,35,136,20
2922,Brassac,9066,09,65,145,50,254,130,434,210
2923,Brie,9067,09,4,63,25,55,48,128,67
2924,Burret,9068,09,5,5,0,10,5,15,10
2925,Buzan,9069,09,4,0,4,16,8,28,4
2926,Les Cabannes,9070,09,89,40,20,138,45,203,129
2927,Cadarcet,9071,09,35,59,5,98,45,148,94
2928,Calzan,9072,09,4,4,8,8,4,20,8
2929,Camarade,9073,09,15,30,5,85,35,125,45
2930,Camon,9074,09,40,15,5,50,20,75,55
2931,Campagne-sur-Arize,9075,09,53,44,5,120,53,178,97
2932,Canté,9076,09,16,52,28,64,40,132,68
2933,Capoulet-et-Junac,9077,09,10,25,25,65,45,135,35
2934,Carcanières,9078,09,32,0,0,5,10,15,32
2935,Carla-Bayle,9079,09,135,149,45,232,110,387,284
2936,Carla-de-Roquefort,9080,09,8,12,22,76,16,114,20
2937,Le Carlaret,9081,09,12,84,20,88,64,172,96
2938,Castelnau-Durban,9082,09,80,80,56,156,68,280,160
2939,Castéras,9083,09,12,0,0,6,0,6,12
2940,Castex,9084,09,20,25,10,25,25,60,45
2941,Castillon-en-Couserans,9085,09,86,40,25,173,40,238,126
2942,Caumont,9086,09,47,79,25,90,66,181,126
2943,Caussou,9087,09,8,20,8,16,12,36,28
2944,Caychax,9088,09,0,4,0,16,0,16,4
2945,Cazals-des-Baylès,9089,09,12,20,4,32,0,36,32
2946,Cazaux,9090,09,4,16,0,20,8,28,20
2947,Cazavet,9091,09,30,35,30,70,60,160,65
2948,Cazenave-Serres-et-Allens,9092,09,0,10,5,15,10,30,10
2949,Celles,9093,09,21,42,12,32,21,65,63
2950,Cérizols,9094,09,30,15,15,65,10,90,45
2951,Cescau,9095,09,12,23,7,52,25,84,35
2952,Château-Verdun,9096,09,9,0,3,10,0,13,9
2953,Clermont,9097,09,8,25,0,33,30,63,33
2954,Contrazy,9098,09,8,4,8,40,20,68,12
2955,Cos,9099,09,40,75,25,160,90,275,115
2956,Couflens,9100,09,4,13,8,56,0,64,17
2957,Coussa,9101,09,24,40,32,84,52,168,64
2958,Coutens,9102,09,12,45,16,67,16,99,57
2959,Crampagna,9103,09,64,180,48,261,193,502,244
2960,Dalou,9104,09,122,132,73,264,89,426,254
2961,Daumazan-sur-Arize,9105,09,132,83,47,260,62,369,215
2962,Dreuilhe,9106,09,29,95,15,154,65,234,124
2963,Dun,9107,09,79,83,25,188,88,301,162
2964,Durban-sur-Arize,9108,09,18,24,7,52,34,93,42
2965,Durfort,9109,09,25,25,25,55,20,100,50
2966,Encourtiech,9110,09,15,5,10,55,0,65,20
2967,Engomer,9111,09,80,72,4,88,48,140,152
2968,Ercé,9113,09,105,60,40,194,80,314,165
2969,Erp,9114,09,29,25,0,44,20,64,54
2970,Esclagne,9115,09,4,24,4,63,28,95,28
2971,Escosse,9116,09,85,85,20,120,85,225,170
2972,Esplas,9117,09,12,28,4,37,13,54,40
2973,Esplas-de-Sérou,9118,09,0,37,8,90,30,128,37
2974,Eycheil,9119,09,85,100,30,225,110,365,185
2975,Fabas,9120,09,44,80,20,96,52,168,124
2976,Ferrières-sur-Ariège,9121,09,128,172,52,292,144,488,300
2977,Foix,9122,09,1729,1927,1017,3109,1597,5723,3656
2978,Fornex,9123,09,22,9,10,41,16,67,31
2979,Le Fossat,9124,09,136,240,112,332,204,648,376
2980,Fougax-et-Barrineuf,9125,09,84,75,6,148,66,220,159
2981,Freychenet,9126,09,15,10,5,35,15,55,25
2982,Gabre,9127,09,8,16,8,44,16,68,24
2983,Gajan,9128,09,19,69,3,120,52,175,88
2984,Galey,9129,09,8,12,4,41,33,78,20
2985,Ganac,9130,09,57,129,36,300,91,427,186
2986,Garanou,9131,09,40,15,5,80,20,105,55
2987,Gaudiès,9132,09,9,48,16,90,29,135,57
2988,Génat,9133,09,5,0,0,0,10,10,5
2989,Gestiès,9134,09,0,0,0,20,0,20,0
2990,Goulier,9135,09,18,0,0,20,4,24,18
2991,Gourbit,9136,09,24,16,4,48,16,68,40
2992,Gudas,9137,09,12,41,8,40,60,108,53
2993,L'Herm,9138,09,20,45,5,90,35,130,65
2994,L'Hospitalet-près-l'Andorre,9139,09,0,6,6,31,19,56,6
2995,Ignaux,9140,09,15,30,10,30,20,60,45
2996,Illartein,9141,09,15,10,0,30,15,45,25
2997,Ilhat,9142,09,30,35,0,55,15,70,65
2998,Illier-et-Laramade,9143,09,12,0,0,8,0,8,12
2999,Les Issards,9145,09,30,70,10,75,65,150,100
3000,Justiniac,9146,09,3,3,3,12,12,27,6
3001,Labatut,9147,09,12,48,4,56,31,91,60
3002,Lacave,9148,09,15,35,15,35,45,95,50
3003,Lacourt,9149,09,48,32,12,72,32,116,80
3004,Lagarde,9150,09,28,40,12,76,36,124,68
3005,Lanoux,9151,09,15,5,0,0,15,15,20
3006,Lapège,9152,09,16,0,0,4,0,4,16
3007,Lapenne,9153,09,15,25,20,35,30,85,40
3008,Larbont,9154,09,4,4,0,24,4,28,8
3009,Larcat,9155,09,0,4,0,20,8,28,4
3010,Larnat,9156,09,0,8,0,16,0,16,8
3011,Laroque-d'Olmes,9157,09,474,493,132,841,425,1398,967
3012,Lasserre,9158,09,44,64,24,76,32,132,108
3013,Lassur,9159,09,12,12,8,12,16,36,24
3014,Lavelanet,9160,09,1279,1182,545,2322,777,3644,2461
3015,Léran,9161,09,80,120,40,250,105,395,200
3016,Lercoul,9162,09,10,0,5,10,0,15,10
3017,Lescousse,9163,09,35,10,10,25,0,35,45
3018,Lescure,9164,09,64,85,48,220,25,293,149
3019,Lesparrou,9165,09,25,28,0,87,35,122,53
3020,Leychert,9166,09,10,20,0,50,15,65,30
3021,Lézat-sur-Lèze,9167,09,420,540,180,695,415,1290,960
3022,Lieurac,9168,09,21,38,4,34,46,84,59
3023,Limbrassac,9169,09,16,29,0,55,8,63,45
3024,Lissac,9170,09,12,47,16,69,64,149,59
3025,Lordat,9171,09,4,8,4,16,12,32,12
3026,Loubaut,9172,09,4,0,4,16,0,20,4
3027,Loubens,9173,09,24,72,28,88,56,172,96
3028,Loubières,9174,09,29,65,25,121,51,197,94
3029,Ludiès,9175,09,12,10,6,12,6,24,22
3030,Luzenac,9176,09,100,55,35,201,75,311,155
3031,Madière,9177,09,25,50,5,70,50,125,75
3032,Malegoude,9178,09,4,8,4,16,8,28,12
3033,Malléon,9179,09,12,12,0,24,8,32,24
3034,Manses,9180,09,16,24,20,48,24,92,40
3035,Le Mas-d'Azil,9181,09,225,185,65,455,195,715,410
3036,Massat,9182,09,105,95,55,250,105,410,200
3037,Mauvezin-de-Prat,9183,09,8,13,9,38,8,55,21
3038,Mauvezin-de-Sainte-Croix,9184,09,5,5,0,15,10,25,10
3039,Mazères,9185,09,420,1019,248,1116,756,2120,1439
3040,Méras,9186,09,8,26,0,46,8,54,34
3041,Mercenac,9187,09,35,75,25,155,65,245,110
3042,Mercus-Garrabet,9188,09,196,260,96,376,204,676,456
3043,Mérens-les-Vals,9189,09,20,20,10,95,20,125,40
3044,Mérigon,9190,09,19,15,9,31,12,52,34
3045,Miglos,9192,09,20,16,4,52,16,72,36
3046,Mijanès,9193,09,15,5,0,25,10,35,20
3047,Mirepoix,9194,09,554,603,288,1127,415,1830,1157
3048,Monesple,9195,09,8,4,0,0,8,8,12
3049,Montagagne,9196,09,0,24,4,4,24,32,24
3050,Montaillou,9197,09,0,0,0,10,0,10,0
3051,Montardit,9198,09,35,25,10,60,50,120,60
3052,Montaut,9199,09,85,150,50,255,155,460,235
3053,Montbel,9200,09,5,42,0,73,24,97,47
3054,Montégut-en-Couserans,9201,09,6,9,9,22,3,34,15
3055,Montégut-Plantaurel,9202,09,38,57,13,79,67,159,95
3056,Montels,9203,09,3,37,3,46,38,87,40
3057,Montesquieu-Avantès,9204,09,30,65,15,105,35,155,95
3058,Montfa,9205,09,12,4,4,32,16,52,16
3059,Montferrier,9206,09,82,72,35,231,117,383,154
3060,Montgaillard,9207,09,288,304,112,532,188,832,592
3061,Montgauch,9208,09,10,25,5,40,30,75,35
3062,Montjoie-en-Couserans,9209,09,151,193,37,452,147,636,344
3063,Montoulieu,9210,09,46,70,50,134,68,252,116
3064,Montségur,9211,09,32,16,0,72,12,84,48
3065,Montseron,9212,09,16,16,0,28,20,48,32
3066,Moulin-Neuf,9213,09,60,48,8,42,39,89,108
3067,Moulis,9214,09,110,125,60,351,100,511,235
3068,Nalzen,9215,09,25,20,15,69,20,104,45
3069,Nescus,9216,09,3,17,3,21,15,39,20
3070,Niaux,9217,09,48,36,8,64,32,104,84
3071,Orgeix,9218,09,26,12,0,24,13,37,38
3072,Orgibet,9219,09,33,12,24,58,16,98,45
3073,Orlu,9220,09,40,44,8,40,48,96,84
3074,Ornolac-Ussat-les-Bains,9221,09,40,45,5,100,40,145,85
3075,Orus,9222,09,0,0,10,0,0,10,0
3076,Oust,9223,09,78,95,41,156,74,271,173
3077,Pailhès,9224,09,51,95,20,141,85,246,146
3078,Pamiers,9225,09,2244,3466,1923,4381,2635,8939,5710
3079,Pech,9226,09,5,10,0,30,10,40,15
3080,Péreille,9227,09,12,38,4,96,30,130,50
3081,Perles-et-Castelet,9228,09,33,34,8,78,27,113,67
3082,Le Peyrat,9229,09,100,115,25,165,100,290,215
3083,Le Pla,9230,09,13,0,4,27,0,31,13
3084,Le Port,9231,09,39,28,0,73,29,102,67
3085,Prades,9232,09,12,0,0,16,0,16,12
3086,Pradettes,9233,09,4,4,4,16,4,24,8
3087,Pradières,9234,09,5,30,10,45,25,80,35
3088,Prat-Bonrepaux,9235,09,183,175,65,300,135,500,358
3089,Prayols,9236,09,30,86,18,132,57,207,116
3090,Le Puch,9237,09,10,0,0,5,10,15,10
3091,Les Pujols,9238,09,72,206,48,236,178,462,278
3092,Quérigut,9239,09,30,10,0,68,15,83,40
3093,Quié,9240,09,56,33,12,92,59,163,89
3094,Rabat-les-Trois-Seigneurs,9241,09,60,65,0,174,55,229,125
3095,Raissac,9242,09,9,9,0,15,6,21,18
3096,Régat,9243,09,0,10,6,43,6,55,10
3097,Rieucros,9244,09,70,197,38,153,164,355,267
3098,Rieux-de-Pelleport,9245,09,96,340,95,409,241,745,436
3099,Rimont,9246,09,80,105,35,230,70,335,185
3100,Rivèrenert,9247,09,48,28,8,76,28,112,76
3101,Roquefixade,9249,09,35,20,0,65,20,85,55
3102,Roquefort-les-Cascades,9250,09,5,25,5,40,25,70,30
3103,Roumengoux,9251,09,20,36,20,80,20,120,56
3104,Rouze,9252,09,20,15,5,35,0,40,35
3105,Sabarat,9253,09,65,78,12,98,44,154,143
3106,Saint-Amadou,9254,09,28,88,8,48,84,140,116
3107,Saint-Amans,9255,09,4,8,0,12,8,20,12
3108,Saint-Bauzeil,9256,09,5,10,5,15,10,30,15
3109,Sainte-Croix-Volvestre,9257,09,55,90,35,310,70,415,145
3110,Saint-Félix-de-Rieutord,9258,09,49,116,37,111,78,226,165
3111,Saint-Félix-de-Tournegat,9259,09,15,30,0,85,20,105,45
3112,Sainte-Foi,9260,09,0,0,4,16,0,20,0
3113,Saint-Girons,9261,09,1379,1024,627,2005,839,3471,2403
3114,Saint-Jean-d'Aigues-Vives,9262,09,80,75,10,170,65,245,155
3115,Saint-Jean-du-Castillonnais,9263,09,0,6,3,9,3,15,6
3116,Saint-Jean-de-Verges,9264,09,81,275,142,371,234,747,356
3117,Saint-Jean-du-Falga,9265,09,506,588,222,788,459,1469,1094
3118,Saint-Julien-de-Gras-Capou,9266,09,0,10,15,25,10,50,10
3119,Saint-Lary,9267,09,35,7,6,52,6,64,42
3120,Saint-Lizier,9268,09,308,192,52,568,144,764,500
3121,Saint-Martin-de-Caralp,9269,09,43,67,19,105,56,180,110
3122,Saint-Martin-d'Oydes,9270,09,41,51,15,127,20,162,92
3123,Saint-Michel,9271,09,0,15,0,50,10,60,15
3124,Saint-Paul-de-Jarrat,9272,09,141,278,61,462,263,786,419
3125,Saint-Pierre-de-Rivière,9273,09,70,108,42,228,100,370,178
3126,Saint-Quentin-la-Tour,9274,09,36,100,28,136,44,208,136
3127,Saint-Quirc,9275,09,25,105,20,110,100,230,130
3128,Saint-Victor-Rouzaud,9276,09,24,61,12,92,32,136,85
3129,Saint-Ybars,9277,09,88,148,30,192,112,334,236
3130,Salsein,9279,09,12,4,4,12,0,16,16
3131,Saurat,9280,09,110,100,50,245,105,400,210
3132,Sautel,9281,09,30,5,0,50,5,55,35
3133,Saverdun,9282,09,727,1049,245,1443,885,2573,1776
3134,Savignac-les-Ormeaux,9283,09,70,105,5,120,85,210,175
3135,Ségura,9284,09,13,49,8,50,52,110,62
3136,Seix,9285,09,103,118,63,234,105,402,221
3137,Sem,9286,09,10,0,0,5,5,10,10
3138,Senconac,9287,09,4,12,0,0,8,8,16
3139,Lorp-Sentaraille,9289,09,223,304,115,487,197,799,527
3140,Sentein,9290,09,28,16,3,48,19,70,44
3141,Sentenac-d'Oust,9291,09,0,30,0,50,15,65,30
3142,Sentenac-de-Sérou,9292,09,0,8,16,24,0,40,8
3143,Serres-sur-Arget,9293,09,70,130,44,259,122,425,200
3144,Sieuras,9294,09,4,16,24,20,0,44,20
3145,Siguer,9295,09,20,5,5,55,10,70,25
3146,Sinsat,9296,09,15,15,10,45,30,85,30
3147,Sor,9297,09,3,6,3,6,9,18,9
3148,Sorgeat,9298,09,15,10,5,40,10,55,25
3149,Soueix-Rogalle,9299,09,48,76,20,170,50,240,124
3150,Soula,9300,09,40,36,12,68,36,116,76
3151,Soulan,9301,09,42,64,27,120,38,185,106
3152,Suc-et-Sentenac,9302,09,4,12,0,36,0,36,16
3153,Surba,9303,09,48,36,40,196,28,264,84
3154,Suzan,9304,09,0,12,0,12,6,18,12
3155,Tabre,9305,09,20,92,25,178,74,277,112
3156,Tarascon-sur-Ariège,9306,09,684,576,303,1012,541,1856,1260
3157,Taurignan-Castet,9307,09,24,40,32,48,32,112,64
3158,Taurignan-Vieux,9308,09,36,32,8,88,40,136,68
3159,Teilhet,9309,09,16,33,8,68,12,88,49
3160,Thouars-sur-Arize,9310,09,5,10,10,20,0,30,15
3161,Tignac,9311,09,0,4,0,8,0,8,4
3162,La Tour-du-Crieu,9312,09,410,805,204,938,688,1830,1215
3163,Tourtouse,9313,09,0,35,5,84,30,119,35
3164,Tourtrol,9314,09,20,72,16,93,38,147,92
3165,Trémoulet,9315,09,4,39,0,37,21,58,43
3166,Troye-d'Ariège,9316,09,10,15,0,45,15,60,25
3167,Uchentein,9317,09,5,0,0,15,0,15,5
3168,Unac,9318,09,20,28,12,32,28,72,48
3169,Unzent,9319,09,7,20,24,44,10,78,27
3170,Urs,9320,09,8,8,0,8,8,16,16
3171,Ussat,9321,09,96,64,20,112,52,184,160
3172,Ustou,9322,09,49,55,15,140,50,205,104
3173,Vals,9323,09,10,34,13,25,20,58,44
3174,Varilhes,9324,09,521,766,296,991,693,1980,1287
3175,Vaychis,9325,09,5,0,0,10,5,15,5
3176,Vèbre,9326,09,25,10,10,60,20,90,35
3177,Ventenac,9327,09,52,40,20,76,32,128,92
3178,Verdun,9328,09,50,35,20,100,15,135,85
3179,Vernajoul,9329,09,90,135,45,294,80,419,225
3180,Vernaux,9330,09,3,0,3,6,6,15,3
3181,Le Vernet,9331,09,64,160,56,208,152,416,224
3182,Verniolle,9332,09,285,545,195,840,371,1406,830
3183,Vicdessos,9334,09,55,85,60,245,45,350,140
3184,Villeneuve,9335,09,15,0,0,20,0,20,15
3185,Villeneuve-d'Olmes,9336,09,171,173,47,433,137,617,344
3186,Villeneuve-du-Latou,9338,09,29,26,0,46,21,67,55
3187,Villeneuve-du-Paréage,9339,09,112,188,76,200,169,445,300
3188,Vira,9340,09,20,25,20,60,30,110,45
3189,Viviès,9341,09,0,35,5,60,25,90,35
3190,Sainte-Suzanne,9342,09,34,27,6,96,30,132,61
3191,Ailleville,10002,10,30,65,25,105,40,170,95
3192,Aix-Villemaur-Pâlis,10003,10,638,794,222,1209,577,2008,1432
3193,Allibaudières,10004,10,31,48,19,49,26,94,79
3194,Amance,10005,10,35,70,35,105,40,180,105
3195,Arcis-sur-Aube,10006,10,528,651,305,782,442,1529,1179
3196,Arconville,10007,10,15,22,0,33,21,54,37
3197,Argançon,10008,10,12,16,12,48,20,80,28
3198,Arrelles,10009,10,3,9,3,33,12,48,12
3199,Arrembécourt,10010,10,25,15,0,15,10,25,40
3200,Arrentières,10011,10,32,52,24,80,32,136,84
3201,Arsonval,10012,10,45,85,10,115,60,185,130
3202,Assenay,10013,10,15,25,15,50,40,105,40
3203,Assencières,10014,10,0,66,0,55,55,110,66
3204,Aubeterre,10015,10,16,92,32,72,92,196,108
3205,Aulnay,10017,10,15,45,0,55,20,75,60
3206,Auxon,10018,10,103,202,92,298,129,519,305
3207,Val-d'Auzon,10019,10,52,116,48,92,96,236,168
3208,Avant-lès-Marcilly,10020,10,83,140,55,130,110,295,223
3209,Avant-lès-Ramerupt,10021,10,24,36,16,52,36,104,60
3210,Avirey-Lingey,10022,10,21,41,9,43,51,103,62
3211,Avon-la-Pèze,10023,10,25,50,45,35,50,130,75
3212,Avreuil,10024,10,32,21,0,33,19,52,53
3213,Bagneux-la-Fosse,10025,10,30,20,10,85,20,115,50
3214,Bailly-le-Franc,10026,10,12,8,0,12,8,20,20
3215,Balignicourt,10027,10,10,20,0,30,10,40,30
3216,Balnot-la-Grange,10028,10,0,20,25,60,15,100,20
3217,Balnot-sur-Laignes,10029,10,15,30,15,55,40,110,45
3218,Barberey-Saint-Sulpice,10030,10,148,396,99,357,265,721,544
3219,Barbuise,10031,10,28,140,16,136,108,260,168
3220,Baroville,10032,10,23,70,28,105,65,198,93
3221,Bar-sur-Aube,10033,10,799,965,488,1680,772,2940,1764
3222,Bar-sur-Seine,10034,10,345,675,335,1010,420,1765,1020
3223,Bayel,10035,10,112,123,34,288,113,435,235
3224,Bercenay-en-Othe,10037,10,39,123,29,147,68,244,162
3225,Bercenay-le-Hayer,10038,10,24,43,16,64,28,108,67
3226,Bergères,10039,10,5,35,30,50,15,95,40
3227,Bernon,10040,10,40,36,24,64,32,120,76
3228,Bertignolles,10041,10,0,5,5,30,10,45,5
3229,Bérulle,10042,10,48,50,0,85,60,145,98
3230,Bessy,10043,10,8,35,8,56,8,72,43
3231,Bétignicourt,10044,10,5,5,5,10,5,20,10
3232,Beurey,10045,10,40,77,20,56,21,97,117
3233,Blaincourt-sur-Aube,10046,10,22,16,0,29,17,46,38
3234,Blignicourt,10047,10,0,10,10,10,9,29,10
3235,Bligny,10048,10,15,40,0,80,35,115,55
3236,Les Bordes-Aumont,10049,10,25,205,20,165,140,325,230
3237,Bossancourt,10050,10,21,16,16,99,25,140,37
3238,Bouilly,10051,10,112,263,63,330,225,618,375
3239,Boulages,10052,10,35,51,15,108,26,149,86
3240,Bouranton,10053,10,56,120,40,220,112,372,176
3241,Bourdenay,10054,10,32,30,12,40,24,76,62
3242,Bourguignons,10055,10,35,75,25,90,60,175,110
3243,Bouy-Luxembourg,10056,10,20,72,12,72,44,128,92
3244,Bouy-sur-Orvin,10057,10,20,15,0,20,5,25,35
3245,Bragelogne-Beauvoir,10058,10,35,55,50,100,15,165,90
3246,Braux,10059,10,12,13,6,18,24,48,25
3247,Bréviandes,10060,10,341,611,200,793,554,1547,952
3248,Brévonnes,10061,10,96,192,32,248,120,400,288
3249,Briel-sur-Barse,10062,10,40,55,25,70,30,125,95
3250,Brienne-la-Vieille,10063,10,72,88,36,184,60,280,160
3251,Brienne-le-Château,10064,10,533,597,216,869,407,1492,1130
3252,Brillecourt,10065,10,9,9,12,24,18,54,18
3253,Bucey-en-Othe,10066,10,38,88,21,170,62,253,126
3254,Buchères,10067,10,149,398,104,522,291,917,547
3255,Buxeuil,10068,10,25,25,5,45,30,80,50
3256,Buxières-sur-Arce,10069,10,9,38,0,40,23,63,47
3257,Celles-sur-Ource,10070,10,29,100,56,157,107,320,129
3258,Chacenay,10071,10,0,0,16,20,0,36,0
3259,La Chaise,10072,10,0,12,4,4,20,28,12
3260,Chalette-sur-Voire,10073,10,24,40,12,40,28,80,64
3261,Chamoy,10074,10,43,99,51,186,78,315,142
3262,Champfleury,10075,10,10,38,0,31,38,69,48
3263,Champignol-lez-Mondeville,10076,10,52,96,12,76,88,176,148
3264,Champigny-sur-Aube,10077,10,4,30,0,12,29,41,34
3265,Champ-sur-Barse,10078,10,3,3,6,6,0,12,6
3266,Channes,10079,10,26,16,3,36,13,52,42
3267,Chaource,10080,10,105,245,135,395,150,680,350
3268,La Chapelle-Saint-Luc,10081,10,1337,3471,1584,3539,2232,7355,4808
3269,Chapelle-Vallon,10082,10,20,60,30,80,40,150,80
3270,Chappes,10083,10,43,58,8,103,58,169,101
3271,Charmont-sous-Barbuise,10084,10,60,352,88,328,232,648,412
3272,Charmoy,10085,10,20,16,4,24,16,44,36
3273,Charny-le-Bachot,10086,10,16,71,12,69,38,119,87
3274,Chaserey,10087,10,15,20,0,20,10,30,35
3275,Châtres,10089,10,80,205,75,225,130,430,285
3276,Chauchigny,10090,10,16,72,8,116,48,172,88
3277,Chaudrey,10091,10,25,25,20,55,20,95,50
3278,Chauffour-lès-Bailly,10092,10,10,40,15,30,30,75,50
3279,Chaumesnil,10093,10,0,32,8,28,20,56,32
3280,Chavanges,10094,10,82,134,41,175,92,308,216
3281,Le Chêne,10095,10,60,85,24,44,93,161,145
3282,Chennegy,10096,10,38,104,8,212,43,263,142
3283,Chervey,10097,10,31,40,5,50,46,101,71
3284,Chesley,10098,10,34,83,8,124,46,178,117
3285,Chessy-les-Prés,10099,10,60,110,35,245,65,345,170
3286,Clérey,10100,10,155,270,100,400,195,695,425
3287,Coclois,10101,10,35,25,25,55,20,100,60
3288,Colombé-la-Fosse,10102,10,45,50,20,70,30,120,95
3289,Colombé-le-Sec,10103,10,20,25,10,60,35,105,45
3290,Cormost,10104,10,28,76,24,92,80,196,104
3291,Courcelles-sur-Voire,10105,10,3,6,0,3,0,3,9
3292,Courceroy,10106,10,16,17,12,33,16,61,33
3293,Coursan-en-Othe,10107,10,0,25,0,60,20,80,25
3294,Courtaoult,10108,10,16,12,12,36,16,64,28
3295,Courtenot,10109,10,10,45,25,125,30,180,55
3296,Courteranges,10110,10,35,165,75,175,90,340,200
3297,Courteron,10111,10,13,18,10,35,9,54,31
3298,Coussegrey,10112,10,45,40,25,70,15,110,85
3299,Couvignon,10113,10,35,40,5,95,25,125,75
3300,Crancey,10114,10,105,148,67,244,107,418,253
3301,Creney-près-Troyes,10115,10,336,383,125,563,328,1016,719
3302,Crésantignes,10116,10,40,76,12,92,88,192,116
3303,Crespy-le-Neuf,10117,10,8,36,21,25,35,81,44
3304,Les Croûtes,10118,10,18,20,6,28,12,46,38
3305,Cunfin,10119,10,31,19,12,70,22,104,50
3306,Cussangy,10120,10,37,65,4,60,39,103,102
3307,Dampierre,10121,10,45,55,0,135,50,185,100
3308,Davrey,10122,10,18,60,21,83,23,127,78
3309,Dienville,10123,10,115,202,90,291,150,531,317
3310,Dierrey-Saint-Julien,10124,10,17,77,8,77,60,145,94
3311,Dierrey-Saint-Pierre,10125,10,12,67,32,100,48,180,79
3312,Dolancourt,10126,10,18,26,7,51,15,73,44
3313,Dommartin-le-Coq,10127,10,12,4,0,28,12,40,16
3314,Donnement,10128,10,15,15,30,15,10,55,30
3315,Dosches,10129,10,24,58,16,119,38,173,82
3316,Dosnon,10130,10,4,36,8,32,24,64,40
3317,Droupt-Saint-Basle,10131,10,25,85,35,145,60,240,110
3318,Droupt-Sainte-Marie,10132,10,8,58,12,93,51,156,66
3319,Eaux-Puiseaux,10133,10,68,53,4,55,33,92,121
3320,Échemines,10134,10,16,32,0,28,16,44,48
3321,Éclance,10135,10,15,0,10,60,5,75,15
3322,Éguilly-sous-Bois,10136,10,30,25,5,35,20,60,55
3323,Engente,10137,10,17,0,6,12,0,18,17
3324,Épagne,10138,10,15,23,6,39,13,58,38
3325,Épothémont,10139,10,12,25,22,65,24,111,37
3326,Ervy-le-Châtel,10140,10,158,280,70,374,205,649,438
3327,Essoyes,10141,10,88,188,104,280,84,468,276
3328,Estissac,10142,10,206,477,171,565,360,1096,683
3329,Étourvy,10143,10,55,30,25,62,15,102,85
3330,Étrelles-sur-Aube,10144,10,12,21,8,56,29,93,33
3331,Faux-Villecerf,10145,10,29,40,21,63,30,114,69
3332,Fay-lès-Marcilly,10146,10,18,13,3,31,3,37,31
3333,Fays-la-Chapelle,10147,10,9,31,0,45,22,67,40
3334,Ferreux-Quincey,10148,10,55,78,21,112,55,188,133
3335,Feuges,10149,10,24,80,4,86,82,172,104
3336,Fontaine,10150,10,45,30,25,145,20,190,75
3337,Fontaine-les-Grès,10151,10,122,151,56,248,165,469,273
3338,Fontaine-Mâcon,10153,10,65,145,75,263,90,428,210
3339,Fontenay-de-Bossery,10154,10,3,6,7,31,12,50,9
3340,Fontette,10155,10,47,36,0,63,26,89,83
3341,Fontvannes,10156,10,55,205,80,195,155,430,260
3342,La Fosse-Corduan,10157,10,29,31,18,63,34,115,60
3343,Fouchères,10158,10,39,129,29,171,95,295,168
3344,Fralignes,10159,10,12,20,12,24,8,44,32
3345,Fravaux,10160,10,8,16,0,20,8,28,24
3346,Fresnay,10161,10,0,0,0,30,5,35,0
3347,Fresnoy-le-Château,10162,10,12,60,12,136,44,192,72
3348,Fuligny,10163,10,8,8,4,32,0,36,16
3349,Gélannes,10164,10,60,160,84,284,124,492,220
3350,Géraudot,10165,10,60,97,5,109,49,163,157
3351,Les Grandes-Chapelles,10166,10,80,80,30,115,70,215,160
3352,Grandville,10167,10,5,31,37,35,0,72,36
3353,Les Granges,10168,10,5,25,15,20,20,55,30
3354,Gumery,10169,10,52,64,8,60,64,132,116
3355,Gyé-sur-Seine,10170,10,100,105,45,185,75,305,205
3356,Hampigny,10171,10,25,63,9,67,41,117,88
3357,Herbisse,10172,10,19,30,10,90,20,120,49
3358,Isle-Aumont,10173,10,58,79,41,186,74,301,137
3359,Isle-Aubigny,10174,10,20,35,25,50,40,115,55
3360,Jasseines,10175,10,10,50,15,50,40,105,60
3361,Jaucourt,10176,10,4,25,22,66,12,100,29
3362,Javernant,10177,10,12,28,8,76,28,112,40
3363,Jessains,10178,10,25,85,0,95,60,155,110
3364,Jeugny,10179,10,38,115,30,164,125,319,153
3365,Joncreuil,10180,10,10,50,10,20,20,50,60
3366,Jully-sur-Sarce,10181,10,51,45,30,80,12,122,96
3367,Juvancourt,10182,10,15,15,3,44,21,68,30
3368,Juvanzé,10183,10,4,4,4,12,4,20,8
3369,Juzanvigny,10184,10,20,20,20,30,25,75,40
3370,Lagesse,10185,10,24,52,16,80,32,128,76
3371,Laines-aux-Bois,10186,10,58,105,43,171,82,296,163
3372,Landreville,10187,10,50,95,60,199,89,348,145
3373,Lantages,10188,10,32,68,24,96,44,164,100
3374,Lassicourt,10189,10,10,15,5,25,10,40,25
3375,Laubressel,10190,10,45,163,32,149,114,295,208
3376,Lavau,10191,10,74,284,69,305,238,612,358
3377,Lentilles,10192,10,8,28,0,44,48,92,36
3378,Lesmont,10193,10,60,65,0,100,75,175,125
3379,Lévigny,10194,10,10,25,25,30,10,65,35
3380,Lhuître,10195,10,45,60,15,100,60,175,105
3381,Lignières,10196,10,48,42,20,125,0,145,90
3382,Lignol-le-Château,10197,10,27,55,8,32,48,88,82
3383,Lirey,10198,10,15,25,5,40,20,65,40
3384,Loches-sur-Ource,10199,10,35,75,15,145,80,240,110
3385,La Loge-aux-Chèvres,10200,10,12,4,9,24,12,45,16
3386,La Loge-Pomblin,10201,10,3,10,9,21,6,36,13
3387,Les Loges-Margueron,10202,10,5,40,30,75,20,125,45
3388,Longchamp-sur-Aujon,10203,10,100,90,35,175,40,250,190
3389,Longeville-sur-Mogne,10204,10,20,42,0,12,42,54,62
3390,Longpré-le-Sec,10205,10,12,12,0,24,8,32,24
3391,Longsols,10206,10,40,10,10,25,20,55,50
3392,Longueville-sur-Aube,10207,10,30,30,15,35,30,80,60
3393,La Louptière-Thénard,10208,10,60,90,25,55,70,150,150
3394,Lusigny-sur-Barse,10209,10,233,464,161,613,337,1111,697
3395,Luyères,10210,10,12,110,35,183,71,289,122
3396,Macey,10211,10,60,253,40,324,244,608,313
3397,Machy,10212,10,5,40,5,60,20,85,45
3398,Magnant,10213,10,25,40,10,70,30,110,65
3399,Magnicourt,10214,10,36,4,4,20,4,28,40
3400,Magny-Fouchard,10215,10,40,99,15,70,62,147,139
3401,Mailly-le-Camp,10216,10,125,378,140,433,356,929,503
3402,Maison-des-Champs,10217,10,10,5,5,0,10,15,15
3403,Maisons-lès-Chaource,10218,10,15,35,15,60,35,110,50
3404,Maisons-lès-Soulaines,10219,10,9,17,0,18,9,27,26
3405,Maizières-la-Grande-Paroisse,10220,10,264,320,112,588,228,928,584
3406,Maizières-lès-Brienne,10221,10,35,40,5,70,35,110,75
3407,Maraye-en-Othe,10222,10,41,130,15,175,130,320,171
3408,Marcilly-le-Hayer,10223,10,104,156,56,188,132,376,260
3409,Marigny-le-Châtel,10224,10,212,480,108,584,348,1040,692
3410,Marnay-sur-Seine,10225,10,26,23,10,91,23,124,49
3411,Marolles-lès-Bailly,10226,10,20,20,20,20,15,55,40
3412,Marolles-sous-Lignières,10227,10,46,55,12,99,60,171,101
3413,Mathaux,10228,10,37,37,9,43,40,92,74
3414,Maupas,10229,10,8,36,12,40,20,72,44
3415,Mergey,10230,10,44,184,60,260,140,460,228
3416,Le Mériot,10231,10,56,184,36,152,168,356,240
3417,Merrey-sur-Arce,10232,10,30,75,29,78,67,174,105
3418,Méry-sur-Seine,10233,10,172,342,173,431,232,836,514
3419,Mesgrigny,10234,10,32,88,8,96,76,180,120
3420,Mesnil-la-Comtesse,10235,10,0,4,8,20,4,32,4
3421,Mesnil-Lettre,10236,10,8,32,4,16,12,32,40
3422,Mesnil-Saint-Loup,10237,10,44,172,68,208,108,384,216
3423,Mesnil-Saint-Père,10238,10,35,143,38,105,102,245,178
3424,Mesnil-Sellières,10239,10,22,159,34,174,142,350,181
3425,Messon,10240,10,26,120,20,174,63,257,146
3426,Metz-Robert,10241,10,13,8,0,17,4,21,21
3427,Meurville,10242,10,20,35,20,65,30,115,55
3428,Molins-sur-Aube,10243,10,8,20,12,20,36,68,28
3429,Montaulin,10245,10,42,204,60,270,151,481,246
3430,Montceaux-lès-Vaudes,10246,10,17,55,22,60,48,130,72
3431,Montfey,10247,10,39,30,0,35,35,70,69
3432,Montgueux,10248,10,44,105,20,150,85,255,149
3433,Montiéramey,10249,10,70,85,25,150,65,240,155
3434,Montier-en-l'Isle,10250,10,25,50,25,90,40,155,75
3435,Montigny-les-Monts,10251,10,30,65,5,115,30,150,95
3436,Montmartin-le-Haut,10252,10,0,20,0,35,10,45,20
3437,Montmorency-Beaufort,10253,10,16,24,4,56,20,80,40
3438,Montpothier,10254,10,33,77,24,66,86,176,110
3439,Montreuil-sur-Barse,10255,10,15,115,30,105,65,200,130
3440,Montsuzain,10256,10,36,124,8,124,105,237,160
3441,Morembert,10257,10,3,6,0,18,0,18,9
3442,Morvilliers,10258,10,35,65,15,115,70,200,100
3443,La Motte-Tilly,10259,10,32,104,24,160,72,256,136
3444,Moussey,10260,10,55,190,70,150,150,370,245
3445,Mussy-sur-Seine,10261,10,180,211,73,296,171,540,391
3446,Neuville-sur-Seine,10262,10,46,107,33,115,96,244,153
3447,Neuville-sur-Vanne,10263,10,55,125,15,110,120,245,180
3448,Noé-les-Mallets,10264,10,12,16,16,38,4,58,28
3449,Les Noës-près-Troyes,10265,10,555,752,292,913,472,1677,1307
3450,Nogent-en-Othe,10266,10,12,0,4,16,4,24,12
3451,Nogent-sur-Aube,10267,10,52,78,40,95,62,197,130
3452,Nogent-sur-Seine,10268,10,730,1483,779,1742,1072,3593,2213
3453,Nozay,10269,10,16,40,12,44,28,84,56
3454,Onjon,10270,10,52,64,8,60,64,132,116
3455,Origny-le-Sec,10271,10,85,168,40,223,97,360,253
3456,Ormes,10272,10,20,52,12,76,44,132,72
3457,Ortillon,10273,10,6,6,0,6,3,9,12
3458,Orvilliers-Saint-Julien,10274,10,36,92,24,80,84,188,128
3459,Ossey-les-Trois-Maisons,10275,10,84,148,44,160,132,336,232
3460,Paisy-Cosdon,10276,10,55,110,39,124,45,208,165
3461,Pargues,10278,10,4,31,23,53,0,76,35
3462,Pars-lès-Chavanges,10279,10,10,10,0,30,10,40,20
3463,Pars-lès-Romilly,10280,10,156,169,68,264,141,473,325
3464,Le Pavillon-Sainte-Julie,10281,10,35,85,15,85,70,170,120
3465,Payns,10282,10,137,360,70,450,295,815,497
3466,Pel-et-Der,10283,10,6,25,9,50,23,82,31
3467,Périgny-la-Rose,10284,10,35,20,0,45,20,65,55
3468,Perthes-lès-Brienne,10285,10,5,10,10,45,15,70,15
3469,Petit-Mesnil,10286,10,38,48,15,67,23,105,86
3470,Piney,10287,10,124,431,148,374,394,916,555
3471,Plaines-Saint-Lange,10288,10,50,30,45,110,30,185,80
3472,Plancy-l'Abbaye,10289,10,122,224,94,266,176,536,346
3473,Planty,10290,10,33,58,4,72,41,117,91
3474,Plessis-Barbuise,10291,10,30,62,29,34,35,98,92
3475,Poivres,10293,10,9,20,22,43,25,90,29
3476,Poligny,10294,10,6,25,3,10,12,25,31
3477,Polisot,10295,10,56,71,18,80,64,162,127
3478,Polisy,10296,10,9,24,16,73,29,118,33
3479,Pont-Sainte-Marie,10297,10,756,1179,511,1369,697,2577,1935
3480,Pont-sur-Seine,10298,10,136,304,108,304,200,612,440
3481,Pouan-les-Vallées,10299,10,68,148,60,184,92,336,216
3482,Pougy,10300,10,28,92,44,76,60,180,120
3483,Pouy-sur-Vannes,10301,10,35,15,20,35,25,80,50
3484,Praslin,10302,10,20,15,15,25,10,50,35
3485,Précy-Notre-Dame,10303,10,0,15,5,35,15,55,15
3486,Précy-Saint-Martin,10304,10,18,18,15,62,32,109,36
3487,Prémierfait,10305,10,20,20,10,25,10,45,40
3488,Proverville,10306,10,59,29,3,86,26,115,88
3489,Prugny,10307,10,40,104,20,160,72,252,144
3490,Prunay-Belleville,10308,10,52,72,20,64,40,124,124
3491,Prusy,10309,10,42,9,3,9,9,21,51
3492,Puits-et-Nuisement,10310,10,33,53,4,67,28,99,86
3493,Racines,10312,10,15,45,0,80,35,115,60
3494,Radonvilliers,10313,10,51,114,20,123,78,221,165
3495,Ramerupt,10314,10,75,76,12,55,79,146,151
3496,Rances,10315,10,10,0,10,25,0,35,10
3497,Rhèges,10316,10,28,72,16,72,52,140,100
3498,Les Riceys,10317,10,150,250,132,461,230,823,400
3499,Rigny-la-Nonneuse,10318,10,13,26,28,56,12,96,39
3500,Rigny-le-Ferron,10319,10,69,75,25,138,69,232,144
3501,Rilly-Sainte-Syre,10320,10,23,49,9,71,48,128,72
3502,La Rivière-de-Corps,10321,10,400,700,172,1241,462,1875,1100
3503,Romilly-sur-Seine,10323,10,2054,3368,1464,4602,2255,8321,5422
3504,Roncenay,10324,10,10,30,20,55,30,105,40
3505,Rosières-près-Troyes,10325,10,376,1065,555,1011,666,2232,1441
3506,Rosnay-l'Hôpital,10326,10,44,56,12,72,28,112,100
3507,La Rothière,10327,10,16,13,0,42,16,58,29
3508,Rouilly-Sacey,10328,10,64,88,32,132,76,240,152
3509,Rouilly-Saint-Loup,10329,10,76,92,50,202,85,337,168
3510,Rouvres-les-Vignes,10330,10,10,15,10,60,15,85,25
3511,Rumilly-lès-Vaudes,10331,10,55,120,35,205,105,345,175
3512,Ruvigny,10332,10,35,145,35,180,95,310,180
3513,Saint-André-les-Vergers,10333,10,1878,2723,1486,3451,2158,7095,4601
3514,Saint-Aubin,10334,10,65,155,45,200,120,365,220
3515,Saint-Benoist-sur-Vanne,10335,10,60,55,15,70,25,110,115
3516,Saint-Benoît-sur-Seine,10336,10,28,112,36,152,84,272,140
3517,Saint-Christophe-Dodinicourt,10337,10,4,0,4,16,0,20,4
3518,Saint-Étienne-sous-Barbuise,10338,10,32,36,12,60,8,80,68
3519,Saint-Flavy,10339,10,23,57,6,76,63,145,80
3520,Saint-Germain,10340,10,234,560,214,932,344,1490,794
3521,Saint-Hilaire-sous-Romilly,10341,10,44,56,52,104,44,200,100
3522,Saint-Jean-de-Bonneval,10342,10,25,105,8,139,94,241,130
3523,Saint-Julien-les-Villas,10343,10,991,1613,686,2162,1250,4098,2604
3524,Saint-Léger-près-Troyes,10344,10,80,210,65,328,140,533,290
3525,Saint-Léger-sous-Brienne,10345,10,70,100,35,104,95,234,170
3526,Saint-Léger-sous-Margerie,10346,10,4,12,4,20,16,40,16
3527,Saint-Loup-de-Buffigny,10347,10,12,52,20,72,52,144,64
3528,Saint-Lupien,10348,10,15,55,15,80,60,155,70
3529,Saint-Lyé,10349,10,384,655,220,1152,495,1867,1039
3530,Saint-Mards-en-Othe,10350,10,70,170,25,250,105,380,240
3531,Saint-Martin-de-Bossenay,10351,10,55,86,15,87,69,171,141
3532,Sainte-Maure,10352,10,197,284,123,587,227,937,481
3533,Saint-Mesmin,10353,10,110,210,55,244,210,509,320
3534,Saint-Nabord-sur-Aube,10354,10,20,40,5,50,20,75,60
3535,Saint-Nicolas-la-Chapelle,10355,10,0,12,0,36,9,45,12
3536,Saint-Oulph,10356,10,65,75,5,65,55,125,140
3537,Saint-Parres-aux-Tertres,10357,10,482,616,196,1043,476,1715,1098
3538,Saint-Parres-lès-Vaudes,10358,10,170,215,55,340,195,590,385
3539,Saint-Phal,10359,10,42,113,49,156,97,302,155
3540,Saint-Pouange,10360,10,73,179,57,309,141,507,252
3541,Saint-Remy-sous-Barbuise,10361,10,12,49,26,55,45,126,61
3542,Sainte-Savine,10362,10,1432,2126,1133,3376,1739,6248,3558
3543,Saint-Thibault,10363,10,86,126,29,149,111,289,212
3544,Saint-Usage,10364,10,30,15,0,20,15,35,45
3545,Salon,10365,10,45,20,10,35,10,55,65
3546,Saulcy,10366,10,6,6,9,31,3,43,12
3547,La Saulsotte,10367,10,32,216,35,209,151,395,248
3548,Savières,10368,10,85,275,70,370,210,650,360
3549,Semoine,10369,10,41,53,31,41,35,107,94
3550,Soligny-les-Étangs,10370,10,16,54,21,82,40,143,70
3551,Sommeval,10371,10,16,88,15,105,56,176,104
3552,Soulaines-Dhuys,10372,10,20,104,20,104,85,209,124
3553,Souligny,10373,10,56,104,28,136,80,244,160
3554,Spoy,10374,10,28,34,17,37,17,71,62
3555,Thennelières,10375,10,36,96,16,116,84,216,132
3556,Thieffrain,10376,10,25,40,5,55,35,95,65
3557,Thil,10377,10,18,29,6,37,19,62,47
3558,Thors,10378,10,0,15,10,40,10,60,15
3559,Torcy-le-Grand,10379,10,76,108,28,140,104,272,184
3560,Torcy-le-Petit,10380,10,0,26,0,29,26,55,26
3561,Torvilliers,10381,10,88,217,52,381,164,597,305
3562,Traînel,10382,10,124,252,88,336,208,632,376
3563,Trancault,10383,10,8,52,8,36,64,108,60
3564,Trannes,10384,10,40,50,20,80,45,145,90
3565,Trouans,10386,10,45,65,5,90,30,125,110
3566,Troyes,10387,10,7288,14044,10488,16362,10587,37437,21332
3567,Turgy,10388,10,10,10,0,30,5,35,20
3568,Unienville,10389,10,25,35,0,45,20,65,60
3569,Urville,10390,10,16,32,0,68,28,96,48
3570,Vailly,10391,10,20,50,30,125,55,210,70
3571,Vallant-Saint-Georges,10392,10,20,95,15,150,90,255,115
3572,Vallentigny,10393,10,21,42,8,85,12,105,63
3573,Vallières,10394,10,30,25,10,50,30,90,55
3574,Vanlay,10395,10,60,72,16,100,64,180,132
3575,Vauchassis,10396,10,51,115,29,172,80,281,166
3576,Vauchonvilliers,10397,10,24,52,0,52,32,84,76
3577,Vaucogne,10398,10,0,15,5,30,15,50,15
3578,Vaudes,10399,10,36,196,56,268,184,508,232
3579,Vaupoisson,10400,10,37,17,3,39,12,54,54
3580,Vendeuvre-sur-Barse,10401,10,326,619,200,694,383,1277,945
3581,La Vendue-Mignot,10402,10,30,50,10,110,30,150,80
3582,Vernonvilliers,10403,10,16,3,9,18,12,39,19
3583,Verpillières-sur-Ource,10404,10,22,23,6,30,12,48,45
3584,Verricourt,10405,10,4,8,8,8,8,24,12
3585,Verrières,10406,10,116,485,152,759,346,1257,601
3586,Viâpres-le-Petit,10408,10,16,40,8,16,40,64,56
3587,Villacerf,10409,10,36,128,32,205,144,381,164
3588,Villadin,10410,10,20,10,5,65,5,75,30
3589,La Ville-aux-Bois,10411,10,0,8,0,12,8,20,8
3590,Villechétif,10412,10,130,210,45,355,175,575,340
3591,Villeloup,10414,10,8,21,4,45,22,71,29
3592,Villemereuil,10416,10,25,44,26,73,43,142,69
3593,Villemoiron-en-Othe,10417,10,20,50,5,95,35,135,70
3594,Villemorien,10418,10,35,30,25,80,35,140,65
3595,Villemoyenne,10419,10,71,212,48,207,174,429,283
3596,Villenauxe-la-Grande,10420,10,287,501,203,717,379,1299,788
3597,La Villeneuve-au-Châtelot,10421,10,20,50,0,55,30,85,70
3598,Villeneuve-au-Chemin,10422,10,35,43,15,25,73,113,78
3599,La Villeneuve-au-Chêne,10423,10,35,104,40,166,90,296,139
3600,Villeret,10424,10,10,10,10,20,10,40,20
3601,Villery,10425,10,25,85,10,115,55,180,110
3602,Ville-sous-la-Ferté,10426,10,115,240,65,350,170,585,355
3603,Ville-sur-Arce,10427,10,60,35,25,70,40,135,95
3604,Ville-sur-Terre,10428,10,0,15,10,70,5,85,15
3605,Villette-sur-Aube,10429,10,24,88,20,68,76,164,112
3606,Villiers-Herbisse,10430,10,15,25,10,15,30,55,40
3607,Villiers-le-Bois,10431,10,15,10,10,34,25,69,25
3608,Villiers-sous-Praslin,10432,10,20,12,4,16,8,28,32
3609,Villy-en-Trodes,10433,10,20,70,20,80,65,165,90
3610,Villy-le-Bois,10434,10,0,25,0,20,20,40,25
3611,Villy-le-Maréchal,10435,10,15,58,10,78,35,123,73
3612,Vinets,10436,10,25,40,15,50,40,105,65
3613,Virey-sous-Bar,10437,10,60,190,60,200,130,390,250
3614,Vitry-le-Croisé,10438,10,55,10,45,95,30,170,65
3615,Viviers-sur-Artaut,10439,10,16,28,4,32,36,72,44
3616,Voigny,10440,10,15,25,15,75,30,120,40
3617,Vosnon,10441,10,28,60,24,88,28,140,88
3618,Voué,10442,10,64,192,36,172,180,388,256
3619,Vougrey,10443,10,4,12,0,8,16,24,16
3620,Vulaines,10444,10,30,55,15,65,50,130,85
3621,Yèvres-le-Petit,10445,10,9,0,9,22,3,34,9
3622,Aigues-Vives,11001,11,66,168,43,136,127,306,234
3623,Airoux,11002,11,44,36,8,36,28,72,80
3624,Ajac,11003,11,45,15,15,105,20,140,60
3625,Alaigne,11004,11,75,45,30,120,45,195,120
3626,Alairac,11005,11,81,396,89,375,311,775,477
3627,Albas,11006,11,25,15,0,30,15,45,40
3628,Albières,11007,11,24,10,5,50,10,65,34
3629,Alet-les-Bains,11008,11,93,45,25,178,33,236,138
3630,Alzonne,11009,11,232,366,139,469,271,879,598
3631,Antugnac,11010,11,31,69,10,125,68,203,100
3632,Aragon,11011,11,32,91,12,135,108,255,123
3633,Argeliers,11012,11,305,458,87,700,402,1189,763
3634,Argens-Minervois,11013,11,27,43,22,143,50,215,70
3635,Armissan,11014,11,211,377,68,489,303,860,588
3636,Arques,11015,11,36,64,8,96,44,148,100
3637,Arquettes-en-Val,11016,11,15,5,5,40,10,55,20
3638,Artigues,11017,11,10,15,0,55,0,55,25
3639,Arzens,11018,11,154,314,57,437,203,697,468
3640,Aunat,11019,11,24,12,0,12,8,20,36
3641,Auriac,11020,11,0,4,0,25,0,25,4
3642,Axat,11021,11,89,101,25,251,85,361,190
3643,Azille,11022,11,179,220,105,429,229,763,399
3644,Badens,11023,11,135,179,60,228,130,418,314
3645,Bages,11024,11,90,182,53,310,151,514,272
3646,Bagnoles,11025,11,65,70,20,70,75,165,135
3647,Baraigne,11026,11,10,45,30,55,45,130,55
3648,Barbaira,11027,11,119,238,55,258,118,431,357
3649,Belcaire,11028,11,106,55,35,160,30,225,161
3650,Belcastel-et-Buc,11029,11,25,5,0,25,0,25,30
3651,Belflou,11030,11,24,45,16,20,24,60,69
3652,Belfort-sur-Rebenty,11031,11,15,3,0,6,0,6,18
3653,Bellegarde-du-Razès,11032,11,16,44,20,84,44,148,60
3654,Belpech,11033,11,190,275,105,425,180,710,465
3655,Belvèze-du-Razès,11034,11,229,195,30,273,145,448,424
3656,Belvianes-et-Cavirac,11035,11,38,40,9,105,36,150,78
3657,Belvis,11036,11,32,20,16,80,8,104,52
3658,Berriac,11037,11,40,260,112,300,152,564,300
3659,Bessède-de-Sault,11038,11,12,0,12,28,4,44,12
3660,La Bezole,11039,11,0,9,0,12,15,27,9
3661,Bizanet,11040,11,197,405,120,442,357,919,602
3662,Bize-Minervois,11041,11,233,243,40,365,229,634,476
3663,Blomac,11042,11,40,48,12,68,40,120,88
3664,Bouilhonnac,11043,11,56,40,8,100,24,132,96
3665,Bouisse,11044,11,19,20,6,24,3,33,39
3666,Bouriège,11045,11,19,25,15,45,20,80,44
3667,Bourigeole,11046,11,5,10,0,20,10,30,15
3668,Le Bousquet,11047,11,13,0,0,16,0,16,13
3669,Boutenac,11048,11,123,150,29,201,130,360,273
3670,Bram,11049,11,583,776,231,1037,551,1819,1359
3671,Brézilhac,11051,11,25,53,6,18,47,71,78
3672,Brousses-et-Villaret,11052,11,40,56,24,164,68,256,96
3673,Brugairolles,11053,11,49,48,19,85,30,134,97
3674,Les Brunels,11054,11,36,56,20,104,56,180,92
3675,Bugarach,11055,11,34,34,5,124,20,149,68
3676,Cabrespine,11056,11,18,27,6,59,25,90,45
3677,Cahuzac,11057,11,8,16,0,12,16,28,24
3678,Cailhau,11058,11,43,44,16,97,32,145,87
3679,Cailhavel,11059,11,8,24,8,68,16,92,32
3680,Cailla,11060,11,20,5,0,10,5,15,25
3681,Cambieure,11061,11,24,76,12,113,80,205,100
3682,Campagna-de-Sault,11062,11,5,0,0,15,0,15,5
3683,Campagne-sur-Aude,11063,11,135,88,40,238,92,370,223
3684,Camplong-d'Aude,11064,11,46,60,24,107,46,177,106
3685,Camps-sur-l'Agly,11065,11,3,0,3,38,0,41,3
3686,Camurac,11066,11,55,5,0,45,0,45,60
3687,Canet,11067,11,224,411,164,486,350,1000,635
3688,Capendu,11068,11,270,280,100,575,205,880,550
3689,Carcassonne,11069,11,6867,10527,4947,14452,7537,26936,17394
3690,Carlipa,11070,11,44,91,16,61,84,161,135
3691,Cascastel-des-Corbières,11071,11,64,40,28,64,32,124,104
3692,La Cassaigne,11072,11,35,43,3,58,32,93,78
3693,Cassaignes,11073,11,6,7,0,18,9,27,13
3694,Les Cassés,11074,11,25,102,16,56,56,128,127
3695,Castans,11075,11,12,9,3,37,15,55,21
3696,Castelnaudary,11076,11,1871,2283,1112,3051,1690,5853,4154
3697,Castelnau-d'Aude,11077,11,86,91,40,147,78,265,177
3698,Castelreng,11078,11,9,29,7,83,38,128,38
3699,Caudebronde,11079,11,50,55,5,65,20,90,105
3700,Val de Lambronne,11080,11,44,37,29,59,9,97,81
3701,Caunes-Minervois,11081,11,265,385,155,570,235,960,650
3702,Caunette-sur-Lauquet,11082,11,0,0,7,14,0,21,0
3703,Caunettes-en-Val,11083,11,5,0,0,15,15,30,5
3704,Caux-et-Sauzens,11084,11,123,204,99,290,192,581,327
3705,Cavanac,11085,11,75,219,69,401,130,600,294
3706,Caves,11086,11,110,209,46,255,152,453,319
3707,Cazalrenoux,11087,11,16,12,0,32,12,44,28
3708,Cazilhac,11088,11,315,300,95,680,245,1020,615
3709,Cenne-Monestiés,11089,11,61,92,8,130,45,183,153
3710,Cépie,11090,11,80,128,80,272,108,460,208
3711,Chalabre,11091,11,212,140,84,448,80,612,352
3712,Citou,11092,11,21,4,4,28,12,44,25
3713,Le Clat,11093,11,5,5,0,15,5,20,10
3714,Clermont-sur-Lauquet,11094,11,10,0,0,5,0,5,10
3715,Comigne,11095,11,39,49,26,94,69,189,88
3716,Comus,11096,11,8,4,4,28,4,36,12
3717,Conilhac-de-la-Montagne,11097,11,0,4,8,48,8,64,4
3718,Conilhac-Corbières,11098,11,140,255,65,305,145,515,395
3719,Conques-sur-Orbiel,11099,11,344,540,188,766,463,1417,884
3720,Corbières,11100,11,0,0,0,12,6,18,0
3721,Coudons,11101,11,24,0,0,20,0,20,24
3722,Couffoulens,11102,11,45,135,10,306,90,406,180
3723,Couiza,11103,11,276,165,40,400,140,580,441
3724,Counozouls,11104,11,20,0,0,16,0,16,20
3725,Cournanel,11105,11,75,148,26,214,144,384,223
3726,Coursan,11106,11,881,1342,500,1999,1055,3554,2223
3727,Courtauly,11107,11,10,22,3,15,13,31,32
3728,La Courtète,11108,11,3,3,0,19,6,25,6
3729,Coustaussa,11109,11,8,4,0,20,12,32,12
3730,Coustouge,11110,11,12,16,8,44,24,76,28
3731,Cruscades,11111,11,78,231,31,148,219,398,309
3732,Cubières-sur-Cinoble,11112,11,5,20,9,59,5,73,25
3733,Cucugnan,11113,11,16,25,20,38,16,74,41
3734,Cumiès,11114,11,0,8,4,16,8,28,8
3735,Cuxac-Cabardès,11115,11,125,215,60,245,155,460,340
3736,Cuxac-d'Aude,11116,11,637,781,302,1418,584,2304,1418
3737,Davejean,11117,11,0,24,4,56,28,88,24
3738,Dernacueillette,11118,11,10,5,0,25,0,25,15
3739,La Digne-d'Amont,11119,11,45,50,35,115,30,180,95
3740,La Digne-d'Aval,11120,11,85,91,42,215,73,330,176
3741,Donazac,11121,11,16,8,8,48,8,64,24
3742,Douzens,11122,11,116,176,24,212,176,412,292
3743,Duilhac-sous-Peyrepertuse,11123,11,20,44,8,40,40,88,64
3744,Durban-Corbières,11124,11,125,100,30,235,85,350,225
3745,Embres-et-Castelmaure,11125,11,40,20,16,64,20,100,60
3746,Escales,11126,11,36,100,28,188,80,296,136
3747,Escouloubre,11127,11,40,0,10,25,0,35,40
3748,Escueillens-et-Saint-Just-de-Bélengard,11128,11,40,24,12,64,28,104,64
3749,Espéraza,11129,11,502,326,153,711,186,1050,828
3750,Espezel,11130,11,55,15,5,95,15,115,70
3751,Fa,11131,11,70,70,10,125,60,195,140
3752,Fabrezan,11132,11,214,270,100,468,244,812,484
3753,Fajac-en-Val,11133,11,5,15,0,15,15,30,20
3754,Fajac-la-Relenque,11134,11,5,15,0,35,0,35,20
3755,La Fajolle,11135,11,0,0,0,12,0,12,0
3756,Fanjeaux,11136,11,102,150,21,243,96,360,252
3757,Félines-Termenès,11137,11,20,15,0,60,15,75,35
3758,Fendeille,11138,11,64,152,36,192,136,364,216
3759,Fenouillet-du-Razès,11139,11,36,8,0,44,4,48,44
3760,Ferrals-les-Corbières,11140,11,200,245,70,425,220,715,445
3761,Ferran,11141,11,5,15,0,55,20,75,20
3762,Festes-et-Saint-André,11142,11,21,44,17,67,25,109,65
3763,Feuilla,11143,11,12,12,12,40,16,68,24
3764,Fitou,11144,11,174,224,55,301,215,571,398
3765,Fleury,11145,11,627,800,261,1563,659,2483,1427
3766,Floure,11146,11,55,130,25,80,100,205,185
3767,Fontanès-de-Sault,11147,11,0,0,0,5,0,5,0
3768,Fontcouverte,11148,11,59,94,42,199,84,325,153
3769,Fonters-du-Razès,11149,11,12,19,0,17,19,36,31
3770,Fontiers-Cabardès,11150,11,84,96,28,144,72,244,180
3771,Fontiès-d'Aude,11151,11,70,90,35,140,75,250,160
3772,Fontjoncouse,11152,11,26,11,15,57,20,92,37
3773,La Force,11153,11,41,39,0,55,35,90,80
3774,Fournes-Cabardès,11154,11,8,8,12,12,12,36,16
3775,Fourtou,11155,11,5,15,0,25,15,40,20
3776,Fraisse-Cabardès,11156,11,15,15,0,60,15,75,30
3777,Fraissé-des-Corbières,11157,11,56,52,0,68,56,124,108
3778,Gaja-et-Villedieu,11158,11,17,45,16,92,61,169,62
3779,Gaja-la-Selve,11159,11,12,29,0,51,37,88,41
3780,Galinagues,11160,11,0,6,3,15,0,18,6
3781,Gardie,11161,11,49,20,0,20,20,40,69
3782,Generville,11162,11,4,24,16,24,8,48,28
3783,Gincla,11163,11,4,4,0,8,20,28,8
3784,Ginestas,11164,11,214,313,102,456,208,766,527
3785,Ginoles,11165,11,91,35,15,150,25,190,126
3786,Gourvieille,11166,11,4,8,4,32,4,40,12
3787,Gramazie,11167,11,21,22,8,28,4,40,43
3788,Granès,11168,11,15,5,15,60,15,90,20
3789,Greffeil,11169,11,20,15,0,30,20,50,35
3790,Gruissan,11170,11,893,800,319,2027,658,3004,1693
3791,Homps,11172,11,104,100,23,185,107,315,204
3792,Hounoux,11173,11,9,30,6,58,10,74,39
3793,Les Ilhes,11174,11,9,0,0,24,4,28,9
3794,Issel,11175,11,90,95,43,158,105,306,185
3795,Jonquières,11176,11,0,5,5,15,10,30,5
3796,Joucou,11177,11,5,5,0,25,5,30,10
3797,Labastide-d'Anjou,11178,11,143,340,115,365,285,765,483
3798,Labastide-en-Val,11179,11,10,10,5,65,5,75,20
3799,Labastide-Esparbairenque,11180,11,20,24,4,36,8,48,44
3800,Labécède-Lauragais,11181,11,55,90,15,190,75,280,145
3801,Lacombe,11182,11,54,37,7,22,33,62,91
3802,Ladern-sur-Lauquet,11183,11,36,60,16,80,48,144,96
3803,Lafage,11184,11,9,35,15,20,20,55,44
3804,Lagrasse,11185,11,71,100,46,162,78,286,171
3805,Lairière,11186,11,0,4,0,16,16,32,4
3806,Lanet,11187,11,10,0,0,30,0,30,10
3807,La Palme,11188,11,326,367,104,586,240,930,693
3808,Laprade,11189,11,20,16,16,16,20,52,36
3809,La Redorte,11190,11,312,183,85,315,163,563,495
3810,Laroque-de-Fa,11191,11,12,13,12,45,19,76,25
3811,Lasbordes,11192,11,88,200,64,232,172,468,288
3812,Lasserre-de-Prouille,11193,11,28,47,13,77,51,141,75
3813,Lastours,11194,11,6,39,3,50,39,92,45
3814,Laurabuc,11195,11,48,104,20,132,88,240,152
3815,Laurac,11196,11,44,20,15,78,10,103,64
3816,Lauraguel,11197,11,100,140,25,210,130,365,240
3817,Laure-Minervois,11198,11,143,221,56,354,192,602,364
3818,Lavalette,11199,11,120,360,196,516,252,964,480
3819,Lespinassière,11200,11,17,8,4,58,12,74,25
3820,Leuc,11201,11,79,195,42,279,171,492,274
3821,Leucate,11202,11,895,625,237,1987,621,2845,1520
3822,Lézignan-Corbières,11203,11,1623,2836,1082,3328,1958,6368,4459
3823,Lignairolles,11204,11,17,4,4,12,0,16,21
3824,Limousis,11205,11,25,13,8,38,16,62,38
3825,Limoux,11206,11,1924,1918,871,3312,1576,5759,3842
3826,Loupia,11207,11,16,68,20,100,48,168,84
3827,La Louvière-Lauragais,11208,11,15,5,10,45,0,55,20
3828,Luc-sur-Aude,11209,11,52,32,8,80,32,120,84
3829,Luc-sur-Orbieu,11210,11,180,245,76,406,213,695,425
3830,Magrie,11211,11,130,76,29,179,65,273,206
3831,Mailhac,11212,11,85,114,22,157,108,287,199
3832,Maisons,11213,11,20,4,0,16,0,16,24
3833,Malras,11214,11,54,58,25,107,61,193,112
3834,Malves-en-Minervois,11215,11,108,188,100,256,164,520,296
3835,Malviès,11216,11,70,82,15,100,82,197,152
3836,Marcorignan,11217,11,148,284,92,519,196,807,432
3837,Marquein,11218,11,4,20,8,24,12,44,24
3838,Marsa,11219,11,0,0,0,16,0,16,0
3839,Marseillette,11220,11,80,110,65,343,110,518,190
3840,Les Martys,11221,11,60,60,16,96,32,144,120
3841,Mas-Cabardès,11222,11,35,45,15,85,25,125,80
3842,Mas-des-Cours,11223,11,0,10,0,5,10,15,10
3843,Massac,11224,11,8,0,0,16,4,20,8
3844,Mas-Saintes-Puelles,11225,11,143,239,39,280,147,466,382
3845,Mayreville,11226,11,20,4,0,20,8,28,24
3846,Mayronnes,11227,11,5,0,0,5,15,20,5
3847,Mazerolles-du-Razès,11228,11,32,36,16,84,8,108,68
3848,Mazuby,11229,11,8,0,0,12,0,12,8
3849,Mérial,11230,11,8,8,0,12,8,20,16
3850,Mézerville,11231,11,8,25,17,17,28,62,33
3851,Miraval-Cabardès,11232,11,3,0,3,12,0,15,3
3852,Mirepeisset,11233,11,70,195,45,295,135,475,265
3853,Mireval-Lauragais,11234,11,16,28,16,60,20,96,44
3854,Missègre,11235,11,15,7,0,22,3,25,22
3855,Molandier,11236,11,16,43,21,92,22,135,59
3856,Molleville,11238,11,4,36,8,32,32,72,40
3857,Montauriol,11239,11,0,28,8,44,8,60,28
3858,Montazels,11240,11,72,116,16,264,104,384,188
3859,Montbrun-des-Corbières,11241,11,70,100,40,75,55,170,170
3860,Montclar,11242,11,32,28,8,84,16,108,60
3861,Montferrand,11243,11,95,135,55,185,75,315,230
3862,Montfort-sur-Boulzane,11244,11,11,10,0,22,12,34,21
3863,Montgaillard,11245,11,0,8,0,32,4,36,8
3864,Montgradail,11246,11,8,12,0,36,16,52,20
3865,Monthaut,11247,11,8,4,0,24,12,36,12
3866,Montirat,11248,11,10,15,0,25,25,50,25
3867,Montjardin,11249,11,0,15,15,50,5,70,15
3868,Montjoi,11250,11,3,3,3,6,12,21,6
3869,Montlaur,11251,11,92,100,12,212,92,316,192
3870,Montmaur,11252,11,35,45,20,150,40,210,80
3871,Montolieu,11253,11,168,152,28,300,124,452,320
3872,Montréal,11254,11,310,517,120,560,350,1030,827
3873,Montredon-des-Corbières,11255,11,185,320,110,405,290,805,505
3874,Montséret,11256,11,80,132,20,180,128,328,212
3875,Monze,11257,11,17,56,8,90,24,122,73
3876,Moussan,11258,11,216,508,100,652,360,1112,724
3877,Moussoulens,11259,11,123,270,55,297,268,620,393
3878,Mouthoumet,11260,11,10,35,5,36,20,61,45
3879,Moux,11261,11,132,124,40,268,100,408,256
3880,Narbonne,11262,11,8267,11444,6044,17023,8885,31952,19711
3881,Nébias,11263,11,40,25,25,95,35,155,65
3882,Névian,11264,11,128,346,82,355,276,713,474
3883,Niort-de-Sault,11265,11,12,0,0,6,0,6,12
3884,Port-la-Nouvelle,11266,11,1150,1050,360,2115,875,3350,2200
3885,Ornaisons,11267,11,226,284,120,357,194,671,510
3886,Orsans,11268,11,9,25,3,27,9,39,34
3887,Ouveillan,11269,11,408,484,188,744,444,1376,892
3888,Padern,11270,11,28,9,6,57,0,63,37
3889,Palairac,11271,11,5,5,0,20,0,20,10
3890,Palaja,11272,11,210,521,192,918,324,1434,731
3891,Paraza,11273,11,125,150,55,240,95,390,275
3892,Pauligne,11274,11,64,56,16,136,64,216,120
3893,Payra-sur-l'Hers,11275,11,24,36,24,84,12,120,60
3894,Paziols,11276,11,85,88,34,195,98,327,173
3895,Pécharic-et-le-Py,11277,11,10,0,0,10,0,10,10
3896,Pech-Luna,11278,11,6,18,0,60,12,72,24
3897,Pennautier,11279,11,331,528,150,886,311,1347,859
3898,Pépieux,11280,11,208,208,108,288,196,592,416
3899,Pexiora,11281,11,176,372,80,353,285,718,548
3900,Peyrefitte-du-Razès,11282,11,3,6,0,10,12,22,9
3901,Peyrefitte-sur-l'Hers,11283,11,12,12,4,20,16,40,24
3902,Peyrens,11284,11,42,133,24,142,112,278,175
3903,Peyriac-de-Mer,11285,11,149,210,90,474,155,719,359
3904,Peyriac-Minervois,11286,11,200,240,68,400,204,672,440
3905,Peyrolles,11287,11,22,4,4,34,4,42,26
3906,Pezens,11288,11,190,350,129,468,225,822,540
3907,Pieusse,11289,11,196,204,88,336,188,612,400
3908,Plaigne,11290,11,12,18,4,44,16,64,30
3909,Plavilla,11291,11,5,11,0,42,15,57,16
3910,La Pomarède,11292,11,30,25,0,75,25,100,55
3911,Pomas,11293,11,122,182,96,282,138,516,304
3912,Pomy,11294,11,12,8,4,4,8,16,20
3913,Portel-des-Corbières,11295,11,151,276,90,442,228,760,427
3914,Pouzols-Minervois,11296,11,67,104,25,159,103,287,171
3915,Pradelles-Cabardès,11297,11,30,20,0,85,10,95,50
3916,Pradelles-en-Val,11298,11,35,50,15,70,20,105,85
3917,Preixan,11299,11,118,118,43,173,94,310,236
3918,Puginier,11300,11,12,32,44,40,32,116,44
3919,Puichéric,11301,11,204,237,60,428,162,650,441
3920,Puilaurens,11302,11,42,43,12,98,36,146,85
3921,Puivert,11303,11,68,96,44,228,88,360,164
3922,Quillan,11304,11,800,538,140,1429,393,1962,1338
3923,Quintillan,11305,11,24,0,0,24,8,32,24
3924,Quirbajou,11306,11,12,24,4,16,4,24,36
3925,Raissac-d'Aude,11307,11,28,36,28,120,32,180,64
3926,Raissac-sur-Lampy,11308,11,25,135,20,154,105,279,160
3927,Rennes-le-Château,11309,11,8,0,4,36,4,44,8
3928,Rennes-les-Bains,11310,11,72,20,20,52,40,112,92
3929,Ribaute,11311,11,65,40,25,80,25,130,105
3930,Ribouisse,11312,11,12,24,4,40,24,68,36
3931,Ricaud,11313,11,20,85,10,95,90,195,105
3932,Rieux-en-Val,11314,11,30,10,10,35,10,55,40
3933,Rieux-Minervois,11315,11,400,402,126,716,271,1113,802
3934,Rivel,11316,11,50,30,5,90,25,120,80
3935,Rodome,11317,11,40,25,0,20,30,50,65
3936,Roquecourbe-Minervois,11318,11,8,28,16,48,28,92,36
3937,Roquefère,11319,11,0,16,8,37,8,53,16
3938,Roquefeuil,11320,11,48,52,8,111,16,135,100
3939,Roquefort-de-Sault,11321,11,35,5,5,35,5,45,40
3940,Roquefort-des-Corbières,11322,11,135,215,100,385,180,665,350
3941,Roquetaillade,11323,11,53,30,6,66,27,99,83
3942,Roubia,11324,11,100,116,48,152,100,300,216
3943,Rouffiac-d'Aude,11325,11,36,92,56,148,96,300,128
3944,Rouffiac-des-Corbières,11326,11,0,20,5,40,25,70,20
3945,Roullens,11327,11,35,91,56,244,45,345,126
3946,Routier,11328,11,45,60,5,110,30,145,105
3947,Rouvenac,11329,11,38,16,21,85,29,135,54
3948,Rustiques,11330,11,41,121,25,182,81,288,162
3949,Saint-Amans,11331,11,16,8,4,44,0,48,24
3950,Saint-André-de-Roquelongue,11332,11,190,328,80,465,284,829,518
3951,Saint-Benoît,11333,11,12,32,4,52,20,76,44
3952,Sainte-Camelle,11334,11,4,36,12,20,28,60,40
3953,Sainte-Colombe-sur-Guette,11335,11,6,10,3,21,3,27,16
3954,Sainte-Colombe-sur-l'Hers,11336,11,90,45,45,175,65,285,135
3955,Saint-Couat-d'Aude,11337,11,65,85,10,140,99,249,150
3956,Saint-Couat-du-Razès,11338,11,0,16,0,24,16,40,16
3957,Saint-Denis,11339,11,96,116,40,192,76,308,212
3958,Sainte-Eulalie,11340,11,48,124,48,180,116,344,172
3959,Saint-Ferriol,11341,11,24,16,4,56,16,76,40
3960,Saint-Frichoux,11342,11,20,53,25,50,50,125,73
3961,Saint-Gaudéric,11343,11,0,24,0,40,24,64,24
3962,Saint-Hilaire,11344,11,108,112,52,241,110,403,220
3963,Saint-Jean-de-Barrou,11345,11,33,40,0,158,20,178,73
3964,Saint-Jean-de-Paracol,11346,11,4,24,4,56,24,84,28
3965,Saint-Julia-de-Bec,11347,11,28,12,4,32,8,44,40
3966,Saint-Julien-de-Briola,11348,11,13,13,0,28,16,44,26
3967,Saint-Just-et-le-Bézu,11350,11,10,10,0,15,10,25,20
3968,Saint-Laurent-de-la-Cabrerisse,11351,11,209,150,40,201,136,377,359
3969,Saint-Louis-et-Parahou,11352,11,0,8,12,36,4,52,8
3970,Saint-Marcel-sur-Aude,11353,11,219,550,142,553,362,1057,769
3971,Saint-Martin-des-Puits,11354,11,4,0,4,16,4,24,4
3972,Saint-Martin-de-Villereglan,11355,11,44,104,24,132,76,232,148
3973,Saint-Martin-Lalande,11356,11,79,264,105,432,166,703,343
3974,Saint-Martin-le-Vieil,11357,11,60,45,10,70,50,130,105
3975,Saint-Martin-Lys,11358,11,5,0,0,15,15,30,5
3976,Saint-Michel-de-Lanès,11359,11,64,85,30,110,107,247,149
3977,Saint-Nazaire-d'Aude,11360,11,213,521,135,655,405,1195,734
3978,Saint-Papoul,11361,11,80,168,55,241,176,472,248
3979,Saint-Paulet,11362,11,25,45,10,55,50,115,70
3980,Saint-Pierre-des-Champs,11363,11,28,24,8,76,36,120,52
3981,Saint-Polycarpe,11364,11,22,20,6,59,16,81,42
3982,Saint-Sernin,11365,11,0,20,0,25,10,35,20
3983,Sainte-Valière,11366,11,75,125,70,231,98,399,200
3984,Saissac,11367,11,157,178,47,225,153,425,335
3985,Sallèles-Cabardès,11368,11,20,20,12,32,16,60,40
3986,Sallèles-d'Aude,11369,11,365,695,244,896,584,1724,1060
3987,Salles-d'Aude,11370,11,478,759,216,1008,626,1850,1237
3988,Salles-sur-l'Hers,11371,11,126,153,68,202,118,388,279
3989,Salsigne,11372,11,76,100,28,148,56,232,176
3990,Salvezines,11373,11,30,4,0,29,0,29,34
3991,Salza,11374,11,10,0,0,5,0,5,10
3992,Seignalens,11375,11,0,0,4,28,0,32,0
3993,La Serpent,11376,11,15,15,5,45,10,60,30
3994,Serres,11377,11,16,4,0,25,0,25,20
3995,Serviès-en-Val,11378,11,32,40,40,84,32,156,72
3996,Sigean,11379,11,793,1179,365,2058,1029,3452,1972
3997,Sonnac-sur-l'Hers,11380,11,26,21,11,85,10,106,47
3998,Sougraigne,11381,11,12,20,0,44,8,52,32
3999,Souilhanels,11382,11,12,88,23,152,56,231,100
4000,Souilhe,11383,11,12,77,16,79,72,167,89
4001,Soulatgé,11384,11,12,12,20,68,12,100,24
4002,Soupex,11385,11,49,73,12,52,78,142,122
4003,Talairan,11386,11,98,53,12,123,58,193,151
4004,Taurize,11387,11,26,21,0,16,17,33,47
4005,Termes,11388,11,20,0,0,10,0,10,20
4006,Terroles,11389,11,0,0,0,4,0,4,0
4007,Thézan-des-Corbières,11390,11,88,84,56,200,96,352,172
4008,La Tourette-Cabardès,11391,11,4,0,0,16,0,16,4
4009,Tournissan,11392,11,56,48,24,104,24,152,104
4010,Tourouzelle,11393,11,85,100,10,173,85,268,185
4011,Tourreilles,11394,11,15,35,10,40,25,75,50
4012,Trassanel,11395,11,0,10,0,10,15,25,10
4013,Trausse,11396,11,72,104,44,212,76,332,176
4014,Trèbes,11397,11,987,1257,437,1753,844,3034,2244
4015,Treilles,11398,11,29,35,9,80,35,124,64
4016,Tréville,11399,11,0,19,9,37,15,61,19
4017,Tréziers,11400,11,5,25,10,35,25,70,30
4018,Tuchan,11401,11,158,110,42,275,99,416,268
4019,Valmigère,11402,11,10,0,0,5,0,5,10
4020,Ventenac-Cabardès,11404,11,80,205,56,352,166,574,285
4021,Ventenac-en-Minervois,11405,11,74,80,30,244,85,359,154
4022,Véraza,11406,11,14,5,5,15,0,20,19
4023,Verdun-en-Lauragais,11407,11,40,56,24,96,52,172,96
4024,Verzeille,11408,11,51,139,29,108,122,259,190
4025,Vignevieille,11409,11,26,12,0,26,9,35,38
4026,Villalier,11410,11,116,248,56,388,148,592,364
4027,Villanière,11411,11,30,32,5,36,41,82,62
4028,Villardebelle,11412,11,9,3,3,21,3,27,12
4029,Villardonnel,11413,11,54,67,41,212,41,294,121
4030,Villar-en-Val,11414,11,3,6,0,14,6,20,9
4031,Villar-Saint-Anselme,11415,11,12,24,32,36,20,88,36
4032,Villarzel-Cabardès,11416,11,16,57,24,40,68,132,73
4033,Villarzel-du-Razès,11417,11,16,12,24,44,4,72,28
4034,Villasavary,11418,11,155,340,125,390,210,725,495
4035,Villautou,11419,11,5,25,15,15,10,40,30
4036,Villebazy,11420,11,20,17,4,30,20,54,37
4037,Villedaigne,11421,11,96,112,40,152,100,292,208
4038,Villedubert,11422,11,50,85,15,125,50,190,135
4039,Villefloure,11423,11,12,36,24,68,32,124,48
4040,Villefort,11424,11,20,30,15,30,10,55,50
4041,Villegailhenc,11425,11,289,382,145,545,279,969,671
4042,Villegly,11426,11,144,276,84,344,228,656,420
4043,Villelongue-d'Aude,11427,11,29,33,22,151,32,205,62
4044,Villemagne,11428,11,40,45,25,100,50,175,85
4045,Villemoustaussou,11429,11,482,1100,337,1448,899,2684,1582
4046,Villeneuve-la-Comptal,11430,11,166,313,60,424,204,688,479
4047,Villeneuve-les-Corbières,11431,11,40,50,30,100,30,160,90
4048,Villeneuve-lès-Montréal,11432,11,40,68,24,84,40,148,108
4049,Villeneuve-Minervois,11433,11,140,215,55,405,175,635,355
4050,Villepinte,11434,11,130,393,129,345,295,769,523
4051,Villerouge-Termenès,11435,11,45,9,12,27,15,54,54
4052,Villesèque-des-Corbières,11436,11,80,96,16,80,92,188,176
4053,Villesèquelande,11437,11,115,244,76,239,155,470,359
4054,Villesiscle,11438,11,60,72,16,102,79,197,132
4055,Villespy,11439,11,61,87,50,124,48,222,148
4056,Villetritouls,11440,11,8,0,4,20,0,24,8
4057,Vinassan,11441,11,340,567,176,952,494,1622,907
4058,Agen-d'Aveyron,12001,12,155,260,35,420,185,640,415
4059,Aguessac,12002,12,51,214,56,263,193,512,265
4060,Les Albres,12003,12,43,48,26,137,34,197,91
4061,Almont-les-Junies,12004,12,100,104,36,148,84,268,204
4062,Alrance,12006,12,120,60,15,155,25,195,180
4063,Ambeyrac,12007,12,70,55,0,65,15,80,125
4064,Anglars-Saint-Félix,12008,12,88,209,25,249,164,438,297
4065,Arnac-sur-Dourdou,12009,12,0,0,4,28,0,32,0
4066,Arques,12010,12,30,40,20,35,15,70,70
4067,Arvieu,12011,12,147,155,30,255,110,395,302
4068,Asprières,12012,12,124,150,50,205,145,400,274
4069,Aubin,12013,12,708,725,180,1536,591,2307,1433
4070,Auriac-Lagast,12015,12,60,35,15,85,25,125,95
4071,Auzits,12016,12,173,155,85,285,125,495,328
4072,Ayssènes,12017,12,36,28,8,88,40,136,64
4073,Balaguier-d'Olt,12018,12,23,35,10,65,20,95,58
4074,Balaguier-sur-Rance,12019,12,15,10,5,40,10,55,25
4075,Balsac,12020,12,62,162,35,213,83,331,224
4076,Le Bas Ségala,12021,12,347,292,92,635,213,940,639
4077,La Bastide-Pradines,12022,12,20,5,5,65,0,70,25
4078,La Bastide-Solages,12023,12,29,6,12,48,3,63,35
4079,Belcastel,12024,12,60,15,10,95,5,110,75
4080,Belmont-sur-Rance,12025,12,152,164,92,296,152,540,316
4081,Bertholène,12026,12,160,224,116,380,132,628,384
4082,Bessuéjouls,12027,12,21,32,16,100,51,167,53
4083,Boisse-Penchot,12028,12,105,110,30,225,45,300,215
4084,Bor-et-Bar,12029,12,40,40,10,80,35,125,80
4085,Bouillac,12030,12,94,110,15,149,65,229,204
4086,Bournazel,12031,12,44,83,8,80,84,172,127
4087,Boussac,12032,12,77,155,29,115,133,277,232
4088,Bozouls,12033,12,339,598,250,939,510,1699,937
4089,Brandonnet,12034,12,32,63,30,132,47,209,95
4090,Brasc,12035,12,22,27,3,54,23,80,49
4091,Brommat,12036,12,86,124,28,245,97,370,210
4092,Broquiès,12037,12,143,61,33,192,81,306,204
4093,Brousse-le-Château,12038,12,40,25,5,65,24,94,65
4094,Brusque,12039,12,56,46,9,102,13,124,102
4095,Cabanès,12041,12,52,44,0,100,36,136,96
4096,Calmels-et-le-Viala,12042,12,40,35,10,100,25,135,75
4097,Calmont,12043,12,145,470,115,702,385,1202,615
4098,Camarès,12044,12,162,203,73,316,124,513,365
4099,Camboulazet,12045,12,66,145,39,84,97,220,211
4100,Camjac,12046,12,120,135,20,230,75,325,255
4101,Campagnac,12047,12,104,108,28,136,88,252,212
4102,Campouriez,12048,12,119,53,15,95,33,143,172
4103,Campuac,12049,12,118,59,34,129,62,225,177
4104,Canet-de-Salars,12050,12,78,96,4,145,66,215,174
4105,Cantoin,12051,12,60,50,15,137,35,187,110
4106,Capdenac-Gare,12052,12,949,840,395,1481,765,2641,1789
4107,La Capelle-Balaguier,12053,12,42,36,56,84,45,185,78
4108,La Capelle-Bleys,12054,12,84,84,32,136,40,208,168
4109,La Capelle-Bonance,12055,12,20,12,24,24,8,56,32
4110,Baraqueville,12056,12,391,740,278,1029,533,1840,1131
4111,Cassagnes-Bégonhès,12057,12,187,166,48,267,160,475,353
4112,Cassuéjouls,12058,12,28,21,0,35,13,48,49
4113,Castanet,12059,12,124,108,36,200,76,312,232
4114,Castelmary,12060,12,45,16,0,38,6,44,61
4115,Castelnau-de-Mandailles,12061,12,92,92,21,223,75,319,184
4116,Castelnau-Pégayrols,12062,12,48,76,48,128,52,228,124
4117,La Cavalerie,12063,12,80,290,100,320,240,660,370
4118,Le Cayrol,12064,12,55,31,9,65,38,112,86
4119,Centrès,12065,12,153,81,5,188,50,243,234
4120,Clairvaux-d'Aveyron,12066,12,152,260,76,332,216,624,412
4121,Le Clapier,12067,12,4,20,8,44,8,60,24
4122,Colombiès,12068,12,204,162,38,292,140,470,366
4123,Combret,12069,12,40,55,20,100,55,175,95
4124,Compeyre,12070,12,72,102,22,202,77,301,174
4125,Compolibat,12071,12,65,75,25,135,40,200,140
4126,Comprégnac,12072,12,10,90,5,95,55,155,100
4127,Comps-la-Grand-Ville,12073,12,95,170,25,140,150,315,265
4128,Condom-d'Aubrac,12074,12,65,50,5,150,30,185,115
4129,Connac,12075,12,20,15,0,65,0,65,35
4130,Conques-en-Rouergue,12076,12,306,298,75,607,279,961,604
4131,Cornus,12077,12,76,104,76,152,92,320,180
4132,Les Costes-Gozon,12078,12,38,26,20,52,25,97,64
4133,Coubisou,12079,12,111,92,3,157,68,228,203
4134,Coupiac,12080,12,90,30,30,220,35,285,120
4135,La Couvertoirade,12082,12,48,24,4,80,24,108,72
4136,Cransac,12083,12,360,260,140,575,205,920,620
4137,Creissels,12084,12,217,373,108,518,290,916,590
4138,Crespin,12085,12,48,44,8,144,40,192,92
4139,La Cresse,12086,12,75,65,40,97,55,192,140
4140,Curières,12088,12,49,43,17,50,29,96,92
4141,Decazeville,12089,12,1122,1083,511,1862,780,3153,2205
4142,Druelle,12090,12,172,582,165,797,467,1429,754
4143,Drulhe,12091,12,56,100,36,184,60,280,156
4144,Durenque,12092,12,135,135,25,150,110,285,270
4145,Le Fel,12093,12,21,20,8,77,17,102,41
4146,Entraygues-sur-Truyère,12094,12,252,140,64,384,120,568,392
4147,Escandolières,12095,12,28,28,16,108,28,152,56
4148,Espalion,12096,12,905,769,298,1459,737,2494,1674
4149,Espeyrac,12097,12,64,36,12,96,24,132,100
4150,Estaing,12098,12,155,89,30,210,41,281,244
4151,Fayet,12099,12,50,55,10,85,55,150,105
4152,Firmi,12100,12,469,452,100,951,324,1375,921
4153,Flagnac,12101,12,144,196,56,412,176,644,340
4154,Flavin,12102,12,167,603,150,790,500,1440,770
4155,Florentin-la-Capelle,12103,12,105,30,5,120,30,155,135
4156,Foissac,12104,12,92,116,24,96,124,244,208
4157,La Fouillade,12105,12,210,215,75,420,145,640,425
4158,Gabriac,12106,12,100,105,15,185,90,290,205
4159,Gaillac-d'Aveyron,12107,12,55,60,20,120,45,185,115
4160,Galgan,12108,12,47,71,18,119,42,179,118
4161,Gissac,12109,12,12,28,8,32,32,72,40
4162,Golinhac,12110,12,60,56,10,158,61,229,116
4163,Goutrens,12111,12,80,145,35,120,130,285,225
4164,Gramond,12113,12,43,115,21,123,54,198,158
4165,L'Hospitalet-du-Larzac,12115,12,30,91,25,75,76,176,121
4166,Huparlac,12116,12,64,43,8,63,39,110,107
4167,Lacroix-Barrez,12118,12,78,43,42,214,49,305,121
4168,Laguiole,12119,12,192,232,140,424,196,760,424
4169,Laissac-Sévérac l'Église,12120,12,344,451,164,682,353,1199,795
4170,Lanuéjouls,12121,12,140,145,49,208,115,372,285
4171,Lapanouse-de-Cernon,12122,12,9,29,6,44,12,62,38
4172,Lassouts,12124,12,60,65,15,110,60,185,125
4173,Laval-Roquecezière,12125,12,70,30,9,78,21,108,100
4174,Lédergues,12127,12,164,136,20,268,120,408,300
4175,Lescure-Jaoul,12128,12,75,35,10,109,25,144,110
4176,Lestrade-et-Thouels,12129,12,80,105,10,190,85,285,185
4177,Livinhac-le-Haut,12130,12,242,226,68,331,178,577,468
4178,La Loubière,12131,12,167,326,130,554,222,906,493
4179,Luc-la-Primaube,12133,12,783,1325,555,1929,1148,3632,2108
4180,Lugan,12134,12,45,65,30,105,50,185,110
4181,Lunac,12135,12,38,76,4,185,43,232,114
4182,Maleville,12136,12,196,248,28,308,200,536,444
4183,Manhac,12137,12,75,230,85,220,175,480,305
4184,Marcillac-Vallon,12138,12,261,364,116,403,317,836,625
4185,Marnhagues-et-Latour,12139,12,26,12,0,40,6,46,38
4186,Martiel,12140,12,192,217,76,288,172,536,409
4187,Martrin,12141,12,48,36,12,76,52,140,84
4188,Mayran,12142,12,80,180,40,185,150,375,260
4189,Mélagues,12143,12,15,6,0,18,6,24,21
4190,Meljac,12144,12,52,12,0,52,16,68,64
4191,Millau,12145,12,3879,4597,1793,7491,3598,12882,8476
4192,Le Monastère,12146,12,248,495,192,749,396,1337,743
4193,Montagnol,12147,12,19,25,3,33,23,59,44
4194,Montbazens,12148,12,210,285,115,470,255,840,495
4195,Montclar,12149,12,38,26,6,37,19,62,64
4196,Monteils,12150,12,120,120,20,185,75,280,240
4197,Montézic,12151,12,30,41,20,111,35,166,71
4198,Montfranc,12152,12,41,12,0,45,8,53,53
4199,Montjaux,12153,12,40,53,15,198,55,268,93
4200,Montlaur,12154,12,80,145,45,265,120,430,225
4201,Fondamente,12155,12,75,50,20,105,60,185,125
4202,Montpeyroux,12156,12,150,85,45,195,80,320,235
4203,Montrozier,12157,12,147,440,110,530,343,983,587
4204,Montsalès,12158,12,45,64,22,69,75,166,109
4205,Morlhon-le-Haut,12159,12,116,112,20,216,100,336,228
4206,Mostuéjouls,12160,12,45,40,20,135,60,215,85
4207,Mouret,12161,12,57,110,42,181,84,307,167
4208,Moyrazès,12162,12,136,288,84,380,236,700,424
4209,Murasson,12163,12,30,20,10,69,25,104,50
4210,Mur-de-Barrez,12164,12,179,130,60,235,85,380,309
4211,Muret-le-Château,12165,12,30,95,10,90,105,205,125
4212,Murols,12166,12,35,17,6,28,9,43,52
4213,Najac,12167,12,168,82,18,229,127,374,250
4214,Nant,12168,12,140,180,28,324,132,484,320
4215,Naucelle,12169,12,396,377,84,696,316,1096,773
4216,Naussac,12170,12,60,68,16,144,68,228,128
4217,Nauviale,12171,12,61,126,31,141,108,280,187
4218,Le Nayrac,12172,12,148,68,28,208,52,288,216
4219,Olemps,12174,12,330,645,251,1174,467,1892,975
4220,Ols-et-Rinhodes,12175,12,24,44,16,60,16,92,68
4221,Onet-le-Château,12176,12,1487,2771,1328,3855,2087,7270,4258
4222,Palmas d'Aveyron,12177,12,131,231,99,367,127,593,362
4223,Paulhe,12178,12,40,100,25,149,80,254,140
4224,Peux-et-Couffouleux,12179,12,50,15,0,25,10,35,65
4225,Peyreleau,12180,12,5,15,5,40,10,55,20
4226,Peyrusse-le-Roc,12181,12,70,40,15,65,30,110,110
4227,Pierrefiche,12182,12,68,60,20,84,44,148,128
4228,Plaisance,12183,12,34,12,16,105,12,133,46
4229,Pomayrols,12184,12,35,10,0,65,0,65,45
4230,Pont-de-Salars,12185,12,230,347,105,450,245,800,577
4231,Pousthomy,12186,12,28,40,24,64,48,136,68
4232,Prades-d'Aubrac,12187,12,75,34,13,222,42,277,109
4233,Prades-Salars,12188,12,40,53,29,76,54,159,93
4234,Pradinas,12189,12,53,67,10,113,72,195,120
4235,Prévinquières,12190,12,55,65,25,100,45,170,120
4236,Privezac,12191,12,68,80,16,132,56,204,148
4237,Mounes-Prohencoux,12192,12,25,25,12,76,20,108,50
4238,Pruines,12193,12,64,80,0,80,84,164,144
4239,Quins,12194,12,104,200,68,272,184,524,304
4240,Rebourguil,12195,12,48,64,12,88,60,160,112
4241,Réquista,12197,12,415,308,130,710,320,1160,723
4242,Rieupeyroux,12198,12,450,415,105,748,245,1098,865
4243,Rignac,12199,12,370,435,120,479,330,929,805
4244,Rivière-sur-Tarn,12200,12,144,228,104,308,176,588,372
4245,Rodelle,12201,12,88,259,88,390,224,702,347
4246,Rodez,12202,12,3142,4973,3782,7114,3981,14877,8115
4247,Roquefort-sur-Soulzon,12203,12,51,115,45,235,106,386,166
4248,La Roque-Sainte-Marguerite,12204,12,35,55,5,80,20,105,90
4249,La Rouquette,12205,12,106,185,33,288,122,443,291
4250,Roussennac,12206,12,89,150,40,189,78,307,239
4251,Rullac-Saint-Cirq,12207,12,90,85,20,110,60,190,175
4252,Saint-Affrique,12208,12,1471,1557,858,2525,1258,4641,3028
4253,Saint-Amans-des-Cots,12209,12,172,109,40,234,81,355,281
4254,Saint-André-de-Najac,12210,12,86,67,15,123,64,202,153
4255,Saint-André-de-Vézines,12211,12,0,21,8,64,21,93,21
4256,Saint-Beaulize,12212,12,9,19,6,40,6,52,28
4257,Saint-Beauzély,12213,12,64,116,40,228,96,364,180
4258,Saint-Chély-d'Aubrac,12214,12,88,64,48,208,76,332,152
4259,Saint-Christophe-Vallon,12215,12,125,270,105,425,185,715,395
4260,Saint-Côme-d'Olt,12216,12,157,226,78,493,144,715,383
4261,Sainte-Croix,12217,12,112,164,16,240,164,420,276
4262,Sainte-Eulalie-d'Olt,12219,12,100,58,20,141,26,187,158
4263,Sainte-Eulalie-de-Cernon,12220,12,51,39,16,90,47,153,90
4264,Saint-Félix-de-Lunel,12221,12,74,47,37,155,58,250,121
4265,Saint-Félix-de-Sorgues,12222,12,40,48,8,80,32,120,88
4266,Argences en Aubrac,12223,12,346,218,98,658,220,976,564
4267,Saint Geniez d'Olt et d'Aubrac,12224,12,399,337,107,697,291,1095,736
4268,Saint-Georges-de-Luzençon,12225,12,225,368,107,525,267,899,593
4269,Saint-Hippolyte,12226,12,112,80,28,188,52,268,192
4270,Saint-Igest,12227,12,40,48,20,36,44,100,88
4271,Saint-Izaire,12228,12,34,39,32,98,42,172,73
4272,Saint-Jean-d'Alcapiès,12229,12,35,85,20,90,40,150,120
4273,Saint-Jean-Delnous,12230,12,50,85,40,100,70,210,135
4274,Saint-Jean-du-Bruel,12231,12,155,62,44,252,65,361,217
4275,Saint-Jean-et-Saint-Paul,12232,12,13,63,20,75,60,155,76
4276,Saint-Juéry,12233,12,48,48,28,108,52,188,96
4277,Sainte-Juliette-sur-Viaur,12234,12,70,175,45,135,165,345,245
4278,Saint-Just-sur-Viaur,12235,12,48,44,16,88,24,128,92
4279,Saint-Laurent-de-Lévézou,12236,12,20,28,8,72,24,104,48
4280,Saint-Laurent-d'Olt,12237,12,108,116,40,240,76,356,224
4281,Saint-Léons,12238,12,33,74,34,96,80,210,107
4282,Saint-Martin-de-Lenne,12239,12,58,70,40,100,30,170,128
4283,Saint-Parthem,12240,12,95,60,35,170,50,255,155
4284,Sainte-Radegonde,12241,12,168,457,96,625,365,1086,625
4285,Saint-Rémy,12242,12,28,76,28,164,48,240,104
4286,Saint-Rome-de-Cernon,12243,12,164,184,73,240,169,482,348
4287,Saint-Rome-de-Tarn,12244,12,114,113,85,271,127,483,227
4288,Saint-Santin,12246,12,70,121,28,174,126,328,191
4289,Saint-Saturnin-de-Lenne,12247,12,111,61,25,75,35,135,172
4290,Saint-Sernin-sur-Rance,12248,12,72,110,76,159,67,302,182
4291,Saint-Sever-du-Moustier,12249,12,53,52,10,85,27,122,105
4292,Saint-Symphorien-de-Thénières,12250,12,40,20,25,100,25,150,60
4293,Saint-Victor-et-Melvieu,12251,12,70,70,20,150,65,235,140
4294,Salles-Courbatiès,12252,12,41,70,26,181,43,250,111
4295,Salles-Curan,12253,12,232,166,31,366,184,581,398
4296,Salles-la-Source,12254,12,231,544,105,696,519,1320,775
4297,Salmiech,12255,12,140,138,39,283,82,404,278
4298,Salvagnac-Cajarc,12256,12,94,80,25,135,50,210,174
4299,Causse-et-Diège,12257,12,116,146,36,211,147,394,262
4300,La Salvetat-Peyralès,12258,12,288,117,20,330,109,459,405
4301,Sanvensa,12259,12,92,168,52,184,168,404,260
4302,Sauclières,12260,12,21,23,14,41,22,77,44
4303,Saujac,12261,12,32,16,16,68,0,84,48
4304,Sauveterre-de-Rouergue,12262,12,175,100,40,265,115,420,275
4305,Savignac,12263,12,52,180,32,228,188,448,232
4306,Sébazac-Concourès,12264,12,366,747,258,1174,560,1992,1113
4307,Sébrazac,12265,12,120,71,36,183,46,265,191
4308,Ségur,12266,12,96,120,40,188,104,332,216
4309,La Selve,12267,12,151,111,14,193,101,308,262
4310,Sénergues,12268,12,116,29,18,155,32,205,145
4311,La Serre,12269,12,35,10,5,45,5,55,45
4312,Sévérac d'Aveyron,12270,12,666,779,345,1396,739,2480,1445
4313,Sonnac,12272,12,66,104,21,179,98,298,170
4314,Soulages-Bonneval,12273,12,30,75,15,125,65,205,105
4315,Sylvanès,12274,12,20,8,16,48,8,72,28
4316,Tauriac-de-Camarès,12275,12,9,14,0,15,0,15,23
4317,Tauriac-de-Naucelle,12276,12,88,72,20,124,48,192,160
4318,Taussac,12277,12,92,83,34,176,56,266,175
4319,Tayrac,12278,12,44,12,8,64,24,96,56
4320,Thérondels,12280,12,115,60,5,180,55,240,175
4321,Toulonjac,12281,12,104,152,68,312,108,488,256
4322,Tournemire,12282,12,42,101,21,100,123,244,143
4323,Trémouilles,12283,12,120,110,20,240,35,295,230
4324,Le Truel,12284,12,85,65,20,95,50,165,150
4325,Vabres-l'Abbaye,12286,12,116,228,96,492,208,796,344
4326,Vailhourles,12287,12,126,134,77,178,109,364,260
4327,Valady,12288,12,170,435,100,515,285,900,605
4328,Valzergues,12289,12,65,40,10,55,40,105,105
4329,Vaureilles,12290,12,92,116,36,196,76,308,208
4330,Verrières,12291,12,29,80,26,140,57,223,109
4331,Versols-et-Lapeyre,12292,12,28,112,32,157,71,260,140
4332,Veyreau,12293,12,8,32,16,60,12,88,40
4333,Vézins-de-Lévézou,12294,12,100,136,60,224,124,408,236
4334,Viala-du-Pas-de-Jaux,12295,12,36,16,8,20,12,40,52
4335,Viala-du-Tarn,12296,12,68,104,8,200,52,260,172
4336,Le Vibal,12297,12,90,113,33,155,115,303,203
4337,Villecomtal,12298,12,64,68,20,144,80,244,132
4338,Villefranche-de-Panat,12299,12,140,124,40,284,104,428,264
4339,Villefranche-de-Rouergue,12300,12,2207,2076,1150,3955,1647,6752,4283
4340,Villeneuve,12301,12,388,365,157,721,202,1080,753
4341,Vimenet,12303,12,55,40,5,105,40,150,95
4342,Viviez,12305,12,311,220,100,400,225,725,531
4343,Curan,12307,12,92,48,28,80,60,168,140
4344,Aix-en-Provence,13001,13,16980,28792,24418,39161,24906,88485,45772
4345,Allauch,13002,13,3006,4736,1934,7610,3730,13274,7742
4346,Alleins,13003,13,244,568,188,931,428,1547,812
4347,Arles,13004,13,7964,11911,5220,17603,8965,31788,19875
4348,Aubagne,13005,13,6229,10597,4781,13446,8062,26289,16826
4349,Aureille,13006,13,196,348,140,564,304,1008,544
4350,Auriol,13007,13,1169,2727,1164,3876,2169,7209,3896
4351,Aurons,13008,13,72,124,36,208,68,312,196
4352,La Barben,13009,13,55,192,90,312,142,544,247
4353,Barbentane,13010,13,501,838,405,1486,639,2530,1339
4354,Les Baux-de-Provence,13011,13,45,48,5,196,31,232,93
4355,Beaurecueil,13012,13,56,52,72,244,20,336,108
4356,Belcodène,13013,13,153,470,156,587,398,1141,623
4357,Berre-l'Étang,13014,13,1509,3394,1680,3942,2477,8099,4903
4358,Bouc-Bel-Air,13015,13,1705,3356,1188,4672,2400,8260,5061
4359,La Bouilladisse,13016,13,675,1414,512,2068,1165,3745,2089
4360,Boulbon,13017,13,200,336,108,560,288,956,536
4361,Cabannes,13018,13,531,1012,456,1467,857,2780,1543
4362,Cabriès,13019,13,1343,2391,707,3256,1716,5679,3734
4363,Cadolive,13020,13,216,495,244,735,411,1390,711
4364,Carry-le-Rouet,13021,13,1270,985,367,2345,943,3655,2255
4365,Cassis,13022,13,1500,1367,611,2635,1112,4358,2867
4366,Ceyreste,13023,13,713,931,345,1461,768,2574,1644
4367,Charleval,13024,13,275,699,266,824,437,1527,974
4368,Châteauneuf-le-Rouge,13025,13,163,513,209,824,397,1430,676
4369,Châteauneuf-les-Martigues,13026,13,1741,3461,1589,4090,2901,8580,5202
4370,Châteaurenard,13027,13,1819,3738,1740,5083,3075,9898,5557
4371,La Ciotat,13028,13,6016,7035,3374,12102,6269,21745,13051
4372,Cornillon-Confoux,13029,13,156,308,164,476,236,876,464
4373,Cuges-les-Pins,13030,13,369,1291,570,1551,1096,3217,1660
4374,La Destrousse,13031,13,437,662,333,1096,513,1942,1099
4375,Éguilles,13032,13,925,1742,683,2528,1530,4741,2667
4376,Ensuès-la-Redonne,13033,13,518,1212,515,2014,980,3509,1730
4377,Eygalières,13034,13,298,320,130,706,275,1111,618
4378,Eyguières,13035,13,732,1578,722,2378,1411,4511,2310
4379,Eyragues,13036,13,592,925,422,1446,703,2571,1517
4380,La Fare-les-Oliviers,13037,13,829,1916,748,2463,1955,5166,2745
4381,Fontvieille,13038,13,632,670,258,1480,556,2294,1302
4382,Fos-sur-Mer,13039,13,1378,4263,1506,5376,3103,9985,5641
4383,Fuveau,13040,13,978,2465,912,3172,2033,6117,3443
4384,Gardanne,13041,13,2377,4763,2323,6293,3823,12439,7140
4385,Gémenos,13042,13,947,1304,538,2005,1150,3693,2251
4386,Gignac-la-Nerthe,13043,13,901,2155,845,3416,1783,6044,3056
4387,Grans,13044,13,657,959,379,1529,829,2737,1616
4388,Graveson,13045,13,502,1212,388,1428,1001,2817,1714
4389,Gréasque,13046,13,509,962,323,1370,800,2493,1471
4390,Istres,13047,13,3845,10888,4919,13766,8501,27186,14733
4391,Jouques,13048,13,401,1082,343,1575,812,2730,1483
4392,Lamanon,13049,13,208,468,176,732,368,1276,676
4393,Lambesc,13050,13,905,2413,830,3174,1850,5854,3318
4394,Lançon-Provence,13051,13,686,2309,953,2728,1952,5633,2995
4395,Maillane,13052,13,283,594,282,820,463,1565,877
4396,Mallemort,13053,13,692,1529,515,1866,1237,3618,2221
4397,Marignane,13054,13,4122,8558,3624,10100,6944,20668,12680
4398,Marseille,13055,13,108117,207181,107813,246188,164838,518839,315298
4399,Martigues,13056,13,6556,11208,5260,15879,8876,30015,17764
4400,Mas-Blanc-des-Alpilles,13057,13,32,152,40,196,80,316,184
4401,Maussane-les-Alpilles,13058,13,374,447,169,685,437,1291,821
4402,Meyrargues,13059,13,385,975,355,1142,734,2231,1360
4403,Meyreuil,13060,13,501,1278,543,1892,1114,3549,1779
4404,Saint-Pierre-de-Mézoargues,13061,13,40,30,40,76,25,141,70
4405,Mimet,13062,13,437,1020,436,1720,831,2987,1457
4406,Miramas,13063,13,2777,6696,3055,7520,4931,15506,9473
4407,Mollégès,13064,13,305,586,220,972,446,1638,891
4408,Mouriès,13065,13,480,745,293,1242,635,2170,1225
4409,Noves,13066,13,711,1325,562,1781,1021,3364,2036
4410,Orgon,13067,13,288,680,446,1188,496,2130,968
4411,Paradou,13068,13,251,488,88,563,404,1055,739
4412,Pélissanne,13069,13,1345,2340,787,3351,1868,6006,3685
4413,La Penne-sur-Huveaune,13070,13,864,1401,622,2149,914,3685,2265
4414,Les Pennes-Mirabeau,13071,13,3147,4350,1828,7132,3734,12694,7497
4415,Peynier,13072,13,341,772,244,1089,682,2015,1113
4416,Peypin,13073,13,498,1263,532,1997,1060,3589,1761
4417,Peyrolles-en-Provence,13074,13,484,1324,434,1524,1027,2985,1808
4418,Plan-de-Cuques,13075,13,1841,2292,877,3531,1623,6031,4133
4419,Plan-d'Orgon,13076,13,336,903,223,1058,677,1958,1239
4420,Port-de-Bouc,13077,13,2384,4376,1727,5417,2950,10094,6760
4421,Port-Saint-Louis-du-Rhône,13078,13,1280,2021,954,2753,1554,5261,3301
4422,Puyloubier,13079,13,130,425,170,585,310,1065,555
4423,Le Puy-Sainte-Réparade,13080,13,612,1216,450,1947,850,3247,1828
4424,Rognac,13081,13,1248,2929,1206,3965,2290,7461,4177
4425,Rognes,13082,13,537,1088,333,1699,812,2844,1625
4426,Rognonas,13083,13,525,912,314,1351,847,2512,1437
4427,La Roque-d'Anthéron,13084,13,663,1507,377,1499,1007,2883,2170
4428,Roquefort-la-Bédoule,13085,13,675,1212,487,1726,1020,3233,1887
4429,Roquevaire,13086,13,1046,2031,870,2931,1778,5579,3077
4430,Rousset,13087,13,453,1259,505,1463,912,2880,1712
4431,Le Rove,13088,13,557,1030,363,1707,900,2970,1587
4432,Saint-Andiol,13089,13,417,879,320,951,612,1883,1296
4433,Saint-Antonin-sur-Bayon,13090,13,35,15,25,40,15,80,50
4434,Saint-Cannat,13091,13,691,1373,443,1919,1023,3385,2064
4435,Saint-Chamas,13092,13,843,1997,855,2615,1605,5075,2840
4436,Saint-Estève-Janson,13093,13,23,105,6,123,69,198,128
4437,Saint-Étienne-du-Grès,13094,13,389,493,125,797,436,1358,882
4438,Saint-Marc-Jaumegarde,13095,13,108,267,77,461,146,684,375
4439,Saintes-Maries-de-la-Mer,13096,13,312,504,248,1108,482,1838,816
4440,Saint-Martin-de-Crau,13097,13,1929,3201,1158,4227,2652,8037,5130
4441,Saint-Mitre-les-Remparts,13098,13,816,1219,531,2228,994,3753,2035
4442,Saint-Paul-lès-Durance,13099,13,40,195,96,356,152,604,235
4443,Saint-Rémy-de-Provence,13100,13,1804,1836,828,3341,1547,5716,3640
4444,Saint-Savournin,13101,13,256,840,361,993,747,2101,1096
4445,Saint-Victoret,13102,13,784,1464,723,2224,1187,4134,2248
4446,Salon-de-Provence,13103,13,5347,10433,5244,12711,8281,26236,15780
4447,Sausset-les-Pins,13104,13,1523,1354,485,3077,1120,4682,2877
4448,Sénas,13105,13,691,1843,820,2019,1552,4391,2534
4449,Septèmes-les-Vallons,13106,13,1445,2695,1153,3325,1870,6348,4140
4450,Simiane-Collongue,13107,13,799,1259,467,1823,972,3262,2058
4451,Tarascon,13108,13,1800,3571,1479,4367,2395,8241,5371
4452,Le Tholonet,13109,13,320,532,280,794,400,1474,852
4453,Trets,13110,13,1133,2799,1132,3498,2264,6894,3932
4454,Vauvenargues,13111,13,130,240,50,339,218,607,370
4455,Velaux,13112,13,811,2158,739,3267,1790,5796,2969
4456,Venelles,13113,13,1280,1833,671,2868,1514,5053,3113
4457,Ventabren,13114,13,657,1186,357,1905,843,3105,1843
4458,Vernègues,13115,13,95,474,148,578,354,1080,569
4459,Verquières,13116,13,57,194,67,278,152,497,251
4460,Vitrolles,13117,13,3109,9002,3806,10908,6737,21451,12111
4461,Coudoux,13118,13,389,981,241,1044,839,2124,1370
4462,Carnoux-en-Provence,13119,13,1045,1451,502,2379,1148,4029,2496
4463,Ablon,14001,14,123,279,81,376,277,734,402
4464,Acqueville,14002,14,4,48,12,49,53,114,52
4465,Agy,14003,14,21,60,12,84,69,165,81
4466,Aignerville,14004,14,20,50,10,60,50,120,70
4467,Airan,14005,14,70,190,20,225,150,395,260
4468,Amayé-sur-Orne,14006,14,83,294,42,266,237,545,377
4469,Amayé-sur-Seulles,14007,14,25,57,12,69,30,111,82
4470,Amblie,14008,14,15,63,12,94,39,145,78
4471,Amfreville,14009,14,110,390,110,499,270,879,500
4472,Anctoville,14011,14,80,291,56,332,215,603,371
4473,Angerville,14012,14,8,36,16,36,36,88,44
4474,Angoville,14013,14,10,10,0,15,0,15,20
4475,Colomby-Anguerny,14014,14,100,280,100,490,175,765,380
4476,Anisy,14015,14,42,196,16,247,153,416,238
4477,Annebault,14016,14,83,105,40,104,109,253,188
4478,Arganchy,14019,14,20,60,10,109,25,144,80
4479,Argences,14020,14,524,1007,322,1004,738,2064,1531
4480,Arromanches-les-Bains,14021,14,68,117,38,199,70,307,185
4481,Asnelles,14022,14,116,96,12,265,48,325,212
4482,Asnières-en-Bessin,14023,14,8,16,4,30,4,38,24
4483,Auberville,14024,14,40,143,28,108,126,262,183
4484,Aubigny,14025,14,45,67,29,63,48,140,112
4485,Audrieu,14026,14,69,312,45,319,273,637,381
4486,Aunay-sur-Odon,14027,14,356,872,332,868,692,1892,1228
4487,Authie,14030,14,101,435,108,552,256,916,536
4488,Les Authieux-Papion,14031,14,10,20,5,15,30,50,30
4489,Les Authieux-sur-Calonne,14032,14,35,85,5,115,55,175,120
4490,Auvillars,14033,14,36,56,12,88,44,144,92
4491,Avenay,14034,14,40,171,44,132,145,321,211
4492,Balleroy-sur-Drôme,14035,14,129,389,98,418,288,804,518
4493,Banneville-la-Campagne,14036,14,0,43,14,52,40,106,43
4494,Malherbe-sur-Ajon,14037,14,33,112,30,206,91,327,145
4495,Banville,14038,14,60,197,55,231,140,426,257
4496,Barbery,14039,14,28,241,67,254,147,468,269
4497,Barbeville,14040,14,25,35,30,80,15,125,60
4498,Barneville-la-Bertran,14041,14,20,10,10,65,15,90,30
4499,Baron-sur-Odon,14042,14,56,239,88,261,215,564,295
4500,Barou-en-Auge,14043,14,20,20,0,30,25,55,40
4501,Basly,14044,14,104,344,84,348,276,708,448
4502,Basseneville,14045,14,20,52,17,91,60,168,72
4503,Bavent,14046,14,188,472,156,608,320,1084,660
4504,Bayeux,14047,14,2341,2852,1505,4384,2126,8015,5193
4505,Bazenville,14049,14,5,20,20,50,25,95,25
4506,La Bazoque,14050,14,15,35,0,83,50,133,50
4507,Beaumais,14053,14,4,37,8,58,30,96,41
4508,Beaumesnil,14054,14,15,70,20,55,55,130,85
4509,Beaumont-en-Auge,14055,14,49,85,34,160,60,254,134
4510,Bauquay,14056,14,16,100,36,52,88,176,116
4511,Bellengreville,14057,14,75,401,150,625,255,1030,476
4512,Benerville-sur-Mer,14059,14,82,50,57,198,34,289,132
4513,Bénouville,14060,14,200,505,235,885,290,1410,705
4514,Souleuvre en Bocage,14061,14,1075,2340,762,2726,1751,5239,3415
4515,Bény-sur-Mer,14062,14,36,112,36,128,112,276,148
4516,Bernesq,14063,14,32,53,8,54,31,93,85
4517,Bernières-d'Ailly,14064,14,20,65,30,65,65,160,85
4518,Bernières-sur-Mer,14066,14,310,500,155,930,410,1495,810
4519,Biéville-Beuville,14068,14,311,750,199,993,518,1710,1061
4520,Beuvillers,14069,14,144,356,128,460,268,856,500
4521,Beuvron-en-Auge,14070,14,55,36,20,65,20,105,91
4522,La Bigne,14073,14,4,40,20,88,48,156,44
4523,Billy,14074,14,24,120,28,128,68,224,144
4524,Bissières,14075,14,10,40,15,100,15,130,50
4525,Blainville-sur-Orne,14076,14,520,1398,718,1673,1085,3476,1918
4526,Blangy-le-Château,14077,14,120,158,23,209,100,332,278
4527,Blay,14078,14,29,118,31,79,97,207,147
4528,Blonville-sur-Mer,14079,14,282,273,119,550,211,880,555
4529,Le Bô,14080,14,0,20,20,34,34,88,20
4530,Boissey,14081,14,20,60,25,90,45,160,80
4531,La Boissière,14082,14,5,80,5,35,60,100,85
4532,Bonnebosq,14083,14,125,127,71,217,87,375,252
4533,Bonnemaison,14084,14,39,85,30,155,90,275,124
4534,Bonneville-la-Louvet,14085,14,130,165,25,285,120,430,295
4535,Bonneville-sur-Touques,14086,14,40,85,43,162,45,250,125
4536,Bonnoeil,14087,14,24,24,4,68,32,104,48
4537,Bons-Tassilly,14088,14,53,106,34,80,72,186,159
4538,Bougy,14089,14,20,131,35,125,75,235,151
4539,Boulon,14090,14,83,163,70,160,148,378,246
4540,Bourgeauville,14091,14,18,6,6,42,9,57,24
4541,Bourguébus,14092,14,53,562,145,434,450,1029,615
4542,Branville,14093,14,16,59,8,52,57,117,75
4543,Brémoy,14096,14,20,36,12,81,31,124,56
4544,Bretteville-le-Rabet,14097,14,0,69,30,104,51,185,69
4545,Bretteville-l'Orgueilleuse,14098,14,237,682,223,875,518,1616,919
4546,Bretteville-sur-Dives,14099,14,45,60,10,95,65,170,105
4547,Bretteville-sur-Laize,14100,14,166,473,165,549,359,1073,639
4548,Bretteville-sur-Odon,14101,14,547,840,402,1299,667,2368,1387
4549,Le Breuil-en-Auge,14102,14,127,178,56,332,220,608,305
4550,Le Breuil-en-Bessin,14103,14,36,120,52,108,112,272,156
4551,Le Brévedent,14104,14,8,35,4,82,25,111,43
4552,Bréville-les-Monts,14106,14,65,180,45,223,143,411,245
4553,Bricqueville,14107,14,34,53,24,16,42,82,87
4554,Brouay,14109,14,18,141,39,112,108,259,159
4555,Brucourt,14110,14,16,30,0,36,20,56,46
4556,Bucéels,14111,14,21,94,50,85,65,200,115
4557,Le Bû-sur-Rouvres,14116,14,0,25,20,35,30,85,25
4558,Cabourg,14117,14,886,617,267,1269,495,2031,1503
4559,Caen,14118,14,12930,21598,22151,25934,17900,65985,34528
4560,Cagny,14119,14,117,468,186,464,274,924,585
4561,Cahagnes,14120,14,112,388,116,480,288,884,500
4562,Cahagnolles,14121,14,24,84,24,68,52,144,108
4563,La Caine,14122,14,0,34,8,36,34,78,34
4564,Cairon,14123,14,138,571,105,741,336,1182,709
4565,La Cambe,14124,14,71,156,35,230,114,379,227
4566,Cambes-en-Plaine,14125,14,143,370,139,588,254,981,513
4567,Cambremer,14126,14,127,286,56,383,207,646,413
4568,Campagnolles,14127,14,43,162,27,148,104,279,205
4569,Campandré-Valcongrain,14128,14,10,20,15,55,15,85,30
4570,Campigny,14130,14,10,55,10,80,30,120,65
4571,Canapville,14131,14,42,53,17,63,30,110,95
4572,Canchy,14132,14,40,40,24,72,20,116,80
4573,Canteloup,14134,14,30,55,5,55,50,110,85
4574,Carcagny,14135,14,25,61,50,105,40,195,86
4575,Cardonville,14136,14,8,28,0,24,16,40,36
4576,Carpiquet,14137,14,260,588,204,869,365,1438,848
4577,Cartigny-l'Épinay,14138,14,15,85,15,110,85,210,100
4578,Castillon,14140,14,38,87,17,90,58,165,125
4579,Castillon-en-Auge,14141,14,28,28,24,68,20,112,56
4580,Castilly,14142,14,24,73,34,105,29,168,97
4581,Caumont-l'Éventé,14143,14,136,343,125,410,225,760,479
4582,Cauvicourt,14145,14,40,135,25,125,150,300,175
4583,Cauville,14146,14,40,45,0,45,30,75,85
4584,Cernay,14147,14,3,37,6,50,25,81,40
4585,Cesny-aux-Vignes,14149,14,36,159,42,97,91,230,195
4586,Cesny-Bois-Halbout,14150,14,73,128,30,132,105,267,201
4587,Champ-du-Boult,14151,14,50,65,35,160,45,240,115
4588,Cheux,14157,14,105,412,106,360,343,809,517
4589,Chicheboville,14158,14,50,150,60,125,110,295,200
4590,Chouain,14159,14,35,80,10,70,39,119,115
4591,Cintheaux,14160,14,16,52,12,48,60,120,68
4592,Clarbec,14161,14,30,70,15,170,75,260,100
4593,Clécy,14162,14,197,278,60,337,256,653,475
4594,Cléville,14163,14,30,110,4,84,103,191,140
4595,Clinchamps-sur-Orne,14164,14,56,272,133,362,217,712,328
4596,Colleville-sur-Mer,14165,14,5,50,10,91,40,141,55
4597,Colleville-Montgomery,14166,14,359,564,124,906,399,1429,923
4598,Colombelles,14167,14,776,1626,774,1883,1046,3703,2402
4599,Colombières,14168,14,47,21,16,66,16,98,68
4600,Colombiers-sur-Seulles,14169,14,5,40,30,50,35,115,45
4601,Combray,14171,14,15,45,30,20,30,80,60
4602,Commes,14172,14,60,73,26,136,66,228,133
4603,Condé-sur-Ifs,14173,14,52,161,12,148,112,272,213
4604,Condé-en-Normandie,14174,14,1159,1499,605,2344,1139,4088,2658
4605,Condé-sur-Seulles,14175,14,28,88,32,68,64,164,116
4606,Conteville,14176,14,3,31,0,18,34,52,34
4607,Coquainvilliers,14177,14,70,195,60,319,157,536,265
4608,Cordebugle,14179,14,10,33,12,29,30,71,43
4609,Cordey,14180,14,21,30,12,49,20,81,51
4610,Cormelles-le-Royal,14181,14,606,1031,487,1659,829,2975,1637
4611,Cormolain,14182,14,68,102,13,81,85,179,170
4612,Cossesseville,14183,14,15,25,10,20,30,60,40
4613,Cottun,14184,14,33,44,0,67,30,97,77
4614,Coudray-Rabut,14185,14,65,70,35,75,70,180,135
4615,Coulombs,14186,14,29,138,45,80,114,239,167
4616,Coupesarte,14189,14,10,5,0,15,5,20,15
4617,Courcy,14190,14,20,40,12,48,24,84,60
4618,Courseulles-sur-Mer,14191,14,1000,618,340,1455,509,2304,1618
4619,Courson,14192,14,60,85,40,120,90,250,145
4620,Courtonne-la-Meurdrac,14193,14,85,137,35,292,110,437,222
4621,Courtonne-les-Deux-Églises,14194,14,45,200,30,245,115,390,245
4622,Courvaudon,14195,14,12,56,24,53,54,131,68
4623,Crépon,14196,14,10,50,15,105,35,155,60
4624,Cresserons,14197,14,70,345,63,443,215,721,415
4625,Cresseveuille,14198,14,5,85,30,85,50,165,90
4626,Creully,14200,14,108,520,100,544,408,1052,628
4627,Crèvecoeur-en-Auge,14201,14,75,160,65,155,85,305,235
4628,Cricqueboeuf,14202,14,35,35,20,95,20,135,70
4629,Cricqueville-en-Auge,14203,14,10,55,20,70,35,125,65
4630,Cricqueville-en-Bessin,14204,14,29,48,12,74,13,99,77
4631,Cristot,14205,14,12,56,16,64,52,132,68
4632,Crocy,14206,14,25,66,16,128,30,174,91
4633,Croisilles,14207,14,53,185,58,143,140,341,238
4634,Croissanville,14208,14,39,142,47,152,96,295,181
4635,Crouay,14209,14,35,155,30,210,100,340,190
4636,Culey-le-Patry,14211,14,28,71,38,100,59,197,99
4637,Cully,14212,14,12,68,4,68,52,124,80
4638,Cussy,14214,14,20,52,26,37,24,87,72
4639,Cuverville,14215,14,128,628,117,649,410,1176,756
4640,Damblainville,14216,14,24,72,24,72,44,140,96
4641,Dampierre,14217,14,5,30,10,65,20,95,35
4642,Danestal,14218,14,28,108,28,104,80,212,136
4643,Danvou-la-Ferrière,14219,14,16,52,20,72,20,112,68
4644,Deauville,14220,14,1062,515,260,1323,400,1983,1577
4645,Démouville,14221,14,330,816,268,1149,601,2018,1146
4646,Le Détroit,14223,14,16,19,0,6,29,35,35
4647,Deux-Jumeaux,14224,14,17,6,6,16,9,31,23
4648,Dives-sur-Mer,14225,14,998,1304,558,1938,886,3382,2302
4649,Donnay,14226,14,10,74,15,85,73,173,84
4650,Douville-en-Auge,14227,14,20,60,5,95,30,130,80
4651,Douvres-la-Délivrande,14228,14,556,1190,521,1792,836,3149,1746
4652,Dozulé,14229,14,262,512,218,533,404,1155,774
4653,Drubec,14230,14,12,30,4,41,16,61,42
4654,Beaufour-Druval,14231,14,32,96,52,148,92,292,128
4655,Ducy-Sainte-Marguerite,14232,14,28,43,0,32,30,62,71
4656,Écrammeville,14235,14,30,63,4,43,48,95,93
4657,Ellon,14236,14,45,95,28,138,75,241,140
4658,Émiéville,14237,14,20,200,40,165,175,380,220
4659,Englesqueville-en-Auge,14238,14,8,20,8,40,32,80,28
4660,Englesqueville-la-Percée,14239,14,8,20,4,24,8,36,28
4661,Épaney,14240,14,32,165,16,140,160,316,197
4662,Épinay-sur-Odon,14241,14,20,201,55,210,155,420,221
4663,Épron,14242,14,192,400,272,464,220,956,592
4664,Équemauville,14243,14,186,250,96,530,184,810,436
4665,Eraines,14244,14,31,87,22,79,71,172,118
4666,Ernes,14245,14,48,92,32,56,92,180,140
4667,Escoville,14246,14,88,229,95,219,160,474,317
4668,Espins,14248,14,12,60,20,100,36,156,72
4669,Esquay-Notre-Dame,14249,14,90,465,115,430,340,885,555
4670,Esquay-sur-Seulles,14250,14,26,63,6,119,58,183,89
4671,Esson,14251,14,8,148,41,178,118,337,156
4672,Estrées-la-Campagne,14252,14,20,92,20,52,64,136,112
4673,Éterville,14254,14,107,419,131,587,252,970,526
4674,Étréham,14256,14,16,65,29,121,49,199,81
4675,Évrecy,14257,14,180,579,198,534,373,1105,759
4676,Falaise,14258,14,1116,1940,880,2405,1475,4760,3056
4677,Fauguernon,14260,14,20,52,24,108,28,160,72
4678,Le Faulq,14261,14,33,120,15,85,100,200,153
4679,Feuguerolles-Bully,14266,14,90,420,76,438,301,815,510
4680,Fierville-Bray,14268,14,12,188,28,164,132,324,200
4681,Fierville-les-Parcs,14269,14,30,60,0,50,55,105,90
4682,Firfol,14270,14,55,110,40,166,55,261,165
4683,Fleury-sur-Orne,14271,14,507,1118,591,1497,834,2922,1625
4684,La Folie,14272,14,31,37,10,10,36,56,68
4685,La Folletière-Abenon,14273,14,20,20,15,75,10,100,40
4686,Fontaine-Étoupefour,14274,14,226,625,155,696,436,1287,851
4687,Fontaine-Henry,14275,14,10,108,58,170,85,313,118
4688,Fontaine-le-Pin,14276,14,24,136,12,104,96,212,160
4689,Fontenay-le-Marmion,14277,14,98,512,173,544,400,1117,610
4690,Fontenay-le-Pesnel,14278,14,77,326,98,332,250,680,403
4691,Fontenermont,14279,14,5,55,10,65,30,105,60
4692,Formentin,14280,14,17,62,8,62,54,124,79
4693,Formigny,14281,14,34,40,15,68,29,112,74
4694,Foulognes,14282,14,5,55,40,55,45,140,60
4695,Fourches,14283,14,20,55,10,85,55,150,75
4696,Fourneaux-le-Val,14284,14,30,30,10,70,10,90,60
4697,Le Fournet,14285,14,0,27,8,25,0,33,27
4698,Fourneville,14286,14,8,168,36,188,108,332,176
4699,Frénouville,14287,14,184,613,208,536,435,1179,797
4700,Le Fresne-Camilly,14288,14,64,226,44,359,98,501,290
4701,Fresné-la-Mère,14289,14,40,225,32,184,140,356,265
4702,Fresney-le-Puceux,14290,14,30,253,72,238,174,484,283
4703,Fresney-le-Vieux,14291,14,15,90,15,110,50,175,105
4704,Fumichon,14293,14,21,54,37,85,43,165,75
4705,Garcelles-Secqueville,14294,14,48,285,82,189,206,477,333
4706,Le Gast,14296,14,36,42,10,88,21,119,78
4707,Gavrus,14297,14,17,207,42,123,134,299,224
4708,Géfosse-Fontenay,14298,14,16,30,8,33,30,71,46
4709,Genneville,14299,14,57,214,15,259,158,432,271
4710,Gerrots,14300,14,4,16,0,20,12,32,20
4711,Giberville,14301,14,604,1398,354,1628,973,2955,2002
4712,Glanville,14302,14,5,55,15,80,50,145,60
4713,Glos,14303,14,95,233,79,284,223,586,328
4714,Gonneville-sur-Honfleur,14304,14,104,219,16,348,120,484,323
4715,Gonneville-sur-Mer,14305,14,115,111,20,333,75,428,226
4716,Gonneville-en-Auge,14306,14,40,90,35,150,75,260,130
4717,Goupillières,14307,14,15,75,5,65,25,95,90
4718,Goustranville,14308,14,30,35,10,65,25,100,65
4719,Gouvix,14309,14,84,163,73,327,100,500,247
4720,Grainville-Langannerie,14310,14,64,235,92,164,177,433,299
4721,Grainville-sur-Odon,14311,14,36,232,58,362,191,611,268
4722,Grandcamp-Maisy,14312,14,445,184,98,671,165,934,629
4723,Grandchamp-le-Château,14313,14,0,8,8,20,12,40,8
4724,Grangues,14316,14,10,45,15,135,30,180,55
4725,Graye-sur-Mer,14318,14,71,95,36,215,54,305,166
4726,Grentheville,14319,14,36,232,63,288,183,534,268
4727,Grimbosq,14320,14,24,88,0,100,80,180,112
4728,Guéron,14322,14,32,49,8,70,44,122,81
4729,Hermanville-sur-Mer,14325,14,264,714,189,1262,506,1957,978
4730,Hermival-les-Vaux,14326,14,90,222,30,360,110,500,312
4731,Hérouville-Saint-Clair,14327,14,1900,5371,3659,5842,3904,13405,7271
4732,Hérouvillette,14328,14,147,230,87,374,211,672,377
4733,Heuland,14329,14,3,12,6,21,15,42,15
4734,Hiéville,14331,14,31,57,32,53,47,132,88
4735,La Hoguette,14332,14,54,176,20,229,116,365,230
4736,Honfleur,14333,14,1153,1842,653,2248,1285,4186,2995
4737,L'Hôtellerie,14334,14,20,90,30,110,80,220,110
4738,Hotot-en-Auge,14335,14,40,56,24,120,60,204,96
4739,Hottot-les-Bagues,14336,14,25,150,25,175,115,315,175
4740,La Houblonnière,14337,14,13,106,12,72,81,165,119
4741,Houlgate,14338,14,436,385,135,705,295,1135,821
4742,Hubert-Folie,14339,14,10,78,26,107,76,209,88
4743,Ifs,14341,14,1120,3219,1351,3112,2331,6794,4339
4744,Isigny-sur-Mer,14342,14,529,484,251,942,318,1511,1013
4745,Les Isles-Bardel,14343,14,12,8,4,28,8,40,20
4746,Janville,14344,14,52,60,20,200,36,256,112
4747,Jort,14345,14,25,60,40,115,45,200,85
4748,Juaye-Mondaye,14346,14,75,140,75,230,115,420,215
4749,Jurques,14347,14,40,190,75,220,155,450,230
4750,Juvigny-sur-Seulles,14348,14,15,30,10,20,10,40,45
4751,Laize-la-Ville,14349,14,4,268,81,180,183,444,272
4752,La Lande-sur-Drôme,14350,14,4,14,4,17,13,34,18
4753,Landelles-et-Coupigny,14352,14,200,216,72,240,152,464,416
4754,Landes-sur-Ajon,14353,14,25,110,30,115,110,255,135
4755,Langrune-sur-Mer,14354,14,209,396,125,675,292,1092,605
4756,Lantheuil,14355,14,40,201,8,248,170,426,241
4757,Lassy,14357,14,24,96,34,132,39,205,120
4758,Léaupartie,14358,14,10,46,20,20,20,60,56
4759,Lécaude,14359,14,21,42,0,41,28,69,63
4760,Leffard,14360,14,12,42,9,60,36,105,54
4761,Lessard-et-le-Chêne,14362,14,9,32,17,45,23,85,41
4762,Lingèvres,14364,14,55,120,60,165,50,275,175
4763,Lion-sur-Mer,14365,14,356,598,160,915,415,1490,954
4764,Lisieux,14366,14,3331,4496,2583,6207,3188,11978,7827
4765,Lison,14367,14,49,107,28,149,66,243,156
4766,Lisores,14368,14,40,80,25,115,25,165,120
4767,Litteau,14369,14,22,57,30,83,49,162,79
4768,Le Molay-Littry,14370,14,505,711,256,928,521,1705,1216
4769,Livarot-Pays-d'Auge,14371,14,858,1565,566,2195,1188,3949,2423
4770,Livry,14372,14,100,215,60,285,130,475,315
4771,Le Locheur,14373,14,25,45,30,95,35,160,70
4772,Les Loges,14374,14,12,32,4,28,32,64,44
4773,Les Loges-Saulces,14375,14,9,60,10,45,55,110,69
4774,Longraye,14376,14,24,64,36,56,52,144,88
4775,Longues-sur-Mer,14377,14,60,175,40,195,160,395,235
4776,Longueville,14378,14,36,76,8,120,64,192,112
4777,Longvillers,14379,14,25,100,25,130,75,230,125
4778,Loucelles,14380,14,10,48,12,57,36,105,58
4779,Louvagny,14381,14,0,15,5,45,0,50,15
4780,Louvières,14382,14,12,8,12,28,8,48,20
4781,Louvigny,14383,14,248,764,303,789,631,1723,1012
4782,Luc-sur-Mer,14384,14,514,621,168,1322,332,1822,1135
4783,Magny-en-Bessin,14385,14,0,60,8,60,28,96,60
4784,Magny-la-Campagne,14386,14,0,150,53,200,135,388,150
4785,Magny-le-Freule,14387,14,35,79,43,100,75,218,114
4786,Maisoncelles-Pelvey,14389,14,35,70,5,90,40,135,105
4787,Maisoncelles-sur-Ajon,14390,14,15,46,12,49,38,99,61
4788,Maisons,14391,14,50,95,25,135,70,230,145
4789,Maizet,14393,14,16,95,22,85,68,175,111
4790,Maizières,14394,14,60,125,30,145,85,260,185
4791,Maltot,14396,14,40,306,89,255,263,607,346
4792,Mandeville-en-Bessin,14397,14,20,93,35,152,56,243,113
4793,Manerbe,14398,14,36,144,44,212,100,356,180
4794,Manneville-la-Pipard,14399,14,65,40,30,130,25,185,105
4795,Le Manoir,14400,14,21,67,12,60,39,111,88
4796,Manvieux,14401,14,15,40,0,35,30,65,55
4797,Le Marais-la-Chapelle,14402,14,25,35,10,60,5,75,60
4798,Marolles,14403,14,55,200,65,305,140,510,255
4799,Martainville,14404,14,40,36,16,0,32,48,76
4800,Martigny-sur-l'Ante,14405,14,29,63,12,107,52,171,92
4801,Martragny,14406,14,60,104,40,84,76,200,164
4802,Mathieu,14407,14,253,552,113,765,341,1219,805
4803,May-sur-Orne,14408,14,152,503,144,700,321,1165,655
4804,Merville-Franceville-Plage,14409,14,485,465,125,730,395,1250,950
4805,Méry-Corbon,14410,14,95,218,116,333,181,630,313
4806,Meslay,14411,14,35,90,48,55,55,158,125
4807,Le Mesnil-au-Grain,14412,14,16,21,4,16,17,37,37
4808,Le Mesnil-Auzouf,14413,14,32,125,32,68,108,208,157
4809,Le Mesnil-Benoist,14415,14,0,15,0,10,25,35,15
4810,Le Mesnil-Caussois,14416,14,16,28,12,32,28,72,44
4811,Mesnil-Clinchamps,14417,14,112,268,56,364,180,600,380
4812,Le Mesnil-Eudes,14419,14,30,55,15,94,55,164,85
4813,Le Mesnil-Guillaume,14421,14,35,155,55,230,120,405,190
4814,Le Mesnil-Mauger,14422,14,84,280,95,387,220,702,364
4815,Le Mesnil-Patry,14423,14,12,88,24,122,28,174,100
4816,Le Mesnil-Robert,14424,14,20,60,15,70,25,110,80
4817,Le Mesnil-Simon,14425,14,14,55,5,89,35,129,69
4818,Le Mesnil-sur-Blangy,14426,14,35,20,30,85,0,115,55
4819,Le Mesnil-Villement,14427,14,39,69,20,77,66,163,108
4820,Meuvaines,14430,14,14,25,20,65,10,95,39
4821,Mézidon-Canon,14431,14,619,1320,506,1433,900,2839,1939
4822,Mittois,14433,14,15,40,5,50,35,90,55
4823,Les Monceaux,14435,14,15,50,15,55,45,115,65
4824,Monceaux-en-Bessin,14436,14,28,136,42,180,115,337,164
4825,Mondeville,14437,14,1288,1969,1345,3186,1552,6083,3257
4826,Mondrainville,14438,14,20,163,4,137,135,276,183
4827,Monfréville,14439,14,20,20,12,16,24,52,40
4828,Monteille,14444,14,8,34,8,56,30,94,42
4829,Montfiquet,14445,14,8,25,8,32,8,48,33
4830,Montigny,14446,14,8,28,4,40,24,68,36
4831,Montreuil-en-Auge,14448,14,6,7,0,29,0,29,13
4832,Monts-en-Bessin,14449,14,33,87,24,162,57,243,120
4833,Montviette,14450,14,35,35,15,55,40,110,70
4834,Morteaux-Couliboeuf,14452,14,62,164,70,125,126,321,226
4835,Mosles,14453,14,35,105,30,125,65,220,140
4836,Mouen,14454,14,114,342,142,493,269,904,456
4837,Moulines,14455,14,16,61,33,75,49,157,77
4838,Moult,14456,14,115,717,200,611,461,1272,832
4839,Les Moutiers-en-Auge,14457,14,15,38,15,26,24,65,53
4840,Les Moutiers-en-Cinglais,14458,14,24,105,12,97,97,206,129
4841,Moyaux,14460,14,224,337,86,401,229,716,561
4842,Mutrécy,14461,14,30,115,10,75,130,215,145
4843,Neuilly-la-Forêt,14462,14,70,120,15,180,65,260,190
4844,Nonant,14465,14,24,128,32,200,92,324,152
4845,Norolles,14466,14,24,64,16,124,52,192,88
4846,Noron-l'Abbaye,14467,14,25,80,15,95,75,185,105
4847,Noron-la-Poterie,14468,14,65,102,25,81,89,195,167
4848,Norrey-en-Auge,14469,14,0,30,10,50,5,65,30
4849,L'Oudon,14472,14,164,359,103,504,287,894,523
4850,Notre-Dame-de-Livaye,14473,14,6,24,0,50,12,62,30
4851,Notre-Dame-d'Estrées-Corbon,14474,14,23,60,20,59,57,136,83
4852,Noyers-Missy,14475,14,129,436,179,495,293,967,565
4853,Olendon,14476,14,16,56,44,52,40,136,72
4854,Ondefontaine,14477,14,52,86,28,105,65,198,138
4855,Orbec,14478,14,441,503,209,591,307,1107,944
4856,Osmanville,14480,14,53,140,64,164,72,300,193
4857,Les Oubeaux,14481,14,15,45,15,95,45,155,60
4858,Ouézy,14482,14,16,56,8,88,44,140,72
4859,Ouffières,14483,14,20,64,16,56,48,120,84
4860,Ouilly-du-Houley,14484,14,20,52,16,62,30,108,72
4861,Ouilly-le-Tesson,14486,14,85,190,40,165,110,315,275
4862,Ouilly-le-Vicomte,14487,14,200,185,20,260,145,425,385
4863,Ouistreham,14488,14,1548,1847,750,3456,1449,5655,3395
4864,Ouville-la-Bien-Tournée,14489,14,28,48,20,96,28,144,76
4865,Parfouru-sur-Odon,14491,14,12,56,12,80,40,132,68
4866,Pennedepie,14492,14,52,70,15,89,70,174,122
4867,Percy-en-Auge,14493,14,14,57,3,74,44,121,71
4868,Périers-en-Auge,14494,14,17,25,13,50,21,84,42
4869,Périers-sur-le-Dan,14495,14,55,110,10,210,105,325,165
4870,Périgny,14496,14,16,16,0,12,12,24,32
4871,Perrières,14497,14,25,90,15,114,70,199,115
4872,Pertheville-Ners,14498,14,20,60,20,110,40,170,80
4873,Petiville,14499,14,40,110,35,195,85,315,150
4874,Pierrefitte-en-Auge,14500,14,5,55,5,60,30,95,60
4875,Pierrefitte-en-Cinglais,14501,14,55,85,25,60,45,130,140
4876,Pierrepont,14502,14,10,20,15,30,15,60,30
4877,Le Pin,14504,14,90,245,25,230,204,459,335
4878,Placy,14505,14,9,40,40,64,20,124,49
4879,Planquery,14506,14,29,62,21,60,39,120,91
4880,Le Plessis-Grimoult,14508,14,25,120,50,131,55,236,145
4881,Plumetot,14509,14,20,60,24,92,24,140,80
4882,La Pommeraye,14510,14,0,12,13,16,12,41,12
4883,Pont-Bellanger,14511,14,8,24,0,28,12,40,32
4884,Pontécoulant,14512,14,20,15,10,25,10,45,35
4885,Pont-Farcy,14513,14,100,145,35,175,75,285,245
4886,Pont-l'Évêque,14514,14,600,1067,480,1243,872,2595,1667
4887,Port-en-Bessin-Huppain,14515,14,397,310,200,778,285,1263,707
4888,Potigny,14516,14,250,485,240,575,395,1210,735
4889,Poussy-la-Campagne,14517,14,10,25,5,35,10,50,35
4890,Préaux-Bocage,14519,14,6,38,3,39,15,57,44
4891,Le Pré-d'Auge,14520,14,42,240,80,275,174,529,282
4892,Prêtreville,14522,14,9,96,39,170,77,286,105
4893,Putot-en-Auge,14524,14,25,70,20,145,50,215,95
4894,Putot-en-Bessin,14525,14,24,105,25,133,72,230,129
4895,Biéville-Quétiéville,14527,14,20,75,50,140,55,245,95
4896,Quetteville,14528,14,30,102,4,135,60,199,132
4897,Ranchy,14529,14,12,64,24,60,60,144,76
4898,Ranville,14530,14,244,381,143,617,255,1015,625
4899,Rapilly,14531,14,4,8,0,24,4,28,12
4900,Repentigny,14533,14,25,25,5,20,20,45,50
4901,Reux,14534,14,20,110,56,84,129,269,130
4902,Reviers,14535,14,44,176,44,200,136,380,220
4903,La Rivière-Saint-Sauveur,14536,14,220,586,254,721,506,1481,806
4904,Rocquancourt,14538,14,43,298,79,196,221,496,341
4905,Rocques,14540,14,38,44,0,80,30,110,82
4906,La Roque-Baignard,14541,14,0,35,4,35,29,68,35
4907,Rosel,14542,14,28,132,40,288,76,404,160
4908,Rots,14543,14,293,589,173,834,429,1436,882
4909,Roucamps,14544,14,8,77,16,48,69,133,85
4910,Rouvres,14546,14,22,63,13,54,33,100,85
4911,Rubercy,14547,14,8,54,12,41,36,89,62
4912,Rucqueville,14548,14,4,32,8,64,12,84,36
4913,Rumesnil,14550,14,4,21,8,39,12,59,25
4914,Russy,14551,14,0,69,33,25,60,118,69
4915,Ryes,14552,14,46,129,28,179,64,271,175
4916,Saint-Aignan-de-Cramesnil,14554,14,24,160,40,120,152,312,184
4917,Saint-André-d'Hébertot,14555,14,25,115,30,170,105,305,140
4918,Saint-André-sur-Orne,14556,14,173,496,151,529,308,988,669
4919,Saint-Arnoult,14557,14,164,185,90,473,155,718,349
4920,Saint-Aubin-d'Arquenay,14558,14,36,210,44,290,146,480,246
4921,Saint-Aubin-des-Bois,14559,14,65,65,15,65,30,110,130
4922,Saint-Aubin-sur-Mer,14562,14,276,547,165,934,321,1420,823
4923,Saint-Benoît-d'Hébertot,14563,14,63,105,40,85,120,245,168
4924,Saint-Côme-de-Fresné,14565,14,45,75,5,95,50,150,120
4925,Saint-Contest,14566,14,291,645,190,887,378,1455,936
4926,Sainte-Croix-Grand-Tonne,14568,14,16,73,15,88,42,145,89
4927,Sainte-Croix-sur-Mer,14569,14,12,72,26,55,58,139,84
4928,Valorbiquet,14570,14,254,673,260,728,536,1524,927
4929,Saint-Denis-de-Mailloc,14571,14,36,58,16,85,53,154,94
4930,Saint-Denis-de-Méré,14572,14,75,180,42,276,146,464,255
4931,Saint-Désir,14574,14,231,365,128,605,260,993,596
4932,Saint-Étienne-la-Thillaye,14575,14,80,100,16,168,76,260,180
4933,Val-de-Vie,14576,14,71,111,26,163,102,291,182
4934,Saint-Gabriel-Brécy,14577,14,20,97,44,84,89,217,117
4935,Saint-Gatien-des-Bois,14578,14,133,255,128,434,189,751,388
4936,Seulline,14579,14,100,314,111,342,217,670,414
4937,Saint-Georges-en-Auge,14580,14,35,20,10,20,10,40,55
4938,Saint-Germain-d'Ectot,14581,14,24,104,16,80,68,164,128
4939,Saint-Germain-de-Livet,14582,14,60,210,90,265,125,480,270
4940,Saint-Germain-du-Pert,14586,14,32,25,8,70,12,90,57
4941,Saint-Germain-la-Blanche-Herbe,14587,14,159,705,294,779,409,1482,864
4942,Saint-Germain-Langot,14588,14,5,75,45,120,45,210,80
4943,Saint-Germain-le-Vasson,14589,14,80,240,85,355,180,620,320
4944,Sainte-Honorine-de-Ducy,14590,14,10,30,30,45,20,95,40
4945,Sainte-Honorine-des-Pertes,14591,14,50,138,27,185,110,322,188
4946,Sainte-Honorine-du-Fay,14592,14,85,423,59,451,259,769,508
4947,Saint-Hymer,14593,14,75,116,37,174,104,315,191
4948,Saint-Jean-de-Livet,14595,14,29,40,16,45,40,101,69
4949,Saint-Jean-des-Essartiers,14596,14,50,50,20,60,35,115,100
4950,Saint-Jean-le-Blanc,14597,14,43,80,35,135,55,225,123
4951,Saint-Jouin,14598,14,30,30,12,50,24,86,60
4952,Saint-Julien-le-Faucon,14600,14,85,216,45,200,145,390,301
4953,Saint-Julien-sur-Calonne,14601,14,30,30,15,65,35,115,60
4954,Saint-Lambert,14602,14,20,76,16,88,68,172,96
4955,Saint-Laurent-de-Condel,14603,14,36,126,12,172,77,261,162
4956,Saint-Laurent-du-Mont,14604,14,20,55,0,58,50,108,75
4957,Saint-Laurent-sur-Mer,14605,14,24,40,4,104,60,168,64
4958,Saint-Léger-Dubosq,14606,14,15,45,10,50,30,90,60
4959,Saint-Louet-sur-Seulles,14607,14,25,35,15,45,20,80,60
4960,Saint-Loup-de-Fribois,14608,14,30,65,10,55,35,100,95
4961,Saint-Loup-Hors,14609,14,36,94,36,107,91,234,130
4962,Saint-Manvieu-Norrey,14610,14,88,468,194,650,368,1212,556
4963,Saint-Manvieu-Bocage,14611,14,44,130,30,166,110,306,174
4964,Saint-Marcouf,14613,14,17,13,17,16,8,41,30
4965,Sainte-Marguerite-d'Elle,14614,14,84,175,53,268,99,420,259
4966,Sainte-Marguerite-de-Viette,14616,14,35,95,10,140,70,220,130
4967,Sainte-Marie-Outre-l'Eau,14619,14,20,25,0,35,25,60,45
4968,Saint-Martin-aux-Chartrains,14620,14,52,76,28,160,72,260,128
4969,Saint-Martin-de-Bienfaite-la-Cressonnière,14621,14,80,115,16,171,97,284,195
4970,Saint-Martin-de-Blagny,14622,14,8,29,8,41,39,88,37
4971,Saint-Martin-de-Fontenay,14623,14,321,733,186,721,493,1400,1054
4972,Saint-Martin-de-la-Lieue,14625,14,152,130,59,268,114,441,282
4973,Saint-Martin-de-Mailloc,14626,14,88,240,44,352,164,560,328
4974,Saint-Martin-de-Mieux,14627,14,20,124,36,176,80,292,144
4975,Saint-Martin-des-Entrées,14630,14,24,140,70,256,100,426,164
4976,Saint-Omer,14635,14,20,40,20,52,40,112,60
4977,Saint-Ouen-du-Mesnil-Oger,14637,14,20,55,20,75,45,140,75
4978,Saint-Ouen-le-Pin,14639,14,20,70,5,135,45,185,90
4979,Saint-Pair,14640,14,30,45,10,90,25,125,75
4980,Saint-Paul-du-Vernay,14643,14,85,255,40,212,200,452,340
4981,Saint-Philbert-des-Champs,14644,14,81,144,43,251,82,376,225
4982,Saint-Pierre-Azif,14645,14,25,45,10,75,25,110,70
4983,Saint-Pierre-Canivet,14646,14,51,87,29,127,55,211,138
4984,Saint-Pierre-des-Ifs,14648,14,50,135,20,205,75,300,185
4985,Saint-Pierre-du-Bû,14649,14,15,115,65,180,80,325,130
4986,Saint-Pierre-du-Fresne,14650,14,35,60,5,55,40,100,95
4987,Saint-Pierre-du-Jonquet,14651,14,18,68,21,59,40,120,86
4988,Saint-Pierre-du-Mont,14652,14,20,12,0,33,12,45,32
4989,Saint-Pierre-sur-Dives,14654,14,695,762,339,1054,434,1827,1457
4990,Saint-Rémy,14656,14,144,230,105,403,160,668,374
4991,Saint-Samson,14657,14,58,50,30,154,30,214,108
4992,Saint-Sever-Calvados,14658,14,289,214,52,328,138,518,503
4993,Saint-Sylvain,14659,14,125,450,110,380,348,838,575
4994,Saint-Vaast-en-Auge,14660,14,6,24,0,24,26,50,30
4995,Saint-Vaast-sur-Seulles,14661,14,15,25,20,30,25,75,40
4996,Saint-Vigor-des-Mézerets,14662,14,25,50,35,90,30,155,75
4997,Saint-Vigor-le-Grand,14663,14,345,495,200,794,379,1373,840
4998,Sallen,14664,14,22,77,16,78,58,152,99
4999,Sallenelles,14665,14,16,88,28,116,76,220,104
5000,Sannerville,14666,14,183,505,148,617,380,1145,688
5001,Saon,14667,14,12,68,8,96,48,152,80
5002,Saonnet,14668,14,24,72,36,80,68,184,96
5003,Sassy,14669,14,32,64,0,52,52,104,96
5004,Sept-Frères,14671,14,72,85,48,108,64,220,157
5005,Sept-Vents,14672,14,48,112,92,116,56,264,160
5006,Soignolles,14674,14,5,50,0,25,45,70,55
5007,Soliers,14675,14,192,596,180,761,354,1295,788
5008,Sommervieu,14676,14,84,276,84,356,228,668,360
5009,Soulangy,14677,14,25,60,15,95,50,160,85
5010,Soumont-Saint-Quentin,14678,14,60,148,64,136,120,320,208
5011,Subles,14679,14,35,165,55,224,175,454,200
5012,Sully,14680,14,12,22,0,56,29,85,34
5013,Surrain,14681,14,15,50,15,60,25,100,65
5014,Surville,14682,14,80,65,39,163,60,262,145
5015,Tessel,14684,14,0,90,20,75,80,175,90
5016,Thaon,14685,14,153,364,115,505,214,834,517
5017,Le Theil-en-Auge,14687,14,10,30,29,93,35,157,40
5018,Thiéville,14688,14,40,80,10,85,60,155,120
5019,Le Hom,14689,14,451,1048,254,1044,762,2060,1499
5020,Tierceville,14690,14,6,59,0,38,34,72,65
5021,Tilly-la-Campagne,14691,14,0,52,29,37,22,88,52
5022,Tilly-sur-Seulles,14692,14,149,499,143,374,393,910,648
5023,Le Torquesne,14694,14,30,135,55,172,115,342,165
5024,Torteval-Quesnay,14695,14,40,80,20,120,50,190,120
5025,Touffréville,14698,14,24,69,24,80,70,174,93
5026,Touques,14699,14,549,756,515,1371,548,2434,1305
5027,Tour-en-Bessin,14700,14,58,183,17,179,147,343,241
5028,Tourgéville,14701,14,247,89,63,377,87,527,336
5029,Tournay-sur-Odon,14702,14,20,96,40,160,52,252,116
5030,Tournebu,14703,14,20,85,40,130,65,235,105
5031,Tournières,14705,14,23,25,23,46,12,81,48
5032,Tourville-en-Auge,14706,14,35,60,5,115,30,150,95
5033,Tourville-sur-Odon,14707,14,51,299,54,359,188,601,350
5034,Tracy-Bocage,14708,14,36,64,28,116,52,196,100
5035,Tracy-sur-Mer,14709,14,53,100,20,130,55,205,153
5036,Tréprel,14710,14,6,36,6,21,34,61,42
5037,Trévières,14711,14,185,225,55,240,170,465,410
5038,Troarn,14712,14,517,886,302,973,754,2029,1403
5039,Trois-Monts,14713,14,40,130,10,119,125,254,170
5040,Le Tronquay,14714,14,56,204,48,276,204,528,260
5041,Trouville-sur-Mer,14715,14,1107,739,368,1721,627,2716,1846
5042,Trungy,14716,14,25,65,5,45,70,120,90
5043,Urville,14719,14,46,178,51,172,156,379,224
5044,Ussy,14720,14,70,266,65,348,128,541,336
5045,Vacognes-Neuilly,14721,14,28,175,32,139,150,321,203
5046,La Vacquerie,14722,14,30,85,30,95,75,200,115
5047,Valsemé,14723,14,25,55,15,120,50,185,80
5048,Varaville,14724,14,149,198,48,342,157,547,347
5049,Valdallière,14726,14,799,1625,486,2057,1014,3557,2424
5050,Vaucelles,14728,14,20,100,19,133,105,257,120
5051,Vaudeloges,14729,14,25,65,5,65,40,110,90
5052,Vauville,14731,14,28,19,6,91,13,110,47
5053,Vaux-sur-Aure,14732,14,65,60,30,150,30,210,125
5054,Vaux-sur-Seulles,14733,14,10,65,20,144,60,224,75
5055,Vendes,14734,14,30,80,40,120,45,205,110
5056,Vendeuvre,14735,14,80,172,52,232,156,440,252
5057,Versainville,14737,14,24,143,32,156,80,268,167
5058,Verson,14738,14,337,859,270,1200,611,2081,1196
5059,Ver-sur-Mer,14739,14,200,340,92,632,292,1016,540
5060,La Vespière-Friardel,14740,14,173,297,83,444,199,726,470
5061,Le Vey,14741,14,16,44,12,32,20,64,60
5062,Vicques,14742,14,16,16,0,12,16,28,32
5063,Victot-Pontfol,14743,14,25,35,5,20,25,50,60
5064,Vienne-en-Bessin,14744,14,0,72,28,121,33,182,72
5065,Vierville-sur-Mer,14745,14,84,40,8,100,20,128,124
5066,Vieux,14747,14,44,204,68,236,152,456,248
5067,Vieux-Bourg,14748,14,0,28,4,48,20,72,28
5068,Vieux-Fumé,14749,14,29,148,57,85,111,253,177
5069,Vieux-Pont-en-Auge,14750,14,33,54,16,92,52,160,87
5070,Vignats,14751,14,20,85,10,125,50,185,105
5071,Villers-Bocage,14752,14,455,695,274,922,504,1700,1150
5072,Villers-Canivet,14753,14,52,281,24,184,229,437,333
5073,Villers-sur-Mer,14754,14,672,465,180,965,435,1580,1137
5074,Villerville,14755,14,66,150,50,263,94,407,216
5075,La Villette,14756,14,16,60,32,56,56,144,76
5076,Villiers-le-Sec,14757,14,20,90,25,125,45,195,110
5077,Villons-les-Buissons,14758,14,77,180,35,286,123,444,257
5078,Villy-lez-Falaise,14759,14,26,66,27,71,42,140,92
5079,Villy-Bocage,14760,14,35,265,50,269,180,499,300
5080,Vimont,14761,14,45,235,60,170,205,435,280
5081,Vire Normandie,14762,14,2772,3736,1625,6010,2876,10511,6508
5082,Vouilly,14763,14,14,17,15,69,3,87,31
5083,Pont-d'Ouilly,14764,14,162,253,84,336,183,603,415
5084,Allanche,15001,15,132,80,40,278,86,404,212
5085,Alleuze,15002,15,20,60,10,75,50,135,80
5086,Ally,15003,15,156,74,32,216,62,310,230
5087,Andelat,15004,15,70,120,30,125,110,265,190
5088,Anglards-de-Saint-Flour,15005,15,16,75,22,136,63,221,91
5089,Anglards-de-Salers,15006,15,160,165,30,335,95,460,325
5090,Anterrieux,15007,15,5,30,20,45,25,90,35
5091,Antignac,15008,15,40,55,10,120,55,185,95
5092,Apchon,15009,15,20,25,5,95,35,135,45
5093,Arches,15010,15,50,30,5,59,30,94,80
5094,Arnac,15011,15,18,17,3,61,19,83,35
5095,Arpajon-sur-Cère,15012,15,794,1285,495,2397,1050,3942,2079
5096,Auriac-l'Église,15013,15,56,6,3,46,21,70,62
5097,Aurillac,15014,15,4075,4638,3012,8728,4072,15812,8713
5098,Auzers,15015,15,29,15,20,80,15,115,44
5099,Ayrens,15016,15,60,140,80,225,135,440,200
5100,Badailhac,15017,15,26,16,0,47,21,68,42
5101,Barriac-les-Bosquets,15018,15,30,15,0,70,5,75,45
5102,Bassignac,15019,15,32,44,12,80,40,132,76
5103,Beaulieu,15020,15,16,17,8,28,12,48,33
5104,Boisset,15021,15,108,110,26,186,131,343,218
5105,Bonnac,15022,15,25,25,20,75,30,125,50
5106,Brageac,15024,15,10,12,0,18,14,32,22
5107,Albepierre-Bredons,15025,15,28,30,16,109,28,153,58
5108,Brezons,15026,15,26,15,16,61,31,108,41
5109,Calvinet,15027,15,164,100,36,120,88,244,264
5110,Carlat,15028,15,70,60,30,130,55,215,130
5111,Cassaniouze,15029,15,140,95,15,205,85,305,235
5112,Cayrols,15030,15,16,62,16,86,63,165,78
5113,Celles,15031,15,24,44,8,84,52,144,68
5114,Celoux,15032,15,16,8,16,32,4,52,24
5115,Cézens,15033,15,44,40,12,84,40,136,84
5116,Chaliers,15034,15,30,30,5,85,15,105,60
5117,Chalinargues,15035,15,80,64,32,130,51,213,144
5118,Chalvignac,15036,15,64,83,9,165,69,243,147
5119,Champagnac,15037,15,199,196,65,393,119,577,395
5120,Champs-sur-Tarentaine-Marchal,15038,15,263,162,28,361,170,559,425
5121,Chanterelle,15040,15,3,13,3,34,22,59,16
5122,La Chapelle-d'Alagnon,15041,15,19,28,3,98,43,144,47
5123,La Chapelle-Laurent,15042,15,36,71,27,99,51,177,107
5124,Charmensac,15043,15,33,8,0,25,12,37,41
5125,Chastel-sur-Murat,15044,15,23,13,9,31,16,56,36
5126,Chaudes-Aigues,15045,15,155,90,90,355,80,525,245
5127,Chaussenac,15046,15,85,35,20,65,35,120,120
5128,Chavagnac,15047,15,20,28,0,28,20,48,48
5129,Chazelles,15048,15,16,0,0,16,4,20,16
5130,Cheylade,15049,15,64,13,14,65,35,114,77
5131,Le Claux,15050,15,25,20,5,105,25,135,45
5132,Clavières,15051,15,54,22,12,64,33,109,76
5133,Collandres,15052,15,33,12,17,45,15,77,45
5134,Coltines,15053,15,20,110,60,185,100,345,130
5135,Condat,15054,15,120,168,88,400,172,660,288
5136,Coren,15055,15,45,83,20,151,74,245,128
5137,Crandelles,15056,15,37,185,35,283,174,492,222
5138,Cros-de-Montvert,15057,15,48,23,13,54,27,94,71
5139,Cros-de-Ronesque,15058,15,10,25,10,65,25,100,35
5140,Cussac,15059,15,20,35,0,75,15,90,55
5141,Deux-Verges,15060,15,9,10,3,9,10,22,19
5142,Dienne,15061,15,62,31,17,94,20,131,93
5143,Drugeac,15063,15,75,80,5,125,75,205,155
5144,Escorailles,15064,15,8,16,4,32,16,52,24
5145,Espinasse,15065,15,8,22,12,12,17,41,30
5146,Le Falgoux,15066,15,38,3,9,44,3,56,41
5147,Le Fau,15067,15,12,0,0,12,4,16,12
5148,Ferrières-Saint-Mary,15069,15,65,25,20,100,25,145,90
5149,Fontanges,15070,15,55,25,5,95,25,125,80
5150,Freix-Anglards,15072,15,53,24,32,65,12,109,77
5151,Fridefont,15073,15,45,0,5,40,10,55,45
5152,Giou-de-Mamou,15074,15,93,160,41,274,138,453,253
5153,Girgols,15075,15,8,20,4,28,16,48,28
5154,Glénat,15076,15,35,13,12,63,12,87,48
5155,Gourdièges,15077,15,12,10,0,12,12,24,22
5156,Jabrun,15078,15,28,20,4,96,20,120,48
5157,Jaleyrac,15079,15,40,90,20,135,90,245,130
5158,Joursac,15080,15,32,28,4,64,28,96,60
5159,Jou-sous-Monjou,15081,15,13,10,3,76,6,85,23
5160,Junhac,15082,15,112,40,32,80,40,152,152
5161,Jussac,15083,15,340,430,155,718,355,1228,770
5162,Labesserette,15084,15,56,56,24,108,36,168,112
5163,Labrousse,15085,15,51,129,38,121,114,273,180
5164,Lacapelle-Barrès,15086,15,15,10,5,15,5,25,25
5165,Lacapelle-del-Fraisse,15087,15,30,100,30,110,75,215,130
5166,Lacapelle-Viescamp,15088,15,84,88,44,180,100,324,172
5167,Ladinhac,15089,15,107,120,35,135,88,258,227
5168,Lafeuillade-en-Vézie,15090,15,90,165,25,170,150,345,255
5169,Landeyrat,15091,15,24,13,6,21,9,36,37
5170,Lanobre,15092,15,280,235,110,630,155,895,515
5171,Lapeyrugue,15093,15,44,20,0,24,20,44,64
5172,Laroquebrou,15094,15,115,108,38,349,103,490,223
5173,Laroquevieille,15095,15,52,60,28,160,60,248,112
5174,Lascelle,15096,15,40,80,20,125,60,205,120
5175,Lastic,15097,15,5,20,35,45,10,90,25
5176,Laurie,15098,15,15,15,10,36,15,61,30
5177,Lavastrie,15099,15,44,48,36,72,52,160,92
5178,Laveissenet,15100,15,25,34,4,24,25,53,59
5179,Laveissière,15101,15,47,108,39,173,125,337,155
5180,Lavigerie,15102,15,18,13,0,36,17,53,31
5181,Leucamp,15103,15,35,35,5,115,40,160,70
5182,Leynhac,15104,15,61,69,9,99,69,177,130
5183,Leyvaux,15105,15,4,0,0,20,0,20,4
5184,Lieutadès,15106,15,30,10,5,90,20,115,40
5185,Lorcières,15107,15,25,40,15,65,25,105,65
5186,Val d'Arcomie,15108,15,215,154,82,326,172,580,369
5187,Lugarde,15110,15,35,35,20,60,20,100,70
5188,Madic,15111,15,50,25,20,95,25,140,75
5189,Malbo,15112,15,12,13,6,29,12,47,25
5190,Mandailles-Saint-Julien,15113,15,45,40,15,60,35,110,85
5191,Marcenat,15114,15,56,63,34,192,53,279,119
5192,Marchastel,15116,15,8,21,8,64,17,89,29
5193,Marcolès,15117,15,105,144,44,204,108,356,249
5194,Marmanhac,15118,15,75,140,48,241,131,420,215
5195,Massiac,15119,15,285,285,115,637,275,1027,570
5196,Mauriac,15120,15,770,653,343,1094,537,1974,1423
5197,Maurines,15121,15,18,19,0,31,15,46,37
5198,Maurs,15122,15,603,350,149,629,275,1053,953
5199,Méallet,15123,15,26,9,13,78,17,108,35
5200,Menet,15124,15,105,120,40,223,80,343,225
5201,Mentières,15125,15,24,23,3,28,21,52,47
5202,Molèdes,15126,15,35,0,0,40,10,50,35
5203,Molompize,15127,15,45,71,10,121,50,181,116
5204,La Monselie,15128,15,20,9,7,44,9,60,29
5205,Montboudif,15129,15,29,17,8,86,8,102,46
5206,Montchamp,15130,15,24,24,20,44,16,80,48
5207,Le Monteil,15131,15,80,56,12,92,32,136,136
5208,Montgreleix,15132,15,8,8,0,16,0,16,16
5209,Montmurat,15133,15,20,20,8,55,8,71,40
5210,Montsalvy,15134,15,196,156,32,276,144,452,352
5211,Montvert,15135,15,34,8,4,28,12,44,42
5212,Mourjou,15136,15,104,40,30,135,25,190,144
5213,Moussages,15137,15,30,50,10,135,50,195,80
5214,Murat,15138,15,305,213,172,664,232,1068,518
5215,Narnhac,15139,15,30,5,5,40,5,50,35
5216,Naucelles,15140,15,308,380,132,772,328,1232,688
5217,Neussargues-Moissac,15141,15,156,192,36,356,208,600,348
5218,Neuvéglise,15142,15,153,203,57,450,162,669,356
5219,Nieudan,15143,15,20,24,4,52,20,76,44
5220,Omps,15144,15,48,104,24,112,60,196,152
5221,Oradour,15145,15,55,55,5,70,45,120,110
5222,Pailherols,15146,15,16,19,3,55,25,83,35
5223,Parlan,15147,15,45,64,37,104,77,218,109
5224,Paulhac,15148,15,85,45,40,165,60,265,130
5225,Paulhenc,15149,15,28,32,8,96,20,124,60
5226,Peyrusse,15151,15,40,10,15,50,40,105,50
5227,Pierrefort,15152,15,180,128,56,340,124,520,308
5228,Pleaux,15153,15,355,180,111,535,217,863,535
5229,Polminhac,15154,15,196,224,44,400,260,704,420
5230,Pradiers,15155,15,25,10,5,45,10,60,35
5231,Prunet,15156,15,38,183,54,164,170,388,221
5232,Quézac,15157,15,57,54,27,69,42,138,111
5233,Rageade,15158,15,7,11,12,39,6,57,18
5234,Raulhac,15159,15,85,20,25,100,10,135,105
5235,Reilhac,15160,15,140,255,95,375,200,670,395
5236,Rézentières,15161,15,28,20,16,40,12,68,48
5237,Riom-ès-Montagnes,15162,15,440,433,227,915,391,1533,873
5238,Roannes-Saint-Mary,15163,15,180,268,80,300,228,608,448
5239,Roffiac,15164,15,39,157,38,225,109,372,196
5240,Rouffiac,15165,15,36,48,3,74,34,111,84
5241,Roumégoux,15166,15,32,83,32,100,52,184,115
5242,Rouziers,15167,15,25,35,5,5,30,40,60
5243,Ruynes-en-Margeride,15168,15,78,135,67,214,104,385,213
5244,Saignes,15169,15,235,110,45,277,115,437,345
5245,Saint-Amandin,15170,15,46,23,12,57,33,102,69
5246,Sainte-Anastasie,15171,15,15,35,5,50,40,95,50
5247,Saint-Antoine,15172,15,35,10,5,45,15,65,45
5248,Saint-Bonnet-de-Condat,15173,15,17,16,4,40,13,57,33
5249,Saint-Bonnet-de-Salers,15174,15,52,37,9,112,47,168,89
5250,Saint-Cernin,15175,15,130,240,80,385,200,665,370
5251,Saint-Chamant,15176,15,39,36,32,68,22,122,75
5252,Saint-Cirgues-de-Jordanne,15178,15,9,14,6,56,23,85,23
5253,Saint-Cirgues-de-Malbert,15179,15,70,45,15,74,59,148,115
5254,Saint-Clément,15180,15,4,16,0,28,12,40,20
5255,Saint-Constant-Fournoulès,15181,15,174,94,30,194,67,291,268
5256,Saint-Étienne-Cantalès,15182,15,5,25,20,60,15,95,30
5257,Saint-Étienne-de-Carlat,15183,15,16,44,12,36,36,84,60
5258,Saint-Étienne-de-Maurs,15184,15,182,140,30,285,140,455,322
5259,Saint-Étienne-de-Chomeil,15185,15,54,60,9,69,50,128,114
5260,Sainte-Eulalie,15186,15,36,44,12,68,48,128,80
5261,Saint-Flour,15187,15,771,1250,793,2161,1019,3973,2021
5262,Saint-Georges,15188,15,142,267,57,421,182,660,409
5263,Saint-Gérons,15189,15,35,45,20,85,50,155,80
5264,Saint-Hippolyte,15190,15,29,8,0,42,21,63,37
5265,Saint-Illide,15191,15,120,120,32,196,92,320,240
5266,Saint-Jacques-des-Blats,15192,15,55,70,45,110,60,215,125
5267,Saint-Julien-de-Toursac,15194,15,19,19,3,43,12,58,38
5268,Saint-Mamet-la-Salvetat,15196,15,195,355,135,520,315,970,550
5269,Sainte-Marie,15198,15,36,16,0,24,36,60,52
5270,Saint-Martial,15199,15,8,17,4,12,25,41,25
5271,Saint-Martin-Cantalès,15200,15,49,27,3,28,27,58,76
5272,Saint-Martin-sous-Vigouroux,15201,15,100,10,40,90,0,130,110
5273,Saint-Martin-Valmeroux,15202,15,152,132,37,268,118,423,284
5274,Saint-Mary-le-Plain,15203,15,32,22,4,50,25,79,54
5275,Saint-Paul-des-Landes,15204,15,196,412,76,488,348,912,608
5276,Saint-Paul-de-Salers,15205,15,29,0,9,45,6,60,29
5277,Saint-Pierre,15206,15,20,20,10,45,25,80,40
5278,Saint-Poncy,15207,15,41,81,21,89,73,183,122
5279,Saint-Projet-de-Salers,15208,15,30,21,0,43,16,59,51
5280,Saint-Rémy-de-Chaudes-Aigues,15209,15,25,25,15,40,20,75,50
5281,Saint-Santin-Cantalès,15211,15,65,80,15,115,40,170,145
5282,Saint-Santin-de-Maurs,15212,15,70,60,15,125,85,225,130
5283,Saint-Saturnin,15213,15,36,25,12,63,28,103,61
5284,Saint-Saury,15214,15,33,29,18,56,18,92,62
5285,Saint-Simon,15215,15,180,276,56,372,260,688,456
5286,Saint-Urcize,15216,15,124,68,48,172,48,268,192
5287,Saint-Victor,15217,15,28,28,0,12,32,44,56
5288,Saint-Vincent-de-Salers,15218,15,35,0,0,30,0,30,35
5289,Salers,15219,15,56,41,15,122,36,173,97
5290,Salins,15220,15,18,19,9,77,10,96,37
5291,Sansac-de-Marmiesse,15221,15,132,290,93,499,233,825,422
5292,Sansac-Veinazès,15222,15,30,40,10,105,25,140,70
5293,Sauvat,15223,15,12,40,16,92,28,136,52
5294,La Ségalassière,15224,15,47,0,9,41,0,50,47
5295,Ségur-les-Villas,15225,15,40,35,15,65,55,135,75
5296,Sénezergues,15226,15,55,35,5,65,25,95,90
5297,Sériers,15227,15,25,15,15,55,15,85,40
5298,Siran,15228,15,85,81,12,180,61,253,166
5299,Soulages,15229,15,35,0,0,30,10,40,35
5300,Sourniac,15230,15,20,48,8,88,40,136,68
5301,Talizat,15231,15,120,130,35,175,120,330,250
5302,Tanavelle,15232,15,16,64,32,76,56,164,80
5303,Teissières-de-Cornet,15233,15,25,70,45,70,60,175,95
5304,Teissières-lès-Bouliès,15234,15,57,64,4,100,56,160,121
5305,Les Ternes,15235,15,65,150,55,225,90,370,215
5306,Thiézac,15236,15,105,100,35,250,130,415,205
5307,Tiviers,15237,15,28,21,8,63,20,91,49
5308,Tournemire,15238,15,48,12,0,43,15,58,60
5309,Trémouille,15240,15,38,19,0,60,26,86,57
5310,La Trinitat,15241,15,12,4,0,16,8,24,16
5311,Le Trioulou,15242,15,32,8,20,36,12,68,40
5312,Trizac,15243,15,105,52,21,229,50,300,157
5313,Ussel,15244,15,26,111,70,108,101,279,137
5314,Vabres,15245,15,25,40,65,95,20,180,65
5315,Valette,15246,15,20,71,15,100,45,160,91
5316,Valjouze,15247,15,4,4,8,4,0,12,8
5317,Valuéjols,15248,15,99,129,51,130,112,293,228
5318,Le Vaulmier,15249,15,12,4,0,24,8,32,16
5319,Vebret,15250,15,61,99,34,161,101,296,160
5320,Védrines-Saint-Loup,15251,15,29,37,4,43,20,67,66
5321,Velzic,15252,15,33,87,18,168,66,252,120
5322,Vernols,15253,15,8,8,0,40,12,52,16
5323,Veyrières,15254,15,45,15,15,35,5,55,60
5324,Vézac,15255,15,110,275,105,425,255,785,385
5325,Vèze,15256,15,10,0,0,30,10,40,10
5326,Vezels-Roussy,15257,15,35,20,0,65,15,80,55
5327,Vic-sur-Cère,15258,15,330,368,117,712,255,1084,698
5328,Vieillespesse,15259,15,28,76,16,84,68,168,104
5329,Vieillevie,15260,15,25,9,0,37,13,50,34
5330,Le Vigean,15261,15,123,144,43,309,140,492,267
5331,Villedieu,15262,15,56,124,28,208,96,332,180
5332,Virargues,15263,15,25,15,10,70,10,90,40
5333,Vitrac,15264,15,35,52,6,97,44,147,87
5334,Ydes,15265,15,305,307,112,601,268,981,612
5335,Yolet,15266,15,65,145,35,190,115,340,210
5336,Ytrac,15267,15,397,994,284,1586,706,2576,1391
5337,Le Rouget-Pers,15268,15,228,272,76,408,212,696,500
5338,Besse,15269,15,40,25,0,35,25,60,65
5339,Abzac,16001,16,49,70,20,243,55,318,119
5340,Les Adjots,16002,16,37,140,38,147,90,275,177
5341,Agris,16003,16,108,192,88,272,176,536,300
5342,Aignes-et-Puypéroux,16004,16,25,40,30,120,30,180,65
5343,Aigre,16005,16,220,192,72,308,148,528,412
5344,Alloue,16007,16,113,50,35,242,45,322,163
5345,Ambérac,16008,16,80,68,28,88,68,184,148
5346,Ambernac,16009,16,55,60,25,140,75,240,115
5347,Ambleville,16010,16,50,40,5,55,25,85,90
5348,Anais,16011,16,64,138,70,241,80,391,202
5349,Angeac-Champagne,16012,16,72,116,32,192,104,328,188
5350,Angeac-Charente,16013,16,32,76,12,142,52,206,108
5351,Angeduc,16014,16,20,36,5,35,35,75,56
5352,Angoulême,16015,16,5390,9367,6366,11958,7621,25945,14757
5353,Ansac-sur-Vienne,16016,16,220,150,95,280,75,450,370
5354,Anville,16017,16,24,58,9,42,32,83,82
5355,Ars,16018,16,58,173,39,308,106,453,231
5356,Asnières-sur-Nouère,16019,16,87,293,112,388,250,750,380
5357,Aubeterre-sur-Dronne,16020,16,75,40,20,125,40,185,115
5358,Aunac,16023,16,72,64,20,108,56,184,136
5359,Aussac-Vadalle,16024,16,56,112,48,184,116,348,168
5360,Baignes-Sainte-Radegonde,16025,16,248,276,89,408,216,713,524
5361,Balzac,16026,16,195,265,90,510,255,855,460
5362,Barbezières,16027,16,20,15,5,68,5,78,35
5363,Barbezieux-Saint-Hilaire,16028,16,858,882,320,1637,615,2572,1740
5364,Bardenac,16029,16,30,55,25,100,10,135,85
5365,Barret,16030,16,130,185,85,404,165,654,315
5366,Barro,16031,16,35,100,25,114,105,244,135
5367,Bassac,16032,16,80,140,52,136,132,320,220
5368,Bayers,16033,16,15,20,15,50,15,80,35
5369,Bazac,16034,16,20,25,15,70,15,100,45
5370,Beaulieu-sur-Sonnette,16035,16,41,34,10,104,22,136,75
5371,Bécheresse,16036,16,40,60,40,95,50,185,100
5372,Bellon,16037,16,50,30,15,60,5,80,80
5373,Benest,16038,16,79,60,7,119,33,159,139
5374,Bernac,16039,16,54,124,10,180,123,313,178
5375,Berneuil,16040,16,60,40,25,130,45,200,100
5376,Bessac,16041,16,32,6,9,39,3,51,38
5377,Bessé,16042,16,32,28,0,60,24,84,60
5378,Bioussac,16044,16,37,57,8,70,43,121,94
5379,Birac,16045,16,35,115,35,100,95,230,150
5380,Blanzac-Porcheresse,16046,16,160,170,85,215,134,434,330
5381,Blanzaguet-Saint-Cybard,16047,16,31,47,26,114,35,175,78
5382,Boisbreteau,16048,16,35,10,10,55,15,80,45
5383,Bonnes,16049,16,65,80,45,165,60,270,145
5384,Bonneuil,16050,16,40,80,5,120,35,160,120
5385,Bonneville,16051,16,26,21,16,42,20,78,47
5386,Bors (Canton de Tude-et-Lavalette),16052,16,56,38,20,66,34,120,94
5387,Bors (Canton de Charente-Sud),16053,16,20,30,10,40,25,75,50
5388,Le Bouchage,16054,16,33,6,9,48,18,75,39
5389,Bouëx,16055,16,78,232,42,277,216,535,310
5390,Bourg-Charente,16056,16,75,138,94,310,119,523,213
5391,Bouteville,16057,16,40,60,20,154,45,219,100
5392,Boutiers-Saint-Trojan,16058,16,224,309,92,532,294,918,533
5393,Brettes,16059,16,20,25,5,80,15,100,45
5394,Bréville,16060,16,36,104,29,226,84,339,140
5395,Brie,16061,16,260,1067,333,1310,859,2502,1327
5396,Brie-sous-Barbezieux,16062,16,12,12,4,45,20,69,24
5397,Brie-sous-Chalais,16063,16,30,20,15,45,45,105,50
5398,Brigueuil,16064,16,111,212,92,394,147,633,323
5399,Brillac,16065,16,89,145,27,234,57,318,234
5400,Brossac,16066,16,92,60,15,257,65,337,152
5401,Bunzac,16067,16,26,118,36,120,118,274,144
5402,Cellefrouin,16068,16,80,125,55,233,70,358,205
5403,Cellettes,16069,16,48,108,28,172,76,276,156
5404,Chabanais,16070,16,393,290,95,597,240,932,683
5405,Chabrac,16071,16,64,110,65,240,90,395,174
5406,Chadurie,16072,16,72,132,24,168,104,296,204
5407,Chalais,16073,16,424,260,95,688,164,947,684
5408,Challignac,16074,16,25,60,45,115,55,215,85
5409,Champagne-Vigny,16075,16,30,50,30,85,50,165,80
5410,Champagne-Mouton,16076,16,216,105,50,406,80,536,321
5411,Champmillon,16077,16,56,152,36,152,132,320,208
5412,Champniers,16078,16,753,1159,362,1940,976,3278,1912
5413,Chantillac,16079,16,46,79,4,92,62,158,125
5414,La Chapelle,16081,16,44,48,36,44,40,120,92
5415,Boisné-La Tude,16082,16,95,191,57,228,138,423,286
5416,Charmé,16083,16,83,65,20,134,35,189,148
5417,Charras,16084,16,70,63,5,116,97,218,133
5418,Chasseneuil-sur-Bonnieure,16085,16,560,610,290,1075,425,1790,1170
5419,Chassenon,16086,16,152,140,65,349,96,510,292
5420,Chassiecq,16087,16,42,15,25,45,5,75,57
5421,Chassors,16088,16,152,236,88,460,172,720,388
5422,Châteaubernard,16089,16,621,647,224,1415,473,2112,1268
5423,Châteauneuf-sur-Charente,16090,16,515,712,266,1163,566,1995,1227
5424,Châtignac,16091,16,38,39,3,64,12,79,77
5425,Chazelles,16093,16,190,306,137,530,274,941,496
5426,Chenommet,16094,16,36,36,0,48,32,80,72
5427,Chenon,16095,16,65,20,10,20,20,50,85
5428,Cherves-Châtelars,16096,16,77,65,19,138,63,220,142
5429,Cherves-Richemont,16097,16,422,431,182,956,322,1460,853
5430,La Chèvrerie,16098,16,8,22,8,69,21,98,30
5431,Chillac,16099,16,24,44,12,76,48,136,68
5432,Chirac,16100,16,130,150,35,320,100,455,280
5433,Claix,16101,16,60,280,65,277,248,590,340
5434,Cognac,16102,16,2762,3895,2287,6038,3138,11463,6657
5435,Combiers,16103,16,36,16,8,48,8,64,52
5436,Condac,16104,16,44,104,36,164,108,308,148
5437,Condéon,16105,16,65,138,38,202,99,339,203
5438,Confolens,16106,16,456,431,208,957,373,1538,887
5439,Coulgens,16107,16,85,155,55,143,110,308,240
5440,Coulonges,16108,16,20,24,20,68,16,104,44
5441,Courbillac,16109,16,66,196,56,181,128,365,262
5442,Courcôme,16110,16,72,69,17,111,70,198,141
5443,Courgeac,16111,16,32,52,8,76,52,136,84
5444,Courlac,16112,16,15,10,0,30,10,40,25
5445,La Couronne,16113,16,1023,1665,960,2519,1161,4640,2688
5446,Couture,16114,16,40,40,10,60,20,90,80
5447,Cressac-Saint-Genis,16115,16,8,32,16,68,32,116,40
5448,Criteuil-la-Magdeleine,16116,16,72,116,48,128,88,264,188
5449,Curac,16117,16,25,20,10,40,15,65,45
5450,Deviat,16118,16,44,48,12,48,16,76,92
5451,Dignac,16119,16,180,295,113,519,210,842,475
5452,Dirac,16120,16,138,305,90,670,240,1000,443
5453,Douzat,16121,16,50,125,35,135,110,280,175
5454,Ébréon,16122,16,18,32,13,61,12,86,50
5455,Échallat,16123,16,74,116,8,190,73,271,190
5456,Écuras,16124,16,109,110,30,233,108,371,219
5457,Édon,16125,16,60,35,15,115,20,150,95
5458,Empuré,16127,16,28,7,3,38,3,44,35
5459,Épenède,16128,16,32,24,21,58,22,101,56
5460,Éraville,16129,16,35,45,0,60,50,110,80
5461,Les Essards,16130,16,60,45,0,70,20,90,105
5462,Esse,16131,16,89,90,30,200,85,315,179
5463,Étagnac,16132,16,208,160,52,292,172,516,368
5464,Étriac,16133,16,40,45,15,65,40,120,85
5465,Exideuil,16134,16,134,201,66,409,154,629,335
5466,Eymouthiers,16135,16,65,50,15,105,60,180,115
5467,La Faye,16136,16,92,136,52,228,120,400,228
5468,Feuillade,16137,16,45,63,20,86,57,163,108
5469,Fléac,16138,16,449,817,259,1403,596,2258,1266
5470,Fleurac,16139,16,12,40,8,100,44,152,52
5471,Fontclaireau,16140,16,47,124,4,126,91,221,171
5472,Fontenille,16141,16,62,49,13,124,47,184,111
5473,La Forêt-de-Tessé,16142,16,55,20,15,80,10,105,75
5474,Fouquebrune,16143,16,57,148,57,237,104,398,205
5475,Fouqueure,16144,16,59,63,9,116,77,202,122
5476,Foussignac,16145,16,44,132,52,232,128,412,176
5477,Garat,16146,16,180,495,84,756,451,1291,675
5478,Gardes-le-Pontaroux,16147,16,17,82,0,114,36,150,99
5479,Genac-Bignac,16148,16,90,226,51,350,197,598,316
5480,Genouillac,16149,16,80,155,50,205,110,365,235
5481,Gensac-la-Pallue,16150,16,180,348,92,688,288,1068,528
5482,Genté,16151,16,124,165,85,370,140,595,289
5483,Gimeux,16152,16,50,142,59,282,104,445,192
5484,Gondeville,16153,16,64,104,84,188,68,340,168
5485,Gond-Pontouvre,16154,16,870,1218,535,1920,1013,3468,2088
5486,Les Gours,16155,16,31,10,5,56,0,61,41
5487,Gourville,16156,16,87,157,43,167,113,323,244
5488,Le Grand-Madieu,16157,16,13,25,8,77,12,97,38
5489,Grassac,16158,16,55,50,10,145,55,210,105
5490,Guimps,16160,16,50,95,50,200,80,330,145
5491,Guizengeard,16161,16,8,32,13,59,16,88,40
5492,Gurat,16162,16,20,35,10,75,40,125,55
5493,Hiersac,16163,16,92,200,96,404,172,672,292
5494,Hiesse,16164,16,70,50,5,100,30,135,120
5495,Houlette,16165,16,50,80,40,125,70,235,130
5496,L'Isle-d'Espagnac,16166,16,859,1091,489,1798,828,3115,1950
5497,Jarnac,16167,16,942,767,355,1440,604,2399,1709
5498,Jauldes,16168,16,76,160,84,272,164,520,236
5499,Javrezac,16169,16,80,105,20,240,130,390,185
5500,Juignac,16170,16,79,52,22,102,50,174,131
5501,Juillac-le-Coq,16171,16,65,125,55,255,135,445,190
5502,Juillé,16173,16,32,40,24,76,16,116,72
5503,Julienne,16174,16,60,152,52,132,116,300,212
5504,Val des Vignes,16175,16,186,297,88,402,235,725,483
5505,Lachaise,16176,16,44,80,40,108,60,208,124
5506,Ladiville,16177,16,13,19,12,39,12,63,32
5507,Lagarde-sur-le-Né,16178,16,44,36,16,60,20,96,80
5508,Laprade,16180,16,35,40,30,79,45,154,75
5509,Lessac,16181,16,68,128,28,228,100,356,196
5510,Lesterps,16182,16,80,90,35,185,90,310,170
5511,Lésignac-Durand,16183,16,17,33,21,64,25,110,50
5512,Lichères,16184,16,24,12,0,40,16,56,36
5513,Ligné,16185,16,24,36,16,60,24,100,60
5514,Lignières-Sonneville,16186,16,114,110,40,150,130,320,224
5515,Linars,16187,16,308,416,133,842,358,1333,724
5516,Le Lindois,16188,16,39,60,16,126,44,186,99
5517,Londigny,16189,16,40,60,8,72,68,148,100
5518,Longré,16190,16,46,24,16,72,15,103,70
5519,Lonnes,16191,16,35,45,25,30,35,90,80
5520,Roumazières-Loubert,16192,16,490,430,235,890,315,1440,920
5521,Louzac-Saint-André,16193,16,136,244,68,376,188,632,380
5522,Lupsault,16194,16,16,10,6,40,12,58,26
5523,Lussac,16195,16,36,64,20,112,52,184,100
5524,Luxé,16196,16,168,115,30,195,107,332,283
5525,La Magdeleine,16197,16,40,28,8,40,24,72,68
5526,Magnac-Lavalette-Villars,16198,16,54,91,16,137,77,230,145
5527,Magnac-sur-Touvre,16199,16,567,602,246,1003,603,1852,1169
5528,Maine-de-Boixe,16200,16,36,103,48,140,79,267,139
5529,Mainxe,16202,16,60,175,40,230,170,440,235
5530,Mainzac,16203,16,9,6,6,39,12,57,15
5531,Malaville,16204,16,44,108,36,144,96,276,152
5532,Manot,16205,16,88,144,12,216,104,332,232
5533,Mansle,16206,16,298,366,151,383,233,767,664
5534,Marcillac-Lanville,16207,16,92,141,33,140,101,274,233
5535,Mareuil,16208,16,48,76,56,164,56,276,124
5536,Marillac-le-Franc,16209,16,130,195,40,310,145,495,325
5537,Marsac,16210,16,88,208,56,308,192,556,296
5538,Marthon,16211,16,55,105,20,230,90,340,160
5539,Massignac,16212,16,100,72,28,112,92,232,172
5540,Mazerolles,16213,16,52,59,3,111,59,173,111
5541,Mazières,16214,16,12,25,0,45,4,49,37
5542,Médillac,16215,16,40,32,0,72,16,88,72
5543,Mérignac,16216,16,94,155,42,264,161,467,249
5544,Merpins,16217,16,144,237,99,353,203,655,381
5545,Mesnac,16218,16,25,130,35,125,100,260,155
5546,Les Métairies,16220,16,99,185,40,199,165,404,284
5547,Mons,16221,16,18,50,12,70,52,134,68
5548,Montboyer,16222,16,114,55,18,99,43,160,169
5549,Montbron,16223,16,495,326,130,713,291,1134,821
5550,Montmérac,16224,16,83,134,43,301,138,482,217
5551,Montemboeuf,16225,16,81,145,45,271,105,421,226
5552,Montignac-Charente,16226,16,126,135,45,241,100,386,261
5553,Montignac-le-Coq,16227,16,4,31,17,67,8,92,35
5554,Montigné,16228,16,33,43,8,54,21,83,76
5555,Montjean,16229,16,40,40,10,110,45,165,80
5556,Montmoreau-Saint-Cybard,16230,16,186,257,29,344,130,503,443
5557,Montrollet,16231,16,73,65,10,105,60,175,138
5558,Mornac,16232,16,194,471,238,891,354,1483,665
5559,Mosnac,16233,16,36,100,40,164,112,316,136
5560,Moulidars,16234,16,75,161,60,270,160,490,236
5561,Mouthiers-sur-Boëme,16236,16,280,557,135,965,451,1551,837
5562,Mouton,16237,16,40,55,30,55,45,130,95
5563,Moutonneau,16238,16,20,19,0,37,15,52,39
5564,Mouzon,16239,16,24,24,0,78,19,97,48
5565,Nabinaud,16240,16,20,8,12,28,12,52,28
5566,Nanclars,16241,16,43,25,9,57,21,87,68
5567,Nanteuil-en-Vallée,16242,16,255,205,120,580,150,850,460
5568,Nercillac,16243,16,89,245,85,478,190,753,334
5569,Nersac,16244,16,330,575,255,755,475,1485,905
5570,Nieuil,16245,16,125,167,71,391,107,569,292
5571,Nonac,16246,16,56,68,24,116,40,180,124
5572,Nonaville,16247,16,19,29,6,69,30,105,48
5573,Oradour,16248,16,22,18,6,87,12,105,40
5574,Oradour-Fanais,16249,16,98,49,4,154,37,195,147
5575,Orgedeuil,16250,16,75,50,5,70,45,120,125
5576,Oriolles,16251,16,36,72,20,100,48,168,108
5577,Orival,16252,16,35,15,20,75,15,110,50
5578,Paizay-Naudouin-Embourie,16253,16,51,87,3,122,73,198,138
5579,Palluaud,16254,16,55,30,15,95,25,135,85
5580,Parzac,16255,16,24,8,12,84,8,104,32
5581,Passirac,16256,16,43,50,13,65,43,121,93
5582,Pérignac,16258,16,106,95,40,171,65,276,201
5583,La Péruse,16259,16,50,90,65,189,108,362,140
5584,Pillac,16260,16,76,44,12,112,24,148,120
5585,Les Pins,16261,16,48,91,45,176,41,262,139
5586,Plassac-Rouffiac,16263,16,32,100,48,124,92,264,132
5587,Pleuville,16264,16,118,45,15,140,45,200,163
5588,Poullignac,16267,16,4,8,8,42,12,62,12
5589,Poursac,16268,16,41,22,9,57,22,88,63
5590,Pranzac,16269,16,137,191,56,266,179,501,328
5591,Pressignac,16270,16,108,48,36,144,56,236,156
5592,Puymoyen,16271,16,395,395,120,1085,380,1585,790
5593,Puyréaux,16272,16,64,152,32,160,124,316,216
5594,Raix,16273,16,45,45,0,50,25,75,90
5595,Rancogne,16274,16,25,90,25,150,90,265,115
5596,Ranville-Breuillaud,16275,16,44,36,8,68,40,116,80
5597,Reignac,16276,16,86,132,75,292,57,424,218
5598,Réparsac,16277,16,76,164,60,192,148,400,240
5599,Rioux-Martin,16279,16,50,43,25,115,23,163,93
5600,Rivières,16280,16,244,409,120,630,331,1081,653
5601,La Rochefoucauld,16281,16,689,455,271,904,421,1596,1144
5602,La Rochette,16282,16,85,114,75,129,129,333,199
5603,Ronsenac,16283,16,120,125,40,235,50,325,245
5604,Rouffiac,16284,16,28,36,0,48,16,64,64
5605,Rougnac,16285,16,75,60,25,190,55,270,135
5606,Rouillac,16286,16,380,475,155,688,351,1194,855
5607,Roullet-Saint-Estèphe,16287,16,446,962,301,1539,833,2673,1408
5608,Roussines,16289,16,61,36,3,112,26,141,97
5609,Rouzède,16290,16,39,25,8,116,20,144,64
5610,Ruelle-sur-Touvre,16291,16,1290,1405,570,2663,1148,4381,2695
5611,Ruffec,16292,16,700,551,366,971,484,1821,1251
5612,Saint-Adjutory,16293,16,60,135,35,160,85,280,195
5613,Saint-Amant-de-Montmoreau,16294,16,155,115,30,250,105,385,270
5614,Saint-Amant-de-Boixe,16295,16,136,339,85,400,251,736,475
5615,Saint-Amant-de-Bonnieure,16296,16,60,85,15,138,70,223,145
5616,Graves-Saint-Amant,16297,16,29,47,35,133,36,204,76
5617,Saint-Amant-de-Nouère,16298,16,100,105,10,115,90,215,205
5618,Saint-Angeau,16300,16,152,160,44,220,132,396,312
5619,Saint-Aulais-la-Chapelle,16301,16,55,25,30,100,25,155,80
5620,Saint-Avit,16302,16,30,55,10,70,35,115,85
5621,Saint-Bonnet,16303,16,63,80,34,145,41,220,143
5622,Saint-Brice,16304,16,115,165,90,485,110,685,280
5623,Saint-Christophe,16306,16,96,72,36,88,52,176,168
5624,Saint-Ciers-sur-Bonnieure,16307,16,49,68,21,92,58,171,117
5625,Saint-Claud,16308,16,202,212,116,382,105,603,414
5626,Sainte-Colombe,16309,16,18,53,0,53,39,92,71
5627,Saint-Coutant,16310,16,68,44,16,56,48,120,112
5628,Saint-Cybardeaux,16312,16,128,180,116,256,152,524,308
5629,Saint-Eutrope,16314,16,20,35,15,80,30,125,55
5630,Saint-Félix,16315,16,25,10,10,65,0,75,35
5631,Saint-Fort-sur-le-Né,16316,16,80,90,10,125,75,210,170
5632,Saint-Fraigne,16317,16,95,85,50,147,55,252,180
5633,Saint-Front,16318,16,45,70,20,95,65,180,115
5634,Saint-Genis-d'Hiersac,16320,16,109,190,125,324,173,622,299
5635,Saint-Georges,16321,16,15,20,0,29,10,39,35
5636,Saint-Germain-de-Montbron,16323,16,100,104,36,148,112,296,204
5637,Saint-Gourson,16325,16,5,20,15,75,20,110,25
5638,Saint-Groux,16326,16,20,25,10,60,20,90,45
5639,Saint-Laurent-de-Belzagot,16328,16,32,72,48,100,32,180,104
5640,Saint-Laurent-de-Céris,16329,16,160,155,35,290,130,455,315
5641,Saint-Laurent-de-Cognac,16330,16,80,185,55,380,145,580,265
5642,Saint-Laurent-des-Combes,16331,16,15,6,10,29,9,48,21
5643,Saint-Léger,16332,16,34,10,9,47,3,59,44
5644,Saint-Martial,16334,16,10,35,20,45,35,100,45
5645,Saint-Martin-du-Clocher,16335,16,20,22,9,43,15,67,42
5646,Saint-Mary,16336,16,51,54,22,106,67,195,105
5647,Saint-Maurice-des-Lions,16337,16,165,160,65,366,130,561,325
5648,Saint-Médard,16338,16,25,76,25,119,38,182,101
5649,Auge-Saint-Médard,16339,16,75,75,5,130,34,169,150
5650,Saint-Même-les-Carrières,16340,16,255,240,75,340,160,575,495
5651,Saint-Michel,16341,16,484,595,433,937,500,1870,1079
5652,Saint-Palais-du-Né,16342,16,30,55,30,110,50,190,85
5653,Saint-Preuil,16343,16,18,56,22,104,27,153,74
5654,Saint-Projet-Saint-Constant,16344,16,199,260,75,344,205,624,459
5655,Saint-Quentin-sur-Charente,16345,16,12,46,12,78,51,141,58
5656,Saint-Quentin-de-Chalais,16346,16,74,41,26,50,37,113,115
5657,Saint-Romain,16347,16,108,120,44,200,68,312,228
5658,Saint-Saturnin,16348,16,140,245,120,565,205,890,385
5659,Sainte-Sévère,16349,16,59,85,66,197,82,345,144
5660,Saint-Séverin,16350,16,135,94,73,280,80,433,229
5661,Saint-Simeux,16351,16,90,155,25,190,130,345,245
5662,Saint-Simon,16352,16,45,50,10,60,35,105,95
5663,Saint-Sornin,16353,16,90,174,81,338,153,572,264
5664,Sainte-Souline,16354,16,6,13,15,41,12,68,19
5665,Saint-Sulpice-de-Cognac,16355,16,165,267,90,396,287,773,432
5666,Saint-Sulpice-de-Ruffec,16356,16,12,4,0,12,4,16,16
5667,Saint-Vallier,16357,16,39,9,13,43,12,68,48
5668,Saint-Yrieix-sur-Charente,16358,16,944,1612,646,2500,1314,4460,2556
5669,Salles-d'Angles,16359,16,123,236,59,328,203,590,359
5670,Salles-de-Barbezieux,16360,16,35,115,35,145,105,285,150
5671,Salles-de-Villefagnan,16361,16,62,77,15,78,76,169,139
5672,Salles-Lavalette,16362,16,45,90,10,150,55,215,135
5673,Saulgond,16363,16,54,109,30,163,79,272,163
5674,Sauvagnac,16364,16,5,25,0,40,10,50,30
5675,Sauvignac,16365,16,25,17,8,16,13,37,42
5676,Segonzac,16366,16,309,415,150,750,385,1285,724
5677,Sers,16368,16,110,200,45,255,230,530,310
5678,Sigogne,16369,16,143,203,77,397,124,598,346
5679,Sireuil,16370,16,128,240,80,460,248,788,368
5680,Souffrignac,16372,16,25,20,10,57,15,82,45
5681,Souvigné,16373,16,55,35,10,70,30,110,90
5682,Soyaux,16374,16,1631,2290,850,2980,1340,5170,3921
5683,Suaux,16375,16,48,86,12,155,86,253,134
5684,Suris,16376,16,25,65,0,115,55,170,90
5685,La Tâche,16377,16,26,30,0,38,16,54,56
5686,Taizé-Aizie,16378,16,44,102,78,223,79,380,146
5687,Taponnat-Fleurignac,16379,16,193,377,162,447,266,875,570
5688,Le Tâtre,16380,16,35,85,30,110,125,265,120
5689,Theil-Rabier,16381,16,25,35,10,75,20,105,60
5690,Torsac,16382,16,37,181,27,288,169,484,218
5691,Tourriers,16383,16,60,197,93,182,175,450,257
5692,Touvérac,16384,16,152,148,20,184,132,336,300
5693,Touvre,16385,16,140,322,76,412,246,734,462
5694,Touzac,16386,16,30,130,30,110,115,255,160
5695,Triac-Lautrait,16387,16,49,98,4,174,59,237,147
5696,Trois-Palis,16388,16,80,210,76,284,149,509,290
5697,Turgon,16389,16,15,15,0,40,15,55,30
5698,Tusson,16390,16,38,8,18,108,12,138,46
5699,Tuzie,16391,16,12,59,0,70,21,91,71
5700,Valence,16392,16,72,20,16,88,16,120,92
5701,Vars,16393,16,248,497,194,618,385,1197,745
5702,Vaux-Lavalette,16394,16,5,10,15,55,15,85,15
5703,Vaux-Rouillac,16395,16,41,51,9,81,59,149,92
5704,Ventouse,16396,16,16,36,8,44,24,76,52
5705,Verdille,16397,16,51,40,35,119,38,192,91
5706,Verneuil,16398,16,4,20,8,44,12,64,24
5707,Verrières,16399,16,64,84,16,124,60,200,148
5708,Verteuil-sur-Charente,16400,16,160,129,4,206,86,296,289
5709,Vervant,16401,16,12,40,20,36,32,88,52
5710,Vibrac,16402,16,27,49,6,102,75,183,76
5711,Le Vieux-Cérier,16403,16,55,5,0,60,15,75,60
5712,Vieux-Ruffec,16404,16,10,25,10,45,15,70,35
5713,Vignolles,16405,16,15,50,10,70,20,100,65
5714,Vilhonneur,16406,16,32,76,44,136,88,268,108
5715,Villebois-Lavalette,16408,16,100,165,40,260,120,420,265
5716,Villefagnan,16409,16,168,164,104,336,132,572,332
5717,Villegats,16410,16,40,35,45,80,15,140,75
5718,Villejésus,16411,16,66,92,47,200,52,299,158
5719,Villejoubert,16412,16,26,86,21,106,55,182,112
5720,Villiers-le-Roux,16413,16,20,28,0,52,28,80,48
5721,Villognon,16414,16,81,40,30,135,30,195,121
5722,Vindelle,16415,16,65,221,90,396,195,681,286
5723,Vitrac-Saint-Vincent,16416,16,75,100,35,200,105,340,175
5724,Viville,16417,16,6,10,6,38,18,62,16
5725,Voeuil-et-Giget,16418,16,219,310,99,605,275,979,529
5726,Vouharte,16419,16,70,48,19,94,41,154,118
5727,Voulgézac,16420,16,41,58,17,72,38,127,99
5728,Vouthon,16421,16,56,100,20,152,96,268,156
5729,Vouzan,16422,16,48,185,56,296,160,512,233
5730,Xambes,16423,16,40,85,30,122,45,197,125
5731,Yviers,16424,16,85,110,10,185,85,280,195
5732,Yvrac-et-Malleyrand,16425,16,88,108,40,172,112,324,196
5733,Agudelle,17002,17,28,36,24,48,12,84,64
5734,Aigrefeuille-d'Aunis,17003,17,499,914,268,1331,712,2311,1413
5735,Île-d'Aix,17004,17,60,28,16,100,20,136,88
5736,Allas-Bocage,17005,17,15,35,20,72,45,137,50
5737,Allas-Champagne,17006,17,32,72,20,88,76,184,104
5738,Anais,17007,17,40,95,5,90,95,190,135
5739,Andilly,17008,17,169,569,173,780,470,1423,738
5740,Angliers,17009,17,37,298,83,212,290,585,335
5741,Angoulins,17010,17,563,717,345,1510,585,2440,1280
5742,Annepont,17011,17,40,85,25,130,70,225,125
5743,Annezay,17012,17,20,40,16,60,16,92,60
5744,Antezant-la-Chapelle,17013,17,65,70,40,150,30,220,135
5745,Arces,17015,17,103,164,44,253,112,409,267
5746,Archiac,17016,17,109,139,79,271,109,459,248
5747,Archingeay,17017,17,80,155,40,280,120,440,235
5748,Ardillières,17018,17,70,265,70,230,200,500,335
5749,Ars-en-Ré,17019,17,288,208,76,464,196,736,496
5750,Arthenac,17020,17,22,63,33,130,57,220,85
5751,Arvert,17021,17,613,556,272,1285,446,2003,1169
5752,Asnières-la-Giraud,17022,17,91,222,88,361,174,623,313
5753,Aujac,17023,17,24,72,56,120,60,236,96
5754,Aulnay,17024,17,268,250,70,523,168,761,518
5755,Aumagne,17025,17,90,175,30,350,85,465,265
5756,Authon-Ébéon,17026,17,100,80,24,116,60,200,180
5757,Avy,17027,17,84,76,32,196,72,300,160
5758,Aytré,17028,17,1320,1553,1202,2833,1646,5681,2873
5759,Bagnizeau,17029,17,57,52,22,51,16,89,109
5760,Balanzac,17030,17,60,133,68,136,132,336,193
5761,Ballans,17031,17,25,57,5,80,40,125,82
5762,Ballon,17032,17,68,220,40,204,194,438,288
5763,La Barde,17033,17,59,120,45,159,90,294,179
5764,Barzan,17034,17,56,92,52,192,48,292,148
5765,Bazauges,17035,17,20,25,5,81,15,101,45
5766,Beaugeay,17036,17,16,208,49,190,231,470,224
5767,Beauvais-sur-Matha,17037,17,84,163,45,204,128,377,247
5768,Bedenac,17038,17,69,145,45,155,120,320,214
5769,Belluire,17039,17,15,55,10,65,65,140,70
5770,Benon,17041,17,55,493,211,233,463,907,548
5771,Bercloux,17042,17,40,120,50,85,135,270,160
5772,Bernay-Saint-Martin,17043,17,124,176,64,236,136,436,300
5773,Berneuil,17044,17,115,290,130,368,225,723,405
5774,Beurlay,17045,17,84,241,84,386,212,682,325
5775,Bignay,17046,17,55,110,20,135,90,245,165
5776,Biron,17047,17,25,30,9,73,40,122,55
5777,Blanzac-lès-Matha,17048,17,44,76,24,152,44,220,120
5778,Blanzay-sur-Boutonne,17049,17,24,16,8,28,8,44,40
5779,Bois,17050,17,63,125,50,182,85,317,188
5780,Le Bois-Plage-en-Ré,17051,17,475,379,111,997,342,1450,854
5781,Boisredon,17052,17,110,125,45,305,120,470,235
5782,Bords,17053,17,245,310,95,423,230,748,555
5783,Boresse-et-Martron,17054,17,64,40,25,69,20,114,104
5784,Boscamnant,17055,17,20,45,15,100,55,170,65
5785,Bougneau,17056,17,40,156,84,204,144,432,196
5786,Bouhet,17057,17,36,269,72,160,266,498,305
5787,Bourcefranc-le-Chapus,17058,17,676,628,197,1279,514,1990,1304
5788,Bourgneuf,17059,17,76,251,132,424,198,754,327
5789,Boutenac-Touvent,17060,17,62,46,26,40,12,78,108
5790,Bran,17061,17,35,5,15,60,5,80,40
5791,Bresdon,17062,17,93,16,20,70,30,120,109
5792,Breuil-la-Réorte,17063,17,60,145,45,115,105,265,205
5793,Breuillet,17064,17,504,479,190,1099,380,1669,983
5794,Breuil-Magné,17065,17,180,430,60,645,290,995,610
5795,Brie-sous-Archiac,17066,17,75,30,15,95,20,130,105
5796,Brie-sous-Matha,17067,17,25,25,20,65,40,125,50
5797,Brie-sous-Mortagne,17068,17,33,19,6,116,9,131,52
5798,Brives-sur-Charente,17069,17,32,68,8,88,44,140,100
5799,Brizambourg,17070,17,134,187,59,270,135,464,321
5800,La Brousse,17071,17,130,145,50,125,75,250,275
5801,Burie,17072,17,244,252,108,420,208,736,496
5802,Bussac-sur-Charente,17073,17,210,295,60,485,232,777,505
5803,Bussac-Forêt,17074,17,68,252,76,356,248,680,320
5804,Cabariot,17075,17,140,270,85,530,230,845,410
5805,Celles,17076,17,28,76,12,116,84,212,104
5806,Cercoux,17077,17,235,215,120,415,220,755,450
5807,Chadenac,17078,17,80,125,40,155,80,275,205
5808,Chaillevette,17079,17,255,350,100,556,275,931,605
5809,Chambon,17080,17,136,216,84,256,188,528,352
5810,Chamouillac,17081,17,74,85,10,125,65,200,159
5811,Champagnac,17082,17,95,125,40,150,100,290,220
5812,Champagne,17083,17,41,163,29,203,127,359,204
5813,Champagnolles,17084,17,112,132,28,240,84,352,244
5814,Champdolent,17085,17,22,109,20,115,81,216,131
5815,Chaniers,17086,17,632,821,156,1198,640,1994,1453
5816,Chantemerle-sur-la-Soie,17087,17,10,35,35,50,45,130,45
5817,La Chapelle-des-Pots,17089,17,85,178,44,354,119,517,263
5818,Charron,17091,17,168,502,89,603,446,1138,670
5819,Chartuzac,17092,17,15,35,5,105,5,115,50
5820,Le Château-d'Oléron,17093,17,878,617,332,1539,520,2391,1495
5821,Châtelaillon-Plage,17094,17,1244,1010,461,2321,834,3616,2254
5822,Chatenet,17095,17,30,41,6,87,38,131,71
5823,Chaunac,17096,17,4,20,12,36,24,72,24
5824,Le Chay,17097,17,93,172,12,325,100,437,265
5825,Chenac-Saint-Seurin-d'Uzet,17098,17,132,104,32,208,104,344,236
5826,Chepniers,17099,17,145,110,30,246,110,386,255
5827,Chérac,17100,17,154,249,37,341,226,604,403
5828,Cherbonnières,17101,17,73,72,40,128,44,212,145
5829,Chermignac,17102,17,160,280,130,470,220,820,440
5830,Chervettes,17103,17,10,35,20,45,40,105,45
5831,Chevanceaux,17104,17,200,172,72,380,168,620,372
5832,Chives,17105,17,55,44,35,179,34,248,99
5833,Cierzac,17106,17,36,56,20,96,53,169,92
5834,Ciré-d'Aunis,17107,17,155,383,95,285,340,720,538
5835,Clam,17108,17,50,95,0,175,80,255,145
5836,Clavette,17109,17,60,340,152,352,308,812,400
5837,Clérac,17110,17,216,204,80,328,152,560,420
5838,Clion,17111,17,155,210,40,275,130,445,365
5839,La Clisse,17112,17,60,164,81,133,154,368,224
5840,La Clotte,17113,17,95,190,25,230,155,410,285
5841,Coivert,17114,17,30,45,5,105,15,125,75
5842,Colombiers,17115,17,30,100,60,75,60,195,130
5843,Consac,17116,17,20,30,5,110,55,170,50
5844,Contré,17117,17,8,12,17,51,16,84,20
5845,Corignac,17118,17,10,75,35,160,55,250,85
5846,Corme-Écluse,17119,17,112,249,88,325,249,662,361
5847,Corme-Royal,17120,17,213,402,93,522,385,1000,615
5848,La Couarde-sur-Mer,17121,17,320,160,85,500,125,710,480
5849,Coulonges,17122,17,40,56,3,72,35,110,96
5850,Courant,17124,17,32,120,20,152,80,252,152
5851,Courcelles,17125,17,56,104,20,240,56,316,160
5852,Courcerac,17126,17,44,72,4,128,72,204,116
5853,Courçon,17127,17,160,424,198,439,373,1010,584
5854,Courcoury,17128,17,64,150,55,315,120,490,214
5855,Courpignac,17129,17,60,90,35,130,85,250,150
5856,Coux,17130,17,60,110,15,185,95,295,170
5857,Cozes,17131,17,428,372,140,780,308,1228,800
5858,Cramchaban,17132,17,76,157,75,178,99,352,233
5859,Cravans,17133,17,96,196,37,277,120,434,292
5860,Crazannes,17134,17,56,94,30,135,91,256,150
5861,Cressé,17135,17,78,13,12,74,20,106,91
5862,Croix-Chapeau,17136,17,124,281,104,435,245,784,405
5863,La Croix-Comtesse,17137,17,50,56,5,65,60,130,106
5864,Dampierre-sur-Boutonne,17138,17,56,29,4,115,36,155,85
5865,Doeuil-sur-le-Mignon,17139,17,25,95,10,160,60,230,120
5866,Dolus-d'Oléron,17140,17,618,563,198,1305,550,2053,1181
5867,Dompierre-sur-Charente,17141,17,55,100,25,175,110,310,155
5868,Dompierre-sur-Mer,17142,17,726,1275,403,1817,1030,3250,2001
5869,Le Douhet,17143,17,100,168,40,216,164,420,268
5870,Échebrune,17145,17,88,89,19,145,83,247,177
5871,Échillais,17146,17,434,864,211,1147,662,2020,1298
5872,Écoyeux,17147,17,156,360,136,356,280,772,516
5873,Écurat,17148,17,35,130,25,210,55,290,165
5874,Les Éduts,17149,17,9,10,3,21,6,30,19
5875,Les Églises-d'Argenteuil,17150,17,60,124,44,220,88,352,184
5876,L'Éguille,17151,17,110,180,50,405,160,615,290
5877,Épargnes,17152,17,120,183,80,252,154,486,303
5878,Esnandes,17153,17,175,515,155,835,355,1345,690
5879,Les Essards,17154,17,52,208,68,205,158,431,260
5880,Étaules,17155,17,382,500,110,766,514,1390,882
5881,Expiremont,17156,17,20,44,12,28,44,84,64
5882,Fenioux,17157,17,35,30,25,50,20,95,65
5883,Ferrières,17158,17,40,240,96,196,228,520,280
5884,Fléac-sur-Seugne,17159,17,26,91,45,89,70,204,117
5885,Floirac,17160,17,75,50,10,105,55,170,125
5886,La Flotte,17161,17,619,521,175,1124,391,1690,1140
5887,Fontaine-Chalendray,17162,17,38,15,6,102,26,134,53
5888,Fontaines-d'Ozillac,17163,17,35,160,85,190,75,350,195
5889,Fontcouverte,17164,17,312,520,140,932,400,1472,832
5890,Fontenet,17165,17,72,88,32,148,68,248,160
5891,Forges,17166,17,84,364,124,424,260,808,448
5892,Le Fouilloux,17167,17,99,157,42,264,119,425,256
5893,Fouras,17168,17,1215,565,175,1530,495,2200,1780
5894,La Frédière,17169,17,0,36,5,10,30,45,36
5895,Geay,17171,17,52,195,61,253,149,463,247
5896,Gémozac,17172,17,475,556,187,1142,324,1653,1031
5897,La Genétouze,17173,17,41,36,9,94,21,124,77
5898,Genouillé,17174,17,68,216,104,212,208,524,284
5899,Germignac,17175,17,52,184,64,192,148,404,236
5900,Gibourne,17176,17,25,20,0,65,5,70,45
5901,Le Gicq,17177,17,20,36,4,48,32,84,56
5902,Givrezac,17178,17,15,15,5,30,10,45,30
5903,Les Gonds,17179,17,253,341,108,651,280,1039,594
5904,Gourvillette,17180,17,34,6,6,24,9,39,40
5905,Grandjean,17181,17,52,72,28,100,24,152,124
5906,La Grève-sur-Mignon,17182,17,72,137,44,128,142,314,209
5907,Grézac,17183,17,128,214,64,321,131,516,342
5908,La Gripperie-Saint-Symphorien,17184,17,33,159,30,204,125,359,192
5909,Le Gua,17185,17,303,385,165,705,289,1159,688
5910,Le Gué-d'Alleré,17186,17,58,250,115,204,195,514,308
5911,Guitinières,17187,17,37,97,52,155,85,292,134
5912,Haimps,17188,17,80,120,30,190,50,270,200
5913,Hiers-Brouage,17189,17,83,150,60,230,125,415,233
5914,L'Houmeau,17190,17,405,543,239,1017,476,1732,948
5915,La Jard,17191,17,32,110,30,74,110,214,142
5916,Jarnac-Champagne,17192,17,75,187,49,282,119,450,262
5917,La Jarne,17193,17,175,575,195,940,495,1630,750
5918,La Jarrie,17194,17,360,778,240,1052,610,1902,1138
5919,La Jarrie-Audouin,17195,17,65,50,5,120,35,160,115
5920,Jazennes,17196,17,37,120,25,163,131,319,157
5921,Jonzac,17197,17,623,590,325,1210,509,2044,1213
5922,Juicq,17198,17,39,66,21,75,45,141,105
5923,Jussas,17199,17,30,30,17,24,20,61,60
5924,Lagord,17200,17,1425,1321,502,2592,1062,4156,2746
5925,La Laigne,17201,17,49,136,24,93,144,261,185
5926,Landes,17202,17,123,153,44,140,103,287,276
5927,Landrais,17203,17,60,198,95,237,151,483,258
5928,Léoville,17204,17,65,80,20,95,50,165,145
5929,Loire-les-Marais,17205,17,8,85,26,168,70,264,93
5930,Loiré-sur-Nie,17206,17,45,35,30,140,25,195,80
5931,Loix,17207,17,164,104,52,236,104,392,268
5932,Longèves,17208,17,71,268,40,297,200,537,339
5933,Lonzac,17209,17,56,68,4,72,52,128,124
5934,Lorignac,17210,17,90,95,35,209,75,319,185
5935,Loulay,17211,17,157,130,50,226,105,381,287
5936,Louzignac,17212,17,33,22,12,37,34,83,55
5937,Lozay,17213,17,25,21,12,46,3,61,46
5938,Luchat,17214,17,20,156,24,181,81,286,176
5939,Lussac,17215,17,12,16,4,20,12,36,28
5940,Lussant,17216,17,101,248,97,273,181,551,349
5941,Macqueville,17217,17,15,70,10,105,75,190,85
5942,Marans,17218,17,858,954,300,1554,720,2574,1812
5943,Marennes,17219,17,955,1165,413,2032,863,3308,2120
5944,Marignac,17220,17,48,92,40,156,60,256,140
5945,Marsais,17221,17,126,235,43,240,181,464,361
5946,Marsilly,17222,17,375,689,230,1086,543,1859,1064
5947,Massac,17223,17,23,23,3,61,23,87,46
5948,Matha,17224,17,474,361,150,805,220,1175,835
5949,Les Mathes,17225,17,376,315,113,706,303,1122,691
5950,Mazeray,17226,17,94,207,64,306,190,560,301
5951,Mazerolles,17227,17,12,45,6,104,34,144,57
5952,Médis,17228,17,542,591,174,1016,494,1684,1133
5953,Mérignac,17229,17,5,51,35,92,46,173,56
5954,Meschers-sur-Gironde,17230,17,796,486,91,1236,386,1713,1282
5955,Messac,17231,17,25,17,0,18,22,40,42
5956,Meursac,17232,17,250,290,149,482,239,870,540
5957,Meux,17233,17,71,26,25,103,26,154,97
5958,Migré,17234,17,76,55,6,113,33,152,131
5959,Migron,17235,17,95,205,40,270,140,450,300
5960,Mirambeau,17236,17,209,301,118,555,243,916,510
5961,Moëze,17237,17,40,115,50,175,160,385,155
5962,Mons,17239,17,26,91,12,145,97,254,117
5963,Montendre,17240,17,555,625,310,1170,415,1895,1180
5964,Montguyon,17241,17,288,372,124,492,248,864,660
5965,Montils,17242,17,100,184,124,244,160,528,284
5966,Montlieu-la-Garde,17243,17,204,248,84,380,196,660,452
5967,Montpellier-de-Médillan,17244,17,90,123,43,255,103,401,213
5968,Montroy,17245,17,20,209,80,333,133,546,229
5969,Moragne,17246,17,40,148,24,152,116,292,188
5970,Mornac-sur-Seudre,17247,17,169,155,20,341,148,509,324
5971,Mortagne-sur-Gironde,17248,17,256,145,70,348,85,503,401
5972,Mortiers,17249,17,48,24,20,84,24,128,72
5973,Mosnac,17250,17,69,79,26,140,80,246,148
5974,Le Mung,17252,17,24,76,20,92,76,188,100
5975,Muron,17253,17,135,310,108,393,259,760,445
5976,Nachamps,17254,17,17,38,16,72,25,113,55
5977,Nancras,17255,17,64,201,96,223,175,494,265
5978,Nantillé,17256,17,48,80,24,116,52,192,128
5979,Néré,17257,17,145,100,40,310,75,425,245
5980,Neuillac,17258,17,70,70,20,110,40,170,140
5981,Neulles,17259,17,15,30,10,55,35,100,45
5982,Neuvicq,17260,17,43,80,26,105,93,224,123
5983,Neuvicq-le-Château,17261,17,52,72,28,148,64,240,124
5984,Nieul-lès-Saintes,17262,17,100,289,76,454,215,745,389
5985,Nieul-le-Virouil,17263,17,115,125,55,165,110,330,240
5986,Nieul-sur-Mer,17264,17,773,1166,423,2373,882,3678,1939
5987,Nieulle-sur-Seudre,17265,17,110,355,105,390,273,768,465
5988,Les Nouillers,17266,17,104,172,68,144,172,384,276
5989,Nuaillé-d'Aunis,17267,17,35,354,105,364,310,779,389
5990,Nuaillé-sur-Boutonne,17268,17,48,40,12,64,44,120,88
5991,Orignolles,17269,17,105,150,65,210,125,400,255
5992,Ozillac,17270,17,90,150,35,255,110,400,240
5993,Paillé,17271,17,60,65,20,135,25,180,125
5994,Péré,17272,17,35,105,10,140,80,230,140
5995,Pérignac,17273,17,136,253,55,341,173,569,389
5996,Périgny,17274,17,791,1803,727,2780,1546,5053,2594
5997,Pessines,17275,17,100,150,35,330,150,515,250
5998,Le Pin,17276,17,10,5,5,45,5,55,15
5999,Essouvert,17277,17,159,272,69,391,224,684,431
6000,Pisany,17278,17,76,175,64,198,162,424,251
6001,Plassac,17279,17,45,140,45,246,130,421,185
6002,Plassay,17280,17,110,148,38,236,122,396,258
6003,Polignac,17281,17,29,35,10,60,30,100,64
6004,Pommiers-Moulons,17282,17,36,48,20,64,36,120,84
6005,Pons,17283,17,855,694,429,1359,566,2354,1549
6006,Pont-l'Abbé-d'Arnoult,17284,17,357,403,95,635,302,1032,760
6007,Port-d'Envaux,17285,17,208,238,70,410,208,688,446
6008,Les Portes-en-Ré,17286,17,168,84,52,232,88,372,252
6009,Pouillac,17287,17,25,55,20,100,70,190,80
6010,Poursay-Garnaud,17288,17,36,80,12,100,88,200,116
6011,Préguillac,17289,17,56,128,32,160,80,272,184
6012,Prignac,17290,17,25,65,50,131,50,231,90
6013,Puilboreau,17291,17,800,1189,533,2038,926,3497,1989
6014,Puy-du-Lac,17292,17,35,149,45,135,119,299,184
6015,Puyravault,17293,17,85,165,75,150,175,400,250
6016,Puyrolland,17294,17,33,31,8,60,39,107,64
6017,Réaux sur Trèfle,17295,17,172,174,42,242,137,421,346
6018,Rétaud,17296,17,130,235,80,430,185,695,365
6019,Rivedoux-Plage,17297,17,412,436,184,888,368,1440,848
6020,Rioux,17298,17,72,212,82,327,160,569,284
6021,Rochefort,17299,17,3891,5142,2482,7873,4011,14366,9033
6022,La Rochelle,17300,17,11990,15065,11957,22555,11637,46149,27055
6023,Romazières,17301,17,9,6,0,39,3,42,15
6024,Romegoux,17302,17,96,158,56,237,88,381,254
6025,La Ronde,17303,17,135,270,45,370,240,655,405
6026,Rouffiac,17304,17,90,115,30,160,65,255,205
6027,Rouffignac,17305,17,96,80,12,148,88,248,176
6028,Royan,17306,17,5556,2433,1286,6526,2113,9925,7989
6029,Sablonceaux,17307,17,175,335,65,438,300,803,510
6030,Saint-Agnant,17308,17,280,735,120,860,580,1560,1015
6031,Saint-Aigulin,17309,17,500,335,100,740,245,1085,835
6032,Saint-André-de-Lidon,17310,17,136,290,92,316,232,640,426
6033,Saint-Augustin,17311,17,134,252,62,522,215,799,386
6034,Saint-Bonnet-sur-Gironde,17312,17,111,123,56,308,82,446,234
6035,Saint-Bris-des-Bois,17313,17,45,75,40,170,50,260,120
6036,Saint-Césaire,17314,17,105,205,30,370,195,595,310
6037,Saint-Christophe,17315,17,124,363,163,366,311,840,487
6038,Saint-Ciers-Champagne,17316,17,50,90,35,180,65,280,140
6039,Saint-Ciers-du-Taillon,17317,17,105,70,55,210,90,355,175
6040,Saint-Clément-des-Baleines,17318,17,228,100,30,213,85,328,328
6041,Sainte-Colombe,17319,17,24,32,0,40,16,56,56
6042,Saint-Coutant-le-Grand,17320,17,30,110,0,145,120,265,140
6043,Saint-Crépin,17321,17,39,100,18,70,85,173,139
6044,Saint-Cyr-du-Doret,17322,17,56,128,36,176,116,328,184
6045,Saint-Denis-d'Oléron,17323,17,377,215,65,515,178,758,592
6046,Saint-Dizant-du-Bois,17324,17,15,25,10,65,5,80,40
6047,Saint-Dizant-du-Gua,17325,17,50,90,65,235,85,385,140
6048,Saint-Eugène,17326,17,33,59,16,83,43,142,92
6049,Saint-Félix,17327,17,56,84,36,60,72,168,140
6050,Saint-Fort-sur-Gironde,17328,17,204,145,65,394,80,539,349
6051,Saint-Froult,17329,17,50,75,20,130,70,220,125
6052,Sainte-Gemme,17330,17,138,263,108,486,189,783,401
6053,Saint-Genis-de-Saintonge,17331,17,152,213,88,457,117,662,365
6054,Saint-Georges-Antignac,17332,17,96,70,26,84,42,152,166
6055,Saint-Georges-de-Didonne,17333,17,1619,615,240,1875,496,2611,2234
6056,Saint-Georges-de-Longuepierre,17334,17,15,51,35,65,65,165,66
6057,Saint-Georges-des-Agoûts,17335,17,34,51,12,104,42,158,85
6058,Saint-Georges-des-Coteaux,17336,17,364,546,105,1100,464,1669,910
6059,Saint-Georges-d'Oléron,17337,17,750,549,201,1462,490,2153,1299
6060,Saint-Georges-du-Bois,17338,17,245,425,110,599,355,1064,670
6061,Saint-Germain-de-Lusignan,17339,17,205,265,60,474,215,749,470
6062,Saint-Germain-de-Marencennes,17340,17,114,270,84,401,255,740,384
6063,Saint-Germain-de-Vibrac,17341,17,30,50,0,90,20,110,80
6064,Saint-Germain-du-Seudre,17342,17,95,95,25,140,60,225,190
6065,Saint-Grégoire-d'Ardennes,17343,17,15,55,10,45,35,90,70
6066,Saint-Hilaire-de-Villefranche,17344,17,124,264,76,512,220,808,388
6067,Saint-Hilaire-du-Bois,17345,17,17,71,12,128,51,191,88
6068,Saint-Hippolyte,17346,17,110,379,148,423,246,817,489
6069,Saint-Jean-d'Angély,17347,17,1529,1320,694,2279,900,3873,2849
6070,Saint-Jean-d'Angle,17348,17,68,138,84,198,77,359,206
6071,Saint-Jean-de-Liversay,17349,17,297,714,173,741,685,1599,1011
6072,Saint-Julien-de-l'Escap,17350,17,246,146,61,325,55,441,392
6073,Saint-Just-Luzac,17351,17,176,440,196,686,380,1262,616
6074,Saint-Laurent-de-la-Barrière,17352,17,24,28,12,24,20,56,52
6075,Saint-Laurent-de-la-Prée,17353,17,181,476,140,782,386,1308,657
6076,Saint-Léger,17354,17,75,150,25,195,160,380,225
6077,Sainte-Lheurine,17355,17,80,125,35,175,105,315,205
6078,Saint-Loup,17356,17,60,72,24,116,52,192,132
6079,Saint-Maigrin,17357,17,96,96,36,248,72,356,192
6080,Saint-Mandé-sur-Brédoire,17358,17,65,60,5,115,50,170,125
6081,Saint-Mard,17359,17,120,300,151,362,242,755,420
6082,Sainte-Marie-de-Ré,17360,17,490,727,223,1262,584,2069,1217
6083,Saint-Martial,17361,17,50,5,0,50,10,60,55
6084,Saint-Martial-de-Mirambeau,17362,17,50,55,10,95,40,145,105
6085,Saint-Martial-de-Vitaterne,17363,17,48,100,8,196,64,268,148
6086,Saint-Martial-sur-Né,17364,17,75,126,8,119,79,206,201
6087,Saint-Martin-d'Ary,17365,17,88,76,16,200,76,292,164
6088,Saint-Martin-de-Coux,17366,17,76,68,36,180,68,284,144
6089,Saint-Martin-de-Juillers,17367,17,25,25,5,60,30,95,50
6090,Saint-Martin-de-Ré,17369,17,346,326,152,609,299,1060,672
6091,Saint-Médard,17372,17,16,21,12,12,0,24,37
6092,Saint-Médard-d'Aunis,17373,17,151,585,240,563,490,1293,736
6093,Sainte-Même,17374,17,35,65,10,80,65,155,100
6094,Saint-Nazaire-sur-Charente,17375,17,165,255,100,450,215,765,420
6095,Saint-Ouen-d'Aunis,17376,17,80,488,161,315,405,881,568
6096,Saint-Ouen-la-Thène,17377,17,35,20,0,35,20,55,55
6097,Saint-Palais-de-Négrignac,17378,17,89,94,24,120,81,225,183
6098,Saint-Palais-de-Phiolin,17379,17,75,45,5,65,30,100,120
6099,Saint-Palais-sur-Mer,17380,17,992,473,152,1723,399,2274,1465
6100,Saint-Pardoult,17381,17,31,43,29,55,25,109,74
6101,Saint-Pierre-d'Amilly,17382,17,44,104,60,176,92,328,148
6102,Saint-Pierre-de-Juillers,17383,17,45,55,35,165,45,245,100
6103,Saint-Pierre-de-l'Isle,17384,17,35,40,25,65,20,110,75
6104,Saint-Pierre-d'Oléron,17385,17,1371,1116,455,2509,993,3957,2487
6105,Saint-Pierre-du-Palais,17386,17,40,90,50,135,65,250,130
6106,Saint-Porchaire,17387,17,320,437,96,545,320,961,757
6107,Saint-Quantin-de-Rançanne,17388,17,39,49,16,100,34,150,88
6108,Sainte-Radegonde,17389,17,62,115,57,206,75,338,177
6109,Sainte-Ramée,17390,17,45,5,5,55,5,65,50
6110,Saint-Rogatien,17391,17,159,541,124,837,352,1313,700
6111,Saint-Romain-sur-Gironde,17392,17,16,0,8,32,12,52,16
6112,Saint-Romain-de-Benet,17393,17,232,328,124,628,296,1048,560
6113,Saint-Saturnin-du-Bois,17394,17,67,195,45,244,164,453,262
6114,Saint-Sauvant,17395,17,70,90,20,185,95,300,160
6115,Saint-Sauveur-d'Aunis,17396,17,144,499,84,440,438,962,643
6116,Saint-Savinien,17397,17,510,405,155,845,410,1410,915
6117,Saint-Seurin-de-Palenne,17398,17,36,35,6,39,27,72,71
6118,Saint-Sever-de-Saintonge,17400,17,80,165,35,250,105,390,245
6119,Saint-Séverin-sur-Boutonne,17401,17,35,15,0,40,0,40,50
6120,Saint-Sigismond-de-Clermont,17402,17,30,35,30,60,15,105,65
6121,Saint-Simon-de-Bordes,17403,17,92,166,31,220,137,388,258
6122,Saint-Simon-de-Pellouaille,17404,17,43,177,70,198,129,397,220
6123,Saint-Sorlin-de-Conac,17405,17,9,41,3,82,34,119,50
6124,Saint-Sornin,17406,17,64,60,28,136,60,224,124
6125,Sainte-Soulle,17407,17,356,1106,383,1291,886,2560,1462
6126,Saint-Sulpice-d'Arnoult,17408,17,87,233,62,209,162,433,320
6127,Saint-Sulpice-de-Royan,17409,17,383,593,164,1364,441,1969,976
6128,Saint-Thomas-de-Conac,17410,17,125,80,25,250,60,335,205
6129,Saint-Trojan-les-Bains,17411,17,273,140,105,474,160,739,413
6130,Saint-Vaize,17412,17,34,170,64,176,115,355,204
6131,Saint-Vivien,17413,17,70,301,90,389,294,773,371
6132,Saint-Xandre,17414,17,517,959,346,1789,730,2865,1476
6133,Saintes,17415,17,4638,4443,2305,8787,3722,14814,9081
6134,Saleignes,17416,17,25,5,5,40,0,45,30
6135,Salignac-de-Mirambeau,17417,17,32,36,12,60,28,100,68
6136,Salignac-sur-Charente,17418,17,45,175,30,250,105,385,220
6137,Salles-sur-Mer,17420,17,250,442,135,853,342,1330,692
6138,Saujon,17421,17,1828,1183,493,2506,895,3894,3011
6139,Seigné,17422,17,27,10,5,36,5,46,37
6140,Semillac,17423,17,18,7,0,18,6,24,25
6141,Semoussac,17424,17,44,76,32,92,64,188,120
6142,Semussac,17425,17,304,592,151,727,506,1384,896
6143,Le Seure,17426,17,23,44,8,72,58,138,67
6144,Siecq,17427,17,36,50,12,56,41,109,86
6145,Sonnac,17428,17,80,120,36,220,76,332,200
6146,Soubise,17429,17,197,501,94,577,443,1114,698
6147,Soubran,17430,17,65,75,20,150,70,240,140
6148,Soulignonne,17431,17,64,212,76,200,180,456,276
6149,Souméras,17432,17,40,80,28,112,92,232,120
6150,Sousmoulins,17433,17,44,52,4,76,40,120,96
6151,Surgères,17434,17,1334,1283,637,2096,1037,3770,2617
6152,Taillant,17435,17,4,48,32,56,48,136,52
6153,Taillebourg,17436,17,100,135,70,285,135,490,235
6154,Talmont-sur-Gironde,17437,17,24,12,0,56,12,68,36
6155,Tanzac,17438,17,50,60,15,95,75,185,110
6156,Taugon,17439,17,93,199,69,244,194,507,292
6157,Ternant,17440,17,32,84,44,144,68,256,116
6158,Tesson,17441,17,180,208,88,336,180,604,388
6159,Thaims,17442,17,64,96,24,124,72,220,160
6160,Thairé,17443,17,99,439,185,534,364,1083,538
6161,Thénac,17444,17,128,360,175,503,320,998,488
6162,Thézac,17445,17,30,45,24,116,51,191,75
6163,Thors,17446,17,80,95,40,140,90,270,175
6164,Le Thou,17447,17,100,574,129,565,405,1099,674
6165,Tonnay-Boutonne,17448,17,200,245,90,345,200,635,445
6166,Tonnay-Charente,17449,17,1167,1690,837,2744,1254,4835,2857
6167,Torxé,17450,17,35,40,25,95,20,140,75
6168,Les Touches-de-Périgny,17451,17,60,105,60,213,80,353,165
6169,La Tremblade,17452,17,1144,751,336,1851,589,2776,1895
6170,Trizay,17453,17,136,399,48,456,349,853,535
6171,Tugéras-Saint-Maurice,17454,17,24,66,25,133,63,221,90
6172,La Vallée,17455,17,76,152,48,252,152,452,228
6173,Vandré,17457,17,93,241,62,228,152,442,334
6174,Vanzac,17458,17,10,35,25,70,25,120,45
6175,Varaize,17459,17,78,87,29,227,59,315,165
6176,Varzay,17460,17,125,170,90,265,135,490,295
6177,Vaux-sur-Mer,17461,17,1216,500,125,1549,330,2004,1716
6178,Vénérand,17462,17,47,212,38,275,121,434,259
6179,Vergeroux,17463,17,127,286,76,455,171,702,413
6180,Vergné,17464,17,55,35,10,45,15,70,90
6181,La Vergne,17465,17,83,107,30,210,79,319,190
6182,Vérines,17466,17,165,670,209,535,617,1361,835
6183,Vervant,17467,17,43,50,22,34,38,94,93
6184,Vibrac,17468,17,45,20,25,25,30,80,65
6185,Villars-en-Pons,17469,17,43,131,30,158,140,328,174
6186,Villars-les-Bois,17470,17,28,56,16,116,48,180,84
6187,La Villedieu,17471,17,43,17,8,79,12,99,60
6188,Villedoux,17472,17,88,684,239,477,691,1407,772
6189,Villemorin,17473,17,10,15,10,35,20,65,25
6190,Villeneuve-la-Comtesse,17474,17,120,170,45,310,85,440,290
6191,Villexavier,17476,17,21,80,4,76,73,153,101
6192,Villiers-Couture,17477,17,3,34,3,65,16,84,37
6193,Vinax,17478,17,5,20,5,30,15,50,25
6194,Virollet,17479,17,64,36,8,120,24,152,100
6195,Virson,17480,17,29,263,59,176,182,417,292
6196,Voissay,17481,17,10,20,10,60,45,115,30
6197,Vouhé,17482,17,76,208,32,200,164,396,284
6198,Yves,17483,17,100,344,188,469,247,904,444
6199,Port-des-Barques,17484,17,436,271,110,733,226,1069,707
6200,Le Grand-Village-Plage,17485,17,188,160,72,404,160,636,348
6201,La Brée-les-Bains,17486,17,185,74,63,319,65,447,259
6202,Achères,18001,18,56,85,33,87,69,189,141
6203,Ainay-le-Vieil,18002,18,25,45,20,95,10,125,70
6204,Les Aix-d'Angillon,18003,18,345,360,145,601,329,1075,705
6205,Allogny,18004,18,125,225,110,305,240,655,350
6206,Allouis,18005,18,64,292,60,324,268,652,356
6207,Annoix,18006,18,20,30,25,95,50,170,50
6208,Apremont-sur-Allier,18007,18,15,9,0,19,9,28,24
6209,Arçay,18008,18,39,164,29,150,119,298,203
6210,Arcomps,18009,18,60,60,20,85,70,175,120
6211,Ardenais,18010,18,40,48,12,80,44,136,88
6212,Argent-sur-Sauldre,18011,18,388,428,151,796,312,1259,816
6213,Argenvières,18012,18,89,105,40,139,100,279,194
6214,Arpheuilles,18013,18,30,65,15,124,65,204,95
6215,Assigny,18014,18,24,24,24,72,28,124,48
6216,Aubigny-sur-Nère,18015,18,1035,1137,478,1851,831,3160,2172
6217,Aubinges,18016,18,24,84,32,100,84,216,108
6218,Augy-sur-Aubois,18017,18,60,55,10,130,45,185,115
6219,Avord,18018,18,155,735,290,570,530,1390,890
6220,Azy,18019,18,80,112,30,125,86,241,192
6221,Bannay,18020,18,135,200,50,280,220,550,335
6222,Bannegon,18021,18,35,36,3,98,34,135,71
6223,Barlieu,18022,18,66,81,13,150,42,205,147
6224,Baugy,18023,18,130,419,122,399,311,832,549
6225,Beddes,18024,18,8,8,8,44,12,64,16
6226,Beffes,18025,18,125,130,50,220,105,375,255
6227,Belleville-sur-Loire,18026,18,94,268,131,282,189,602,362
6228,Bengy-sur-Craon,18027,18,58,156,56,200,118,374,214
6229,Berry-Bouy,18028,18,116,300,136,440,220,796,416
6230,Bessais-le-Fromental,18029,18,41,68,9,122,50,181,109
6231,Blancafort,18030,18,232,226,95,406,135,636,458
6232,Blet,18031,18,125,126,50,165,110,325,251
6233,Boulleret,18032,18,259,224,56,529,189,774,483
6234,Bourges,18033,18,9131,14085,8950,20412,10925,40287,23216
6235,Bouzais,18034,18,32,76,4,144,72,220,108
6236,Brécy,18035,18,52,258,81,265,231,577,310
6237,Brinay,18036,18,50,99,36,209,84,329,149
6238,Brinon-sur-Sauldre,18037,18,236,176,56,376,160,592,412
6239,Bruère-Allichamps,18038,18,100,180,45,180,70,295,280
6240,Bué,18039,18,49,55,32,69,64,165,104
6241,Bussy,18040,18,33,104,26,124,52,202,137
6242,La Celette,18041,18,35,45,5,60,30,95,80
6243,La Celle,18042,18,39,62,33,106,51,190,101
6244,La Celle-Condé,18043,18,21,39,6,70,29,105,60
6245,Cerbois,18044,18,45,110,65,110,95,270,155
6246,Chalivoy-Milon,18045,18,25,120,20,160,100,280,145
6247,Chambon,18046,18,18,36,12,64,16,92,54
6248,La Chapelle-d'Angillon,18047,18,145,125,70,185,105,360,270
6249,La Chapelle-Hugon,18048,18,36,88,28,152,88,268,124
6250,La Chapelle-Montlinard,18049,18,65,87,9,187,90,286,152
6251,La Chapelle-Saint-Ursin,18050,18,395,738,284,1440,473,2197,1133
6252,La Chapelotte,18051,18,29,45,10,70,25,105,74
6253,Charenton-du-Cher,18052,18,200,228,96,404,160,660,428
6254,Charentonnay,18053,18,30,70,54,104,55,213,100
6255,Charly,18054,18,48,40,32,88,48,168,88
6256,Chârost,18055,18,140,185,45,425,170,640,325
6257,Chassy,18056,18,36,60,16,88,44,148,96
6258,Châteaumeillant,18057,18,476,332,118,637,297,1052,808
6259,Châteauneuf-sur-Cher,18058,18,245,290,125,540,190,855,535
6260,Le Châtelet,18059,18,197,200,70,353,140,563,397
6261,Chaumont,18060,18,4,4,4,20,4,28,8
6262,Chaumoux-Marcilly,18061,18,20,12,12,36,16,64,32
6263,Le Chautay,18062,18,29,77,20,125,54,199,106
6264,Chavannes,18063,18,15,35,5,60,50,115,50
6265,Chéry,18064,18,20,34,13,66,40,119,54
6266,Chezal-Benoît,18065,18,105,85,55,320,90,465,190
6267,Civray,18066,18,100,252,124,356,196,676,352
6268,Clémont,18067,18,169,95,79,244,120,443,264
6269,Cogny,18068,18,15,5,0,5,10,15,20
6270,Colombiers,18069,18,52,100,40,160,64,264,152
6271,Concressault,18070,18,39,36,9,53,34,96,75
6272,Contres,18071,18,10,5,0,10,10,20,15
6273,Cornusse,18072,18,50,70,25,85,45,155,120
6274,Corquoy,18073,18,15,45,10,115,30,155,60
6275,Couargues,18074,18,40,25,30,65,40,135,65
6276,Cours-les-Barres,18075,18,74,245,75,459,195,729,319
6277,Coust,18076,18,101,80,19,132,44,195,181
6278,Couy,18077,18,45,85,40,125,55,220,130
6279,Crézançay-sur-Cher,18078,18,20,10,0,15,15,30,30
6280,Crézancy-en-Sancerre,18079,18,75,110,20,200,60,280,185
6281,Croisy,18080,18,13,38,4,56,26,86,51
6282,Crosses,18081,18,49,80,28,108,76,212,129
6283,Cuffy,18082,18,105,270,75,399,230,704,375
6284,Culan,18083,18,156,110,40,342,80,462,266
6285,Dampierre-en-Crot,18084,18,48,48,12,68,36,116,96
6286,Dampierre-en-Graçay,18085,18,40,88,16,60,64,140,128
6287,Drevant,18086,18,90,85,65,259,75,399,175
6288,Dun-sur-Auron,18087,18,696,837,296,1224,653,2173,1533
6289,Ennordres,18088,18,44,34,16,34,43,93,78
6290,Épineuil-le-Fleuriel,18089,18,88,109,28,108,63,199,197
6291,Étréchy,18090,18,81,126,27,106,98,231,207
6292,Farges-Allichamps,18091,18,27,51,0,90,25,115,78
6293,Farges-en-Septaine,18092,18,80,266,88,248,247,583,346
6294,Faverdines,18093,18,25,45,10,30,35,75,70
6295,Feux,18094,18,60,50,16,141,25,182,110
6296,Flavigny,18095,18,50,40,0,55,35,90,90
6297,Foëcy,18096,18,265,470,194,612,448,1254,735
6298,Fussy,18097,18,207,435,100,873,317,1290,642
6299,Gardefort,18098,18,15,25,0,55,45,100,40
6300,Garigny,18099,18,48,52,20,88,40,148,100
6301,Genouilly,18100,18,108,148,36,276,120,432,256
6302,Germigny-l'Exempt,18101,18,45,55,30,135,50,215,100
6303,Givardon,18102,18,45,55,0,130,60,190,100
6304,Graçay,18103,18,345,255,80,420,235,735,600
6305,Groises,18104,18,52,24,12,44,16,72,76
6306,Gron,18105,18,45,105,15,165,115,295,150
6307,Grossouvre,18106,18,40,56,32,104,48,184,96
6308,La Groutte,18107,18,24,40,8,36,24,68,64
6309,La Guerche-sur-l'Aubois,18108,18,627,677,266,1052,616,1934,1304
6310,Henrichemont,18109,18,263,370,140,578,279,997,633
6311,Herry,18110,18,155,210,90,421,130,641,365
6312,Humbligny,18111,18,40,25,15,75,30,120,65
6313,Ids-Saint-Roch,18112,18,54,43,21,104,32,157,97
6314,Ignol,18113,18,20,65,5,75,30,110,85
6315,Ineuil,18114,18,20,55,25,89,40,154,75
6316,Ivoy-le-Pré,18115,18,128,195,65,280,145,490,323
6317,Jalognes,18116,18,45,65,40,109,55,204,110
6318,Jars,18117,18,84,111,29,174,84,287,195
6319,Jouet-sur-l'Aubois,18118,18,236,315,54,524,255,833,551
6320,Jussy-Champagne,18119,18,55,60,5,45,50,100,115
6321,Jussy-le-Chaudrier,18120,18,65,135,45,255,115,415,200
6322,Lantan,18121,18,15,21,5,26,20,51,36
6323,Lapan,18122,18,24,44,20,56,52,128,68
6324,Laverdines,18123,18,0,10,5,30,5,40,10
6325,Lazenay,18124,18,30,75,40,110,70,220,105
6326,Léré,18125,18,122,218,71,466,182,719,340
6327,Levet,18126,18,167,351,88,460,268,816,518
6328,Lignières,18127,18,340,199,48,462,186,696,539
6329,Limeux,18128,18,20,40,15,45,45,105,60
6330,Lissay-Lochy,18129,18,5,75,20,110,40,170,80
6331,Loye-sur-Arnon,18130,18,76,60,8,112,40,160,136
6332,Lugny-Bourbonnais,18131,18,8,4,0,16,0,16,12
6333,Lugny-Champagne,18132,18,23,23,12,34,35,81,46
6334,Lunery,18133,18,219,313,117,470,241,828,532
6335,Lury-sur-Arnon,18134,18,125,150,55,225,110,390,275
6336,Maisonnais,18135,18,61,18,12,90,24,126,79
6337,Marçais,18136,18,35,61,10,125,55,190,96
6338,Mareuil-sur-Arnon,18137,18,95,134,15,223,98,336,229
6339,Marmagne,18138,18,292,484,128,732,376,1236,776
6340,Marseilles-lès-Aubigny,18139,18,120,115,35,245,125,405,235
6341,Massay,18140,18,210,280,80,515,275,870,490
6342,Mehun-sur-Yèvre,18141,18,1178,1334,597,2430,997,4024,2512
6343,Meillant,18142,18,105,96,53,267,92,412,201
6344,Menetou-Couture,18143,18,20,76,48,132,64,244,96
6345,Menetou-Râtel,18144,18,115,80,75,150,65,290,195
6346,Menetou-Salon,18145,18,300,355,110,560,290,960,655
6347,Ménétréol-sous-Sancerre,18146,18,63,55,15,135,55,205,118
6348,Ménétréol-sur-Sauldre,18147,18,20,45,25,130,5,160,65
6349,Méreau,18148,18,375,655,145,925,485,1555,1030
6350,Méry-ès-Bois,18149,18,95,130,60,210,100,370,225
6351,Méry-sur-Cher,18150,18,88,150,60,250,129,439,238
6352,Montigny,18151,18,40,105,20,165,60,245,145
6353,Montlouis,18152,18,16,8,17,36,4,57,24
6354,Morlac,18153,18,61,60,21,105,49,175,121
6355,Mornay-Berry,18154,18,68,45,0,50,45,95,113
6356,Mornay-sur-Allier,18155,18,50,52,12,190,64,266,102
6357,Morogues,18156,18,61,75,20,156,73,249,136
6358,Morthomiers,18157,18,25,210,85,285,155,525,235
6359,Moulins-sur-Yèvre,18158,18,46,225,88,202,214,504,271
6360,Nançay,18159,18,156,176,36,344,152,532,332
6361,Nérondes,18160,18,177,328,90,546,270,906,505
6362,Neuilly-en-Dun,18161,18,19,41,9,106,32,147,60
6363,Neuilly-en-Sancerre,18162,18,34,25,37,92,20,149,59
6364,Neuvy-Deux-Clochers,18163,18,51,40,12,91,47,150,91
6365,Neuvy-le-Barrois,18164,18,10,35,10,67,30,107,45
6366,Neuvy-sur-Barangeon,18165,18,184,232,76,520,156,752,416
6367,Nohant-en-Goût,18166,18,25,141,21,146,106,273,166
6368,Nohant-en-Graçay,18167,18,44,64,24,104,52,180,108
6369,Le Noyer,18168,18,49,17,3,121,16,140,66
6370,Nozières,18169,18,30,45,25,85,20,130,75
6371,Oizon,18170,18,175,120,35,220,130,385,295
6372,Orcenais,18171,18,8,62,12,83,56,151,70
6373,Orval,18172,18,404,357,110,659,291,1060,761
6374,Osmery,18173,18,20,65,20,115,50,185,85
6375,Osmoy,18174,18,8,36,20,80,32,132,44
6376,Ourouer-les-Bourdelins,18175,18,121,105,50,286,65,401,226
6377,Parassy,18176,18,40,100,60,145,85,290,140
6378,Parnay,18177,18,8,12,0,8,12,20,20
6379,La Perche,18178,18,45,35,15,85,40,140,80
6380,Pigny,18179,18,54,223,78,295,181,554,277
6381,Plaimpied-Givaudins,18180,18,168,507,136,698,366,1200,675
6382,Plou,18181,18,40,132,40,188,108,336,172
6383,Poisieux,18182,18,24,48,13,63,38,114,72
6384,Le Pondy,18183,18,35,35,20,40,30,90,70
6385,Précy,18184,18,59,40,15,109,35,159,99
6386,Presly,18185,18,32,44,0,60,80,140,76
6387,Preuilly,18186,18,60,90,30,160,85,275,150
6388,Préveranges,18187,18,131,45,30,275,45,350,176
6389,Primelles,18188,18,25,55,10,95,45,150,80
6390,Quantilly,18189,18,45,100,35,205,65,305,145
6391,Quincy,18190,18,70,213,55,273,234,562,283
6392,Raymond,18191,18,25,65,15,60,40,115,90
6393,Reigny,18192,18,60,65,15,85,45,145,125
6394,Rezay,18193,18,44,40,16,100,40,156,84
6395,Rians,18194,18,111,213,110,317,173,600,324
6396,Sagonne,18195,18,51,22,12,53,6,71,73
6397,Saint-Aignan-des-Noyers,18196,18,25,20,10,20,20,50,45
6398,Saint-Amand-Montrond,18197,18,2014,1718,866,3596,1242,5704,3732
6399,Saint-Ambroix,18198,18,55,80,45,120,60,225,135
6400,Saint-Baudel,18199,18,58,34,9,76,37,122,92
6401,Saint-Bouize,18200,18,90,50,15,110,35,160,140
6402,Saint-Caprais,18201,18,20,271,60,185,228,473,291
6403,Saint-Céols,18202,18,0,0,5,10,0,15,0
6404,Saint-Christophe-le-Chaudry,18203,18,12,22,0,44,17,61,34
6405,Saint-Denis-de-Palin,18204,18,23,77,9,112,79,200,100
6406,Saint-Doulchard,18205,18,1536,2011,508,3471,1459,5438,3547
6407,Saint-Éloy-de-Gy,18206,18,109,396,62,560,318,940,505
6408,Saint-Florent-sur-Cher,18207,18,1106,1356,583,2378,991,3952,2462
6409,Sainte-Gemme-en-Sancerrois,18208,18,60,120,20,140,105,265,180
6410,Saint-Georges-de-Poisieux,18209,18,29,114,26,175,67,268,143
6411,Saint-Georges-sur-la-Prée,18210,18,52,188,36,216,160,412,240
6412,Saint-Georges-sur-Moulon,18211,18,70,162,80,273,136,489,232
6413,Saint-Germain-des-Bois,18212,18,34,132,63,229,109,401,166
6414,Saint-Germain-du-Puy,18213,18,841,1156,416,1656,882,2954,1997
6415,Saint-Hilaire-de-Court,18214,18,65,165,30,265,110,405,230
6416,Saint-Hilaire-de-Gondilly,18215,18,30,45,5,60,30,95,75
6417,Saint-Hilaire-en-Lignières,18216,18,112,81,19,190,60,269,193
6418,Saint-Jeanvrin,18217,18,35,30,5,60,20,85,65
6419,Saint-Just,18218,18,39,130,55,227,109,391,169
6420,Saint-Laurent,18219,18,20,120,56,152,112,320,140
6421,Saint-Léger-le-Petit,18220,18,49,56,18,123,52,193,105
6422,Saint-Loup-des-Chaumes,18221,18,36,80,8,108,60,176,116
6423,Sainte-Lunaise,18222,18,0,6,0,9,0,9,6
6424,Saint-Martin-d'Auxigny,18223,18,233,602,184,777,480,1441,835
6425,Saint-Martin-des-Champs,18224,18,50,35,9,122,39,170,85
6426,Saint-Maur,18225,18,29,57,21,110,28,159,86
6427,Saint-Michel-de-Volangis,18226,18,40,125,35,190,80,305,165
6428,Sainte-Montaine,18227,18,29,26,17,70,28,115,55
6429,Saint-Outrille,18228,18,70,22,12,56,9,77,92
6430,Saint-Palais,18229,18,65,130,39,269,120,428,195
6431,Saint-Pierre-les-Bois,18230,18,56,60,36,116,40,192,116
6432,Saint-Pierre-les-Étieux,18231,18,85,115,75,300,120,495,200
6433,Saint-Priest-la-Marche,18232,18,30,40,15,130,10,155,70
6434,Saint-Satur,18233,18,337,285,80,506,212,798,622
6435,Saint-Saturnin,18234,18,109,46,9,169,43,221,155
6436,Sainte-Solange,18235,18,140,240,135,440,155,730,380
6437,Saint-Symphorien,18236,18,17,26,0,33,30,63,43
6438,Sainte-Thorette,18237,18,36,109,36,185,68,289,145
6439,Saint-Vitte,18238,18,28,16,16,48,16,80,44
6440,Saligny-le-Vif,18239,18,24,56,28,48,36,112,80
6441,Sancergues,18240,18,134,155,76,156,101,333,289
6442,Sancerre,18241,18,255,222,133,501,198,832,477
6443,Sancoins,18242,18,669,541,155,1149,425,1729,1210
6444,Santranges,18243,18,75,100,35,120,85,240,175
6445,Saugy,18244,18,5,25,0,45,15,60,30
6446,Saulzais-le-Potier,18245,18,87,95,12,128,74,214,182
6447,Savigny-en-Sancerre,18246,18,193,195,90,399,150,639,388
6448,Savigny-en-Septaine,18247,18,44,208,36,248,164,448,252
6449,Senneçay,18248,18,3,120,31,133,105,269,123
6450,Sens-Beaujeu,18249,18,60,70,40,170,45,255,130
6451,Serruelles,18250,18,5,20,5,30,20,55,25
6452,Sévry,18251,18,8,28,8,32,8,48,36
6453,Sidiailles,18252,18,120,15,20,130,15,165,135
6454,Soulangis,18253,18,24,118,26,165,101,292,142
6455,Soye-en-Septaine,18254,18,49,120,39,208,104,351,169
6456,Le Subdray,18255,18,70,230,90,345,175,610,300
6457,Subligny,18256,18,32,64,36,136,68,240,96
6458,Sury-près-Léré,18257,18,66,179,39,221,128,388,245
6459,Sury-en-Vaux,18258,18,53,136,43,197,116,356,189
6460,Sury-ès-Bois,18259,18,43,25,9,98,38,145,68
6461,Tendron,18260,18,26,40,10,10,20,40,66
6462,Thaumiers,18261,18,61,91,25,93,89,207,152
6463,Thauvenay,18262,18,56,92,20,124,68,212,148
6464,Thénioux,18263,18,75,140,45,280,125,450,215
6465,Thou,18264,18,16,16,12,32,0,44,32
6466,Torteron,18265,18,130,165,85,245,170,500,295
6467,Touchay,18266,18,40,25,20,95,30,145,65
6468,Trouy,18267,18,517,903,225,1542,624,2391,1420
6469,Uzay-le-Venon,18268,18,40,90,54,140,70,264,130
6470,Vailly-sur-Sauldre,18269,18,242,75,50,237,55,342,317
6471,Vallenay,18270,18,96,159,33,223,142,398,255
6472,Vasselay,18271,18,118,382,103,389,335,827,500
6473,Veaugues,18272,18,108,148,44,176,160,380,256
6474,Venesmes,18273,18,166,170,81,208,144,433,336
6475,Verdigny,18274,18,72,64,24,104,56,184,136
6476,Vereaux,18275,18,15,30,20,60,25,105,45
6477,Vernais,18276,18,60,35,5,70,20,95,95
6478,Verneuil,18277,18,10,0,0,15,0,15,10
6479,Vesdun,18278,18,129,94,32,177,72,281,223
6480,Vierzon,18279,18,4851,5567,2672,8924,4035,15631,10418
6481,Vignoux-sous-les-Aix,18280,18,72,176,56,284,104,444,248
6482,Vignoux-sur-Barangeon,18281,18,225,502,174,798,334,1306,727
6483,Villabon,18282,18,71,125,37,172,93,302,196
6484,Villecelin,18283,18,25,15,0,30,15,45,40
6485,Villegenon,18284,18,15,30,35,115,15,165,45
6486,Villeneuve-sur-Cher,18285,18,25,115,40,160,100,300,140
6487,Villequiers,18286,18,65,102,36,141,86,263,167
6488,Vinon,18287,18,64,56,24,88,60,172,120
6489,Vorly,18288,18,30,45,15,70,80,165,75
6490,Vornay,18289,18,53,177,47,125,131,303,230
6491,Vouzeron,18290,18,53,95,40,133,95,268,148
6492,Affieux,19001,19,76,56,12,168,52,232,132
6493,Aix,19002,19,28,89,6,138,71,215,117
6494,Albignac,19003,19,42,26,21,80,33,134,68
6495,Albussac,19004,19,216,116,44,228,96,368,332
6496,Allassac,19005,19,563,811,291,1222,799,2312,1374
6497,Alleyrat,19006,19,22,9,3,21,16,40,31
6498,Altillac,19007,19,150,145,60,410,115,585,295
6499,Ambrugeat,19008,19,33,24,3,91,20,114,57
6500,Les Angles-sur-Corrèze,19009,19,12,20,8,52,16,76,32
6501,Argentat,19010,19,658,505,225,1020,435,1680,1163
6502,Arnac-Pompadour,19011,19,285,173,65,393,172,630,458
6503,Astaillac,19012,19,34,43,8,89,22,119,77
6504,Aubazines,19013,19,110,195,68,277,187,532,305
6505,Auriac,19014,19,32,36,12,136,24,172,68
6506,Ayen,19015,19,100,165,25,300,135,460,265
6507,Bar,19016,19,64,56,24,104,68,196,120
6508,Bassignac-le-Bas,19017,19,40,5,5,35,0,40,45
6509,Bassignac-le-Haut,19018,19,40,30,5,80,19,104,70
6510,Beaulieu-sur-Dordogne,19019,19,220,150,64,370,111,545,370
6511,Beaumont,19020,19,20,20,15,50,15,80,40
6512,Bellechassagne,19021,19,8,4,13,32,20,65,12
6513,Benayes,19022,19,64,23,16,84,19,119,87
6514,Beynat,19023,19,172,252,116,448,236,800,424
6515,Beyssac,19024,19,145,80,44,179,80,303,225
6516,Beyssenac,19025,19,100,75,5,120,70,195,175
6517,Bilhac,19026,19,40,16,12,100,16,128,56
6518,Bonnefond,19027,19,45,10,5,39,5,49,55
6519,Bort-les-Orgues,19028,19,528,402,269,886,346,1501,930
6520,Branceilles,19029,19,30,48,8,111,55,174,78
6521,Brignac-la-Plaine,19030,19,104,257,105,320,198,623,361
6522,Brive-la-Gaillarde,19031,19,8796,9495,5215,14326,7653,27194,18291
6523,Brivezac,19032,19,63,13,9,46,15,70,76
6524,Bugeat,19033,19,199,70,32,276,81,389,269
6525,Camps-Saint-Mathurin-Léobazel,19034,19,40,40,20,110,35,165,80
6526,Chabrignac,19035,19,85,110,40,175,105,320,195
6527,Chamberet,19036,19,312,236,56,388,212,656,548
6528,Chamboulive,19037,19,263,202,96,371,140,607,465
6529,Chameyrat,19038,19,208,280,88,736,260,1084,488
6530,Champagnac-la-Noaille,19039,19,60,36,8,76,44,128,96
6531,Champagnac-la-Prune,19040,19,45,45,0,60,25,85,90
6532,Chanac-les-Mines,19041,19,110,75,45,233,45,323,185
6533,Chanteix,19042,19,112,132,12,192,128,332,244
6534,La Chapelle-aux-Brocs,19043,19,20,100,30,200,80,310,120
6535,La Chapelle-aux-Saints,19044,19,20,57,16,95,43,154,77
6536,La Chapelle-Saint-Géraud,19045,19,30,45,15,85,25,125,75
6537,Chapelle-Spinasse,19046,19,24,20,0,68,12,80,44
6538,Chartrier-Ferrière,19047,19,60,75,37,121,72,230,135
6539,Le Chastang,19048,19,48,84,12,124,92,228,132
6540,Chasteaux,19049,19,90,205,90,190,170,450,295
6541,Chauffour-sur-Vell,19050,19,55,90,20,184,69,273,145
6542,Chaumeil,19051,19,40,20,20,74,25,119,60
6543,Chavanac,19052,19,5,5,0,30,0,30,10
6544,Chaveroche,19053,19,24,48,24,72,32,128,72
6545,Chenailler-Mascheix,19054,19,38,39,4,37,51,92,77
6546,Chirac-Bellevue,19055,19,60,61,12,56,54,122,121
6547,Clergoux,19056,19,97,75,20,155,84,259,172
6548,Collonges-la-Rouge,19057,19,80,108,36,164,92,292,188
6549,Combressol,19058,19,40,82,30,131,47,208,122
6550,Concèze,19059,19,84,85,35,159,60,254,169
6551,Condat-sur-Ganaveix,19060,19,111,108,25,200,90,315,219
6552,Cornil,19061,19,188,300,88,348,208,644,488
6553,Corrèze,19062,19,253,205,43,304,167,514,458
6554,Cosnac,19063,19,206,680,161,1280,491,1932,886
6555,Couffy-sur-Sarsonne,19064,19,20,4,8,40,0,48,24
6556,Courteix,19065,19,12,22,4,4,17,25,34
6557,Cublac,19066,19,233,380,143,594,325,1062,613
6558,Curemonte,19067,19,44,48,20,76,32,128,92
6559,Dampniat,19068,19,108,172,76,220,156,452,280
6560,Darazac,19069,19,55,10,10,40,15,65,65
6561,Darnets,19070,19,44,68,26,104,79,209,112
6562,Davignac,19071,19,36,40,10,96,40,146,76
6563,Donzenac,19072,19,413,615,194,792,461,1447,1028
6564,Égletons,19073,19,606,978,499,1008,507,2014,1584
6565,L'Église-aux-Bois,19074,19,10,5,5,15,15,35,15
6566,Espagnac,19075,19,97,64,12,135,40,187,161
6567,Espartignac,19076,19,68,68,22,163,70,255,136
6568,Estivals,19077,19,21,38,4,39,20,63,59
6569,Estivaux,19078,19,52,112,17,120,68,205,164
6570,Eyburie,19079,19,100,70,33,164,65,262,170
6571,Eygurande,19080,19,98,100,16,207,90,313,198
6572,Eyrein,19081,19,79,85,45,239,55,339,164
6573,Favars,19082,19,136,212,104,352,208,664,348
6574,Feyt,19083,19,10,20,20,75,15,110,30
6575,Forgès,19084,19,88,60,0,116,44,160,148
6576,Gimel-les-Cascades,19085,19,72,157,78,271,132,481,229
6577,Goulles,19086,19,84,60,6,90,39,135,144
6578,Gourdon-Murat,19087,19,15,25,0,60,15,75,40
6579,Grandsaigne,19088,19,20,0,0,12,4,16,20
6580,Gros-Chastang,19089,19,8,24,16,120,20,156,32
6581,Gumond,19090,19,45,20,15,25,10,50,65
6582,Hautefage,19091,19,45,60,20,124,55,199,105
6583,Le Jardin,19092,19,20,15,15,20,20,55,35
6584,Jugeals-Nazareth,19093,19,95,257,26,336,179,541,352
6585,Juillac,19094,19,210,235,85,400,190,675,445
6586,Lacelle,19095,19,35,10,0,43,9,52,45
6587,Ladignac-sur-Rondelles,19096,19,47,76,16,169,64,249,123
6588,Lafage-sur-Sombre,19097,19,20,10,15,49,20,84,30
6589,Lagarde-Enval,19098,19,136,160,60,324,128,512,296
6590,Lagleygeolle,19099,19,16,36,4,112,36,152,52
6591,Lagraulière,19100,19,224,253,55,351,191,597,477
6592,Laguenne,19101,19,276,256,128,456,224,808,532
6593,Lamazière-Basse,19102,19,49,34,4,118,28,150,83
6594,Lamazière-Haute,19103,19,15,6,6,13,12,31,21
6595,Lamongerie,19104,19,35,15,5,45,15,65,50
6596,Lanteuil,19105,19,44,160,64,200,96,360,204
6597,Lapleau,19106,19,100,64,16,148,64,228,164
6598,Larche,19107,19,195,305,205,625,245,1075,500
6599,Laroche-près-Feyt,19108,19,15,5,10,25,15,50,20
6600,Lascaux,19109,19,12,64,16,68,52,136,76
6601,Latronche,19110,19,20,22,10,57,21,88,42
6602,Laval-sur-Luzège,19111,19,40,10,0,35,15,50,50
6603,Lestards,19112,19,12,17,10,30,16,56,29
6604,Liginiac,19113,19,140,125,20,200,95,315,265
6605,Lignareix,19114,19,5,40,25,65,35,125,45
6606,Ligneyrac,19115,19,60,44,20,108,52,180,104
6607,Liourdres,19116,19,24,52,12,112,40,164,76
6608,Lissac-sur-Couze,19117,19,88,216,56,220,184,460,304
6609,Le Lonzac,19118,19,215,85,70,310,75,455,300
6610,Lostanges,19119,19,25,23,0,50,19,69,48
6611,Louignac,19120,19,28,36,12,84,38,134,64
6612,Lubersac,19121,19,444,355,126,862,326,1314,799
6613,Madranges,19122,19,40,20,10,90,25,125,60
6614,Malemort,19123,19,1234,1612,744,2778,1398,4920,2846
6615,Mansac,19124,19,188,301,43,409,290,742,489
6616,Marcillac-la-Croisille,19125,19,147,95,55,395,70,520,242
6617,Marcillac-la-Croze,19126,19,35,15,0,100,25,125,50
6618,Marc-la-Tour,19127,19,30,40,0,60,40,100,70
6619,Margerides,19128,19,40,48,16,92,64,172,88
6620,Masseret,19129,19,128,112,24,284,124,432,240
6621,Maussac,19130,19,72,68,48,180,52,280,140
6622,Meilhards,19131,19,145,65,55,180,50,285,210
6623,Ménoire,19132,19,15,25,0,55,20,75,40
6624,Mercoeur,19133,19,30,21,23,82,19,124,51
6625,Merlines,19134,19,137,109,30,221,101,352,246
6626,Mestes,19135,19,15,95,10,135,85,230,110
6627,Meymac,19136,19,336,569,222,744,324,1290,905
6628,Meyrignac-l'Église,19137,19,10,25,0,15,20,35,35
6629,Meyssac,19138,19,228,228,128,432,152,712,456
6630,Millevaches,19139,19,8,8,8,40,12,60,16
6631,Monceaux-sur-Dordogne,19140,19,112,108,33,224,117,374,220
6632,Monestier-Merlines,19141,19,28,48,36,60,36,132,76
6633,Monestier-Port-Dieu,19142,19,25,10,5,25,30,60,35
6634,Montaignac-Saint-Hippolyte,19143,19,103,118,33,166,107,306,221
6635,Montgibaud,19144,19,50,30,25,85,35,145,80
6636,Moustier-Ventadour,19145,19,54,80,44,158,99,301,134
6637,Naves,19146,19,293,460,175,957,360,1492,753
6638,Nespouls,19147,19,30,140,65,306,100,471,170
6639,Neuvic,19148,19,272,308,212,552,156,920,580
6640,Neuville,19149,19,50,45,10,70,25,105,95
6641,Noailhac,19150,19,46,102,21,110,95,226,148
6642,Noailles,19151,19,75,245,73,318,185,576,320
6643,Nonards,19152,19,70,75,45,185,60,290,145
6644,Objat,19153,19,784,748,334,965,595,1894,1532
6645,Orgnac-sur-Vézère,19154,19,48,47,30,102,36,168,95
6646,Orliac-de-Bar,19155,19,55,85,0,98,55,153,140
6647,Palazinges,19156,19,32,20,8,28,32,68,52
6648,Palisse,19157,19,45,50,45,69,15,129,95
6649,Pandrignes,19158,19,44,16,16,80,8,104,60
6650,Péret-Bel-Air,19159,19,10,25,0,54,20,74,35
6651,Pérols-sur-Vézère,19160,19,40,35,0,65,35,100,75
6652,Perpezac-le-Blanc,19161,19,70,100,15,180,120,315,170
6653,Perpezac-le-Noir,19162,19,124,248,76,384,240,700,372
6654,Le Pescher,19163,19,31,37,34,109,26,169,68
6655,Peyrelevade,19164,19,150,130,50,195,110,355,280
6656,Peyrissac,19165,19,24,20,4,72,12,88,44
6657,Pierrefitte,19166,19,24,16,8,12,20,40,40
6658,Confolent-Port-Dieu,19167,19,0,0,0,25,0,25,0
6659,Pradines,19168,19,35,3,3,44,3,50,38
6660,Puy-d'Arnac,19169,19,60,35,9,115,29,153,95
6661,Queyssac-les-Vignes,19170,19,30,40,15,87,30,132,70
6662,Reygade,19171,19,16,40,16,80,40,136,56
6663,Rilhac-Treignac,19172,19,35,5,0,50,10,60,40
6664,Rilhac-Xaintrie,19173,19,50,55,30,90,60,180,105
6665,La Roche-Canillac,19174,19,40,25,5,75,10,90,65
6666,Roche-le-Peyroux,19175,19,40,10,5,15,15,35,50
6667,Rosiers-d'Égletons,19176,19,180,248,20,356,244,620,428
6668,Rosiers-de-Juillac,19177,19,53,15,12,40,18,70,68
6669,Sadroc,19178,19,89,215,42,294,197,533,304
6670,Saillac,19179,19,36,36,36,65,40,141,72
6671,Saint-Angel,19180,19,63,150,43,237,129,409,213
6672,Saint-Augustin,19181,19,147,65,5,144,90,239,212
6673,Saint-Aulaire,19182,19,104,208,56,304,160,520,312
6674,Saint-Bazile-de-la-Roche,19183,19,44,19,0,27,19,46,63
6675,Saint-Bazile-de-Meyssac,19184,19,45,16,0,49,9,58,61
6676,Saint-Bonnet-Avalouze,19185,19,25,35,20,125,20,165,60
6677,Saint-Bonnet-Elvert,19186,19,25,30,25,100,30,155,55
6678,Saint-Bonnet-la-Rivière,19187,19,56,76,20,140,88,248,132
6679,Saint-Bonnet-l'Enfantier,19188,19,56,72,32,128,72,232,128
6680,Saint-Bonnet-les-Tours-de-Merle,19189,19,4,12,4,16,12,32,16
6681,Saint-Bonnet-près-Bort,19190,19,16,48,20,56,40,116,64
6682,Saint-Cernin-de-Larche,19191,19,32,188,44,222,169,435,220
6683,Saint-Chamant,19192,19,96,96,32,196,80,308,192
6684,Saint-Cirgues-la-Loutre,19193,19,47,7,12,62,12,86,54
6685,Saint-Clément,19194,19,215,280,120,445,270,835,495
6686,Saint-Cyprien,19195,19,60,102,10,118,90,218,162
6687,Saint-Cyr-la-Roche,19196,19,39,128,24,148,99,271,167
6688,Saint-Éloy-les-Tuileries,19198,19,12,23,6,41,6,53,35
6689,Saint-Étienne-aux-Clos,19199,19,34,49,20,56,35,111,83
6690,Saint-Étienne-la-Geneste,19200,19,5,10,20,25,20,65,15
6691,Saint-Exupéry-les-Roches,19201,19,96,132,56,176,116,348,228
6692,Sainte-Féréole,19202,19,237,339,81,657,356,1094,576
6693,Sainte-Fortunade,19203,19,252,364,52,768,332,1152,616
6694,Saint-Fréjoux,19204,19,25,80,25,125,45,195,105
6695,Saint-Geniez-ô-Merle,19205,19,20,15,0,50,10,60,35
6696,Saint-Germain-Lavolps,19206,19,10,15,0,20,20,40,25
6697,Saint-Germain-les-Vergnes,19207,19,128,262,81,324,199,604,390
6698,Saint-Hilaire-Foissac,19208,19,39,38,3,47,41,91,77
6699,Saint-Hilaire-les-Courbes,19209,19,16,16,0,78,9,87,32
6700,Saint-Hilaire-Luc,19210,19,9,17,0,18,15,33,26
6701,Saint-Hilaire-Peyroux,19211,19,89,189,58,368,169,595,278
6702,Saint-Hilaire-Taurieux,19212,19,24,13,0,15,17,32,37
6703,Saint-Jal,19213,19,126,135,25,225,120,370,261
6704,Saint-Julien-aux-Bois,19214,19,125,55,15,195,60,270,180
6705,Saint-Julien-le-Pèlerin,19215,19,15,20,0,75,20,95,35
6706,Saint-Julien-le-Vendômois,19216,19,55,55,10,100,35,145,110
6707,Saint-Julien-Maumont,19217,19,40,36,20,60,24,104,76
6708,Saint-Julien-près-Bort,19218,19,75,75,45,165,50,260,150
6709,Sainte-Marie-Lapanouze,19219,19,8,12,4,16,16,36,20
6710,Saint-Martial-de-Gimel,19220,19,76,68,45,218,28,291,144
6711,Saint-Martial-Entraygues,19221,19,4,17,8,25,4,37,21
6712,Saint-Martin-la-Méanne,19222,19,100,50,35,120,40,195,150
6713,Saint-Martin-Sepert,19223,19,24,68,28,108,84,220,92
6714,Saint-Merd-de-Lapleau,19225,19,48,46,8,56,32,96,94
6715,Saint-Merd-les-Oussines,19226,19,15,20,20,70,15,105,35
6716,Saint-Mexant,19227,19,155,305,75,440,265,780,460
6717,Saint-Pantaléon-de-Lapleau,19228,19,0,10,10,30,5,45,10
6718,Saint-Pantaléon-de-Larche,19229,19,544,1119,408,1641,970,3019,1663
6719,Saint-Pardoux-Corbier,19230,19,58,95,20,128,69,217,153
6720,Saint-Pardoux-la-Croisille,19231,19,28,20,24,76,28,128,48
6721,Saint-Pardoux-le-Neuf,19232,19,8,8,12,40,12,64,16
6722,Saint-Pardoux-le-Vieux,19233,19,29,59,21,110,54,185,88
6723,Saint-Pardoux-l'Ortigier,19234,19,88,100,56,144,96,296,188
6724,Saint-Paul,19235,19,45,35,5,90,30,125,80
6725,Saint-Priest-de-Gimel,19236,19,52,126,44,148,78,270,178
6726,Saint-Privat,19237,19,185,165,65,410,180,655,350
6727,Saint-Rémy,19238,19,39,31,22,61,20,103,70
6728,Saint-Robert,19239,19,84,56,12,112,60,184,140
6729,Saint-Salvadour,19240,19,56,76,12,92,61,165,132
6730,Saint-Setiers,19241,19,28,32,16,124,48,188,60
6731,Saint-Solve,19242,19,64,124,20,144,92,256,188
6732,Saint-Sornin-Lavolps,19243,19,223,134,59,281,109,449,357
6733,Saint-Sulpice-les-Bois,19244,19,26,30,0,25,17,42,56
6734,Saint-Sylvain,19245,19,34,15,15,55,15,85,49
6735,Saint-Viance,19246,19,152,433,133,672,356,1161,585
6736,Saint-Victour,19247,19,15,40,10,80,35,125,55
6737,Saint-Ybard,19248,19,156,140,44,216,116,376,296
6738,Saint-Yrieix-le-Déjalat,19249,19,75,30,35,146,40,221,105
6739,Salon-la-Tour,19250,19,99,99,47,251,99,397,198
6740,Sarran,19251,19,40,45,25,125,25,175,85
6741,Sarroux,19252,19,72,100,24,128,96,248,172
6742,Segonzac,19253,19,92,36,0,60,44,104,128
6743,Ségur-le-Château,19254,19,36,10,5,93,35,133,46
6744,Seilhac,19255,19,325,313,125,549,316,990,638
6745,Sérandon,19256,19,92,48,16,140,64,220,140
6746,Sérilhac,19257,19,35,45,15,125,60,200,80
6747,Servières-le-Château,19258,19,148,90,20,236,55,311,238
6748,Sexcles,19259,19,60,45,0,85,45,130,105
6749,Sioniac,19260,19,48,52,8,88,40,136,100
6750,Sornac,19261,19,87,93,55,214,111,380,180
6751,Soudaine-Lavinadière,19262,19,29,17,0,70,24,94,46
6752,Soudeilles,19263,19,52,84,24,108,44,176,136
6753,Soursac,19264,19,151,50,37,145,55,237,201
6754,Tarnac,19265,19,87,23,0,107,56,163,110
6755,Thalamy,19266,19,19,55,15,49,5,69,74
6756,Toy-Viam,19268,19,8,8,0,0,12,12,16
6757,Treignac,19269,19,245,215,90,505,180,775,460
6758,Troche,19270,19,125,105,30,215,75,320,230
6759,Tudeils,19271,19,50,40,30,95,20,145,90
6760,Tulle,19272,19,2432,2430,1541,4570,2095,8206,4862
6761,Turenne,19273,19,210,175,50,265,135,450,385
6762,Ussac,19274,19,422,1000,312,1478,779,2569,1422
6763,Ussel,19275,19,1524,2013,1069,3365,1482,5916,3537
6764,Uzerche,19276,19,446,422,180,750,358,1288,868
6765,Valiergues,19277,19,9,21,8,64,12,84,30
6766,Varetz,19278,19,283,488,141,878,431,1450,771
6767,Vars-sur-Roseix,19279,19,46,79,16,105,54,175,125
6768,Végennes,19280,19,58,30,12,29,29,70,88
6769,Veix,19281,19,37,10,18,5,10,33,47
6770,Veyrières,19283,19,16,8,4,16,8,28,24
6771,Viam,19284,19,16,20,4,28,28,60,36
6772,Vigeois,19285,19,255,210,75,375,165,615,465
6773,Vignols,19286,19,115,115,15,214,95,324,230
6774,Vitrac-sur-Montane,19287,19,51,63,12,65,35,112,114
6775,Voutezac,19288,19,154,251,107,408,228,743,405
6776,Yssandon,19289,19,70,162,60,298,126,484,232
6777,Agencourt,21001,21,40,80,32,132,68,232,120
6778,Agey,21002,21,60,64,32,72,56,160,124
6779,Ahuy,21003,21,170,225,75,532,160,767,395
6780,Aignay-le-Duc,21004,21,55,45,25,118,40,183,100
6781,Aiserey,21005,21,92,352,148,416,316,880,444
6782,Aisey-sur-Seine,21006,21,37,29,15,36,23,74,66
6783,Aisy-sous-Thil,21007,21,25,50,10,75,40,125,75
6784,Alise-Sainte-Reine,21008,21,49,57,25,145,33,203,106
6785,Allerey,21009,21,20,22,8,57,29,94,42
6786,Aloxe-Corton,21010,21,20,40,15,60,15,90,60
6787,Ampilly-les-Bordes,21011,21,0,25,15,35,20,70,25
6788,Ampilly-le-Sec,21012,21,48,60,44,152,44,240,108
6789,Ancey,21013,21,0,140,30,125,120,275,140
6790,Antheuil,21014,21,20,0,10,25,5,40,20
6791,Antigny-la-Ville,21015,21,40,28,0,16,28,44,68
6792,Arceau,21016,21,56,210,44,316,160,520,266
6793,Arcenant,21017,21,40,160,28,148,140,316,200
6794,Arcey,21018,21,5,25,0,20,20,40,30
6795,Arconcey,21020,21,55,40,15,55,35,105,95
6796,Arc-sur-Tille,21021,21,257,704,190,839,482,1511,961
6797,Argilly,21022,21,24,140,34,113,125,272,164
6798,Arnay-le-Duc,21023,21,257,258,98,488,205,791,515
6799,Arnay-sous-Vitteaux,21024,21,23,15,19,68,15,102,38
6800,Arrans,21025,21,5,10,0,30,5,35,15
6801,Asnières-en-Montagne,21026,21,28,40,16,60,36,112,68
6802,Asnières-lès-Dijon,21027,21,100,314,135,443,176,754,414
6803,Athée,21028,21,110,185,50,217,130,397,295
6804,Athie,21029,21,6,23,17,12,20,49,29
6805,Aubaine,21030,21,0,15,0,45,25,70,15
6806,Aubigny-en-Plaine,21031,21,32,116,32,164,116,312,148
6807,Aubigny-la-Ronce,21032,21,28,24,12,56,40,108,52
6808,Aubigny-lès-Sombernon,21033,21,30,30,0,60,35,95,60
6809,Autricourt,21034,21,26,12,8,41,8,57,38
6810,Auvillars-sur-Saône,21035,21,44,100,40,76,68,184,144
6811,Auxant,21036,21,15,10,10,20,10,40,25
6812,Auxey-Duresses,21037,21,35,50,10,145,60,215,85
6813,Auxonne,21038,21,938,1829,827,2147,1399,4373,2767
6814,Avelanges,21039,21,12,8,0,20,0,20,20
6815,Avosnes,21040,21,8,16,8,20,24,52,24
6816,Avot,21041,21,25,40,20,60,20,100,65
6817,Bagnot,21042,21,10,41,9,45,36,90,51
6818,Baigneux-les-Juifs,21043,21,30,55,15,110,20,145,85
6819,Balot,21044,21,19,17,0,16,14,30,36
6820,Barbirey-sur-Ouche,21045,21,22,47,6,83,41,130,69
6821,Bard-le-Régulier,21046,21,5,10,5,30,20,55,15
6822,Bard-lès-Époisses,21047,21,12,4,8,24,0,32,16
6823,Barges,21048,21,32,166,32,198,112,342,198
6824,Barjon,21049,21,9,6,3,9,6,18,15
6825,Baubigny,21050,21,20,45,15,95,35,145,65
6826,Baulme-la-Roche,21051,21,20,27,0,36,20,56,47
6827,Beaulieu,21052,21,6,3,6,6,3,15,9
6828,Beaumont-sur-Vingeanne,21053,21,55,30,10,75,15,100,85
6829,Beaune,21054,21,2992,4598,2673,6680,3920,13273,7590
6830,Beaunotte,21055,21,4,8,0,0,8,8,12
6831,Beire-le-Châtel,21056,21,76,213,89,239,125,453,289
6832,Beire-le-Fort,21057,21,32,96,28,44,112,184,128
6833,Belan-sur-Ource,21058,21,55,53,19,63,32,114,108
6834,Bellefond,21059,21,94,189,40,291,193,524,283
6835,Belleneuve,21060,21,185,481,70,540,321,931,666
6836,Bellenod-sur-Seine,21061,21,25,10,10,20,10,40,35
6837,Bellenot-sous-Pouilly,21062,21,37,51,12,68,33,113,88
6838,Beneuvre,21063,21,19,13,6,41,9,56,32
6839,Benoisey,21064,21,12,20,8,20,16,44,32
6840,Bessey-en-Chaume,21065,21,15,45,10,45,25,80,60
6841,Bessey-la-Cour,21066,21,3,12,0,23,12,35,15
6842,Bessey-lès-Cîteaux,21067,21,26,194,49,220,126,395,220
6843,Beurey-Bauguay,21068,21,28,37,8,24,28,60,65
6844,Beurizot,21069,21,28,24,8,48,4,60,52
6845,Bévy,21070,21,0,35,15,45,29,89,35
6846,Bèze,21071,21,95,170,85,225,150,460,265
6847,Bézouotte,21072,21,24,32,16,72,36,124,56
6848,Bierre-lès-Semur,21073,21,8,16,8,40,0,48,24
6849,Billey,21074,21,28,62,0,90,39,129,90
6850,Billy-lès-Chanceaux,21075,21,10,20,15,10,10,35,30
6851,Binges,21076,21,87,169,43,232,143,418,256
6852,Bissey-la-Côte,21077,21,4,24,16,44,24,84,28
6853,Bissey-la-Pierre,21078,21,12,8,8,12,8,28,20
6854,Blagny-sur-Vingeanne,21079,21,20,35,5,55,25,85,55
6855,Blaisy-Bas,21080,21,56,192,64,248,148,460,248
6856,Blaisy-Haut,21081,21,0,32,12,52,32,96,32
6857,Blancey,21082,21,8,21,0,29,8,37,29
6858,Blanot,21083,21,8,40,0,32,36,68,48
6859,Source-Seine,21084,21,12,8,4,16,12,32,20
6860,Bligny-le-Sec,21085,21,40,25,5,40,30,75,65
6861,Bligny-lès-Beaune,21086,21,136,320,92,444,244,780,456
6862,Bligny-sur-Ouche,21087,21,110,170,65,304,152,521,280
6863,Boncourt-le-Bois,21088,21,32,84,16,76,68,160,116
6864,Bonnencontre,21089,21,54,120,10,160,85,255,174
6865,Boudreville,21090,21,20,12,4,20,12,36,32
6866,Bouhey,21091,21,0,0,0,15,15,30,0
6867,Bouilland,21092,21,20,32,17,74,41,132,52
6868,Bouix,21093,21,29,22,4,50,22,76,51
6869,Bourberain,21094,21,60,102,20,86,82,188,162
6870,Bousselange,21095,21,16,4,4,24,0,28,20
6871,Boussenois,21096,21,0,35,10,55,35,100,35
6872,Boussey,21097,21,3,3,3,6,6,15,6
6873,Boux-sous-Salmaise,21098,21,26,20,3,39,13,55,46
6874,Bouze-lès-Beaune,21099,21,20,72,25,118,93,236,92
6875,Brain,21100,21,0,10,5,10,15,30,10
6876,Braux,21101,21,17,34,0,48,25,73,51
6877,Brazey-en-Morvan,21102,21,45,23,6,38,18,62,68
6878,Brazey-en-Plaine,21103,21,275,597,286,963,285,1534,872
6879,Brémur-et-Vaurois,21104,21,11,16,0,15,25,40,27
6880,Bressey-sur-Tille,21105,21,16,316,100,260,249,609,332
6881,Bretenière,21106,21,48,247,74,325,144,543,295
6882,Bretigny,21107,21,70,245,85,348,165,598,315
6883,Brianny,21108,21,16,20,4,28,16,48,36
6884,Brion-sur-Ource,21109,21,13,29,43,114,13,170,42
6885,Brochon,21110,21,79,119,63,255,65,383,198
6886,Brognon,21111,21,8,77,24,116,44,184,85
6887,Broin,21112,21,44,136,8,100,148,256,180
6888,Broindon,21113,21,16,52,16,13,56,85,68
6889,Buffon,21114,21,10,60,15,65,40,120,70
6890,Buncey,21115,21,45,65,20,195,40,255,110
6891,Bure-les-Templiers,21116,21,36,28,8,52,16,76,64
6892,Busseaut,21117,21,12,0,0,23,0,23,12
6893,Busserotte-et-Montenaille,21118,21,12,12,0,6,12,18,24
6894,Bussières,21119,21,0,5,10,30,0,40,5
6895,La Bussière-sur-Ouche,21120,21,28,24,20,48,20,88,52
6896,Bussy-la-Pesle,21121,21,15,20,0,25,20,45,35
6897,Bussy-le-Grand,21122,21,45,75,30,90,60,180,120
6898,Buxerolles,21123,21,16,0,0,8,0,8,16
6899,Censerey,21124,21,25,35,5,85,30,120,60
6900,Cérilly,21125,21,60,50,5,90,30,125,110
6901,Cessey-sur-Tille,21126,21,55,147,61,188,114,363,202
6902,Chaignay,21127,21,40,151,35,190,121,346,191
6903,Chailly-sur-Armançon,21128,21,30,71,10,70,65,145,101
6904,Chambain,21129,21,12,3,0,0,6,6,15
6905,Chambeire,21130,21,16,115,44,108,89,241,131
6906,Chamblanc,21131,21,47,117,33,119,85,237,164
6907,Chamboeuf,21132,21,16,96,12,148,76,236,112
6908,Chambolle-Musigny,21133,21,70,60,25,75,70,170,130
6909,Chamesson,21134,21,44,85,16,92,48,156,129
6910,Champagne-sur-Vingeanne,21135,21,29,73,12,115,46,173,102
6911,Champagny,21136,21,0,0,3,15,0,18,0
6912,Champ-d'Oiseau,21137,21,4,16,12,36,20,68,20
6913,Champdôtre,21138,21,29,144,67,160,119,346,173
6914,Champeau-en-Morvan,21139,21,92,19,9,69,22,100,111
6915,Champignolles,21140,21,10,15,15,30,10,55,25
6916,Champrenault,21141,21,8,8,0,8,8,16,16
6917,Chanceaux,21142,21,28,57,12,64,56,132,85
6918,Channay,21143,21,16,16,0,28,8,36,32
6919,Charencey,21144,21,6,0,0,9,9,18,6
6920,Charigny,21145,21,12,8,0,0,4,4,20
6921,Charmes,21146,21,0,45,0,45,30,75,45
6922,Charny,21147,21,8,0,0,12,4,16,8
6923,Charrey-sur-Saône,21148,21,45,105,30,90,85,205,150
6924,Charrey-sur-Seine,21149,21,35,15,5,80,15,100,50
6925,Chassagne-Montrachet,21150,21,50,45,25,125,60,210,95
6926,Chassey,21151,21,10,15,15,45,15,75,25
6927,Châteauneuf,21152,21,35,15,10,25,10,45,50
6928,Châtellenot,21153,21,25,17,6,41,18,65,42
6929,Châtillon-sur-Seine,21154,21,909,964,398,1667,828,2893,1873
6930,Chaudenay-la-Ville,21155,21,0,12,4,20,4,28,12
6931,Chaudenay-le-Château,21156,21,3,10,6,6,6,18,13
6932,Chaugey,21157,21,0,0,6,0,6,12,0
6933,Chaume-et-Courchamp,21158,21,19,40,25,50,40,115,59
6934,La Chaume,21159,21,25,5,10,55,0,65,30
6935,Chaume-lès-Baigneux,21160,21,10,20,10,40,20,70,30
6936,Chaumont-le-Bois,21161,21,17,9,9,29,6,44,26
6937,Chaux,21162,21,37,134,35,140,80,255,171
6938,Chazeuil,21163,21,20,55,10,90,35,135,75
6939,Chazilly,21164,21,24,20,20,48,28,96,44
6940,Chemin-d'Aisey,21165,21,0,5,0,30,20,50,5
6941,Chenôve,21166,21,1865,3747,1678,4047,2631,8356,5612
6942,Cheuge,21167,21,20,24,0,40,24,64,44
6943,Chevannay,21168,21,15,5,0,20,0,20,20
6944,Chevannes,21169,21,13,18,6,45,25,76,31
6945,Chevigny-en-Valière,21170,21,30,125,20,90,75,185,155
6946,Chevigny-Saint-Sauveur,21171,21,1122,2625,1286,3815,1942,7043,3747
6947,Chivres,21172,21,72,77,8,59,50,117,149
6948,Chorey-les-Beaune,21173,21,110,170,45,145,155,345,280
6949,Cirey-lès-Pontailler,21175,21,12,35,8,37,56,101,47
6950,Civry-en-Montagne,21176,21,15,30,0,20,45,65,45
6951,Clamerey,21177,21,24,28,8,108,16,132,52
6952,Clémencey,21178,21,8,36,0,40,40,80,44
6953,Clénay,21179,21,24,217,62,313,177,552,241
6954,Cléry,21180,21,20,25,15,45,20,80,45
6955,Clomot,21181,21,16,25,0,42,20,62,41
6956,Collonges-lès-Bévy,21182,21,5,20,15,35,15,65,25
6957,Collonges-lès-Premières,21183,21,33,261,67,248,195,510,294
6958,Colombier,21184,21,0,8,0,12,24,36,8
6959,Combertault,21185,21,30,190,20,135,175,330,220
6960,Comblanchien,21186,21,112,160,84,137,100,321,272
6961,Commarin,21187,21,9,16,6,38,19,63,25
6962,Corberon,21189,21,30,140,35,125,115,275,170
6963,Corcelles-les-Arts,21190,21,63,110,35,185,80,300,173
6964,Corcelles-lès-Cîteaux,21191,21,70,190,60,355,135,550,260
6965,Corcelles-les-Monts,21192,21,120,120,50,285,80,415,240
6966,Corgengoux,21193,21,52,88,28,120,84,232,140
6967,Corgoloin,21194,21,55,176,133,311,137,581,231
6968,Cormot-le-Grand,21195,21,24,21,4,60,17,81,45
6969,Corpeau,21196,21,82,202,105,326,186,617,284
6970,Corpoyer-la-Chapelle,21197,21,3,3,0,6,6,12,6
6971,Corrombles,21198,21,29,58,16,61,41,118,87
6972,Corsaint,21199,21,8,47,4,58,21,83,55
6973,Couchey,21200,21,180,175,150,470,95,715,355
6974,Coulmier-le-Sec,21201,21,55,95,15,65,55,135,150
6975,Courban,21202,21,10,40,10,70,40,120,50
6976,Courcelles-Frémoy,21203,21,30,30,0,30,25,55,60
6977,Courcelles-lès-Montbard,21204,21,6,9,0,39,9,48,15
6978,Courcelles-lès-Semur,21205,21,24,68,12,84,48,144,92
6979,Courlon,21207,21,8,28,0,36,12,48,36
6980,Courtivron,21208,21,50,35,15,45,30,90,85
6981,Couternon,21209,21,128,536,144,616,416,1176,664
6982,Créancey,21210,21,30,135,60,170,125,355,165
6983,Crécey-sur-Tille,21211,21,40,20,5,55,20,80,60
6984,Crépand,21212,21,80,85,25,85,60,170,165
6985,Crimolois,21213,21,64,219,72,264,145,481,283
6986,Crugey,21214,21,19,28,12,71,21,104,47
6987,Cuiserey,21215,21,4,53,4,56,36,96,57
6988,Culètre,21216,21,16,28,12,28,16,56,44
6989,Curley,21217,21,6,23,9,38,28,75,29
6990,Curtil-Saint-Seine,21218,21,0,34,21,40,21,82,34
6991,Curtil-Vergy,21219,21,16,44,0,40,32,72,60
6992,Cussey-les-Forges,21220,21,30,40,5,30,30,65,70
6993,Cussy-la-Colonne,21221,21,12,25,0,0,30,30,37
6994,Cussy-le-Châtel,21222,21,15,20,0,50,20,70,35
6995,Daix,21223,21,184,328,108,603,180,891,512
6996,Dampierre-en-Montagne,21224,21,25,15,5,20,10,35,40
6997,Dampierre-et-Flée,21225,21,28,32,8,52,28,88,60
6998,Darcey,21226,21,55,110,10,110,55,175,165
6999,Darois,21227,21,50,82,21,114,64,199,132
7000,Détain-et-Bruant,21228,21,20,40,0,35,35,70,60
7001,Diancey,21229,21,12,18,0,8,28,36,30
7002,Diénay,21230,21,29,87,22,107,68,197,116
7003,Dijon,21231,21,17099,31970,30671,39370,27400,97441,49069
7004,Dompierre-en-Morvan,21232,21,20,40,25,80,45,150,60
7005,Drambon,21233,21,0,44,36,40,48,124,44
7006,Drée,21234,21,12,8,8,12,4,24,20
7007,Duesme,21235,21,17,9,0,8,8,16,26
7008,Ébaty,21236,21,4,57,26,82,53,161,61
7009,Échalot,21237,21,10,15,0,70,20,90,25
7010,Échannay,21238,21,8,25,4,57,20,81,33
7011,Échenon,21239,21,64,220,30,210,180,420,284
7012,Échevannes,21240,21,8,77,36,36,84,156,85
7013,Échevronne,21241,21,22,81,9,63,70,142,103
7014,Échigey,21242,21,6,95,19,68,65,152,101
7015,Écutigny,21243,21,10,21,5,47,10,62,31
7016,Éguilly,21244,21,0,15,10,25,10,45,15
7017,Épagny,21245,21,12,100,16,104,68,188,112
7018,Épernay-sous-Gevrey,21246,21,10,60,10,75,35,120,70
7019,Époisses,21247,21,120,190,105,230,125,460,310
7020,Éringes,21248,21,12,20,8,8,20,36,32
7021,Esbarres,21249,21,58,189,41,240,120,401,247
7022,Essarois,21250,21,16,13,0,36,0,36,29
7023,Essey,21251,21,8,44,68,68,60,196,52
7024,Étais,21252,21,25,20,5,35,15,55,45
7025,Étalante,21253,21,30,25,8,56,12,76,55
7026,L'Étang-Vergy,21254,21,12,55,17,36,58,111,67
7027,Étaules,21255,21,44,60,28,96,40,164,104
7028,Étevaux,21256,21,20,70,50,115,50,215,90
7029,Étormay,21257,21,15,25,5,25,0,30,40
7030,Étrochey,21258,21,22,16,4,77,8,89,38
7031,Fain-lès-Montbard,21259,21,30,80,10,105,70,185,110
7032,Fain-lès-Moutiers,21260,21,16,44,0,51,30,81,60
7033,Fauverney,21261,21,59,130,70,219,130,419,189
7034,Faverolles-lès-Lucey,21262,21,0,0,0,28,0,28,0
7035,Fénay,21263,21,225,300,145,590,240,975,525
7036,Le Fête,21264,21,8,20,4,20,20,44,28
7037,Fixin,21265,21,159,117,36,303,62,401,276
7038,Flacey,21266,21,28,32,16,40,29,85,60
7039,Flagey-Echézeaux,21267,21,44,84,39,206,39,284,128
7040,Flagey-lès-Auxonne,21268,21,12,56,16,80,36,132,68
7041,Flammerans,21269,21,40,120,30,150,80,260,160
7042,Flavignerot,21270,21,16,31,17,62,13,92,47
7043,Flavigny-sur-Ozerain,21271,21,65,40,10,75,35,120,105
7044,Flée,21272,21,28,36,4,56,36,96,64
7045,Fleurey-sur-Ouche,21273,21,112,235,100,506,195,801,347
7046,Foissy,21274,21,24,36,12,56,32,100,60
7047,Foncegrive,21275,21,9,16,6,68,9,83,25
7048,Fontaines-en-Duesmois,21276,21,25,20,5,35,25,65,45
7049,Fontaine-Française,21277,21,80,213,105,295,133,533,293
7050,Fontaine-lès-Dijon,21278,21,1563,1724,807,3299,1266,5372,3287
7051,Fontaines-les-Sèches,21279,21,12,4,0,20,0,20,16
7052,Fontangy,21280,21,40,15,15,40,30,85,55
7053,Fontenelle,21281,21,20,44,12,44,40,96,64
7054,Forléans,21282,21,15,40,10,20,30,60,55
7055,Fraignot-et-Vesvrotte,21283,21,3,6,3,28,6,37,9
7056,Francheville,21284,21,34,74,4,55,65,124,108
7057,Franxault,21285,21,72,88,44,156,84,284,160
7058,Frénois,21286,21,15,30,5,30,15,50,45
7059,Fresnes,21287,21,35,30,15,75,20,110,65
7060,Frôlois,21288,21,24,44,24,60,28,112,68
7061,Fussey,21289,21,4,44,4,36,32,72,48
7062,Gemeaux,21290,21,55,265,80,240,235,555,320
7063,Genay,21291,21,40,90,50,115,60,225,130
7064,Genlis,21292,21,496,1349,525,1935,990,3450,1845
7065,Gergueil,21293,21,6,23,3,51,20,74,29
7066,Gerland,21294,21,30,120,25,125,125,275,150
7067,Gevrey-Chambertin,21295,21,337,652,323,1027,585,1935,989
7068,Gevrolles,21296,21,28,36,24,68,28,120,64
7069,Gilly-lès-Cîteaux,21297,21,72,132,72,248,116,436,204
7070,Gissey-le-Vieil,21298,21,8,12,12,40,12,64,20
7071,Gissey-sous-Flavigny,21299,21,24,20,8,24,28,60,44
7072,Gissey-sur-Ouche,21300,21,44,90,25,145,60,230,134
7073,Glanon,21301,21,15,45,25,95,40,160,60
7074,Gomméville,21302,21,25,45,15,50,20,85,70
7075,Les Goulles,21303,21,0,0,0,18,0,18,0
7076,Grancey-le-Château-Neuvelle,21304,21,40,55,9,90,45,144,95
7077,Grancey-sur-Ource,21305,21,48,40,8,100,28,136,88
7078,Grenant-lès-Sombernon,21306,21,0,63,12,50,53,115,63
7079,Grésigny-Sainte-Reine,21307,21,15,25,15,75,15,105,40
7080,Grignon,21308,21,32,72,36,84,32,152,104
7081,Griselles,21309,21,20,25,15,20,10,45,45
7082,Grosbois-en-Montagne,21310,21,11,13,6,32,9,47,24
7083,Grosbois-lès-Tichey,21311,21,12,26,4,28,8,40,38
7084,Gurgy-la-Ville,21312,21,15,0,0,5,10,15,15
7085,Gurgy-le-Château,21313,21,20,12,0,12,12,24,32
7086,Hauteroche,21314,21,16,0,4,44,4,52,16
7087,Hauteville-lès-Dijon,21315,21,80,308,89,456,191,736,388
7088,Heuilley-sur-Saône,21316,21,36,76,48,100,72,220,112
7089,Is-sur-Tille,21317,21,580,1220,405,1310,805,2520,1800
7090,Izeure,21319,21,56,235,62,234,210,506,291
7091,Izier,21320,21,80,265,85,235,155,475,345
7092,Jailly-les-Moulins,21321,21,24,12,0,28,24,52,36
7093,Jallanges,21322,21,36,84,32,104,76,212,120
7094,Jancigny,21323,21,12,41,13,25,20,58,53
7095,Jeux-lès-Bard,21324,21,10,35,0,5,20,25,45
7096,Jouey,21325,21,40,20,5,65,45,115,60
7097,Jours-lès-Baigneux,21326,21,12,28,4,28,20,52,40
7098,Val-Mont,21327,21,28,27,20,105,36,161,55
7099,Juillenay,21328,21,10,0,0,20,10,30,10
7100,Juilly,21329,21,12,0,4,12,0,16,12
7101,Labergement-Foigney,21330,21,80,45,35,170,35,240,125
7102,Labergement-lès-Auxonne,21331,21,58,81,35,80,33,148,139
7103,Labergement-lès-Seurre,21332,21,70,245,50,360,210,620,315
7104,Labruyère,21333,21,28,64,8,56,56,120,92
7105,Lacanche,21334,21,70,105,45,245,90,380,175
7106,Lacour-d'Arcenay,21335,21,39,25,25,50,10,85,64
7107,Laignes,21336,21,160,140,45,270,70,385,300
7108,Lamarche-sur-Saône,21337,21,154,334,104,431,215,750,488
7109,Lamargelle,21338,21,17,16,29,54,8,91,33
7110,Lantenay,21339,21,20,143,17,173,118,308,163
7111,Lanthes,21340,21,36,84,28,60,56,144,120
7112,Lantilly,21341,21,0,35,15,40,25,80,35
7113,Laperrière-sur-Saône,21342,21,52,118,32,90,70,192,170
7114,Larrey,21343,21,15,25,10,30,10,50,40
7115,Lechâtelet,21344,21,29,71,12,36,52,100,100
7116,Léry,21345,21,25,70,10,85,55,150,95
7117,Leuglay,21346,21,45,45,20,125,40,185,90
7118,Levernois,21347,21,45,75,5,125,40,170,120
7119,Licey-sur-Vingeanne,21348,21,15,15,15,35,20,70,30
7120,Liernais,21349,21,105,137,45,180,55,280,242
7121,Lignerolles,21350,21,10,15,0,25,5,30,25
7122,Longchamp,21351,21,75,320,75,445,215,735,395
7123,Longeault,21352,21,60,115,40,270,75,385,175
7124,Longecourt-en-Plaine,21353,21,79,295,103,402,235,740,374
7125,Longecourt-lès-Culêtre,21354,21,4,4,0,21,8,29,8
7126,Longvic,21355,21,924,2141,1166,2920,1601,5687,3065
7127,Losne,21356,21,261,435,135,481,287,903,696
7128,Louesme,21357,21,25,13,9,31,15,55,38
7129,Lucenay-le-Duc,21358,21,15,45,10,76,35,121,60
7130,Lucey,21359,21,16,12,0,25,4,29,28
7131,Lusigny-sur-Ouche,21360,21,10,25,10,25,25,60,35
7132,Lux,21361,21,52,160,44,164,104,312,212
7133,Maconge,21362,21,12,36,3,21,41,65,48
7134,Magnien,21363,21,70,91,5,115,55,175,161
7135,Magny-Lambert,21364,21,25,20,0,40,5,45,45
7136,Magny-la-Ville,21365,21,12,12,0,32,12,44,24
7137,Magny-lès-Aubigny,21366,21,40,55,15,65,30,110,95
7138,Magny-Montarlot,21367,21,15,70,15,80,75,170,85
7139,Magny-lès-Villers,21368,21,44,54,18,71,22,111,98
7140,Magny-Saint-Médard,21369,21,30,95,25,85,60,170,125
7141,Magny-sur-Tille,21370,21,42,254,46,261,197,504,296
7142,Les Maillys,21371,21,84,220,80,260,176,516,304
7143,Maisey-le-Duc,21372,21,6,16,0,32,15,47,22
7144,Mâlain,21373,21,70,195,74,247,165,486,265
7145,Maligny,21374,21,50,35,15,75,20,110,85
7146,Manlay,21375,21,31,30,30,40,40,110,61
7147,Marandeuil,21376,21,0,45,0,35,30,65,45
7148,Marcellois,21377,21,5,0,0,25,5,30,5
7149,Marcenay,21378,21,9,12,6,43,6,55,21
7150,Marcheseuil,21379,21,25,30,5,65,29,99,55
7151,Marcigny-sous-Thil,21380,21,4,32,0,16,24,40,36
7152,Marcilly-et-Dracy,21381,21,12,20,4,36,28,68,32
7153,Marcilly-Ogny,21382,21,32,20,26,61,9,96,52
7154,Marcilly-sur-Tille,21383,21,184,456,120,516,392,1028,640
7155,Marey-lès-Fussey,21384,21,5,0,10,40,0,50,5
7156,Marey-sur-Tille,21385,21,12,88,4,117,68,189,100
7157,Marigny-le-Cahouët,21386,21,32,96,40,116,24,180,128
7158,Marigny-lès-Reullée,21387,21,12,52,8,96,36,140,64
7159,Marliens,21388,21,26,176,37,132,137,306,202
7160,Marmagne,21389,21,40,25,5,132,10,147,65
7161,Marsannay-la-Côte,21390,21,894,1270,384,1786,864,3034,2164
7162,Marsannay-le-Bois,21391,21,64,244,48,248,212,508,308
7163,Martrois,21392,21,10,20,5,25,15,45,30
7164,Massingy,21393,21,16,29,12,51,24,87,45
7165,Massingy-lès-Semur,21394,21,10,40,10,70,30,110,50
7166,Massingy-lès-Vitteaux,21395,21,5,35,0,30,35,65,40
7167,Mauvilly,21396,21,3,6,0,30,3,33,9
7168,Mavilly-Mandelot,21397,21,40,50,15,40,30,85,90
7169,Maxilly-sur-Saône,21398,21,55,85,45,110,50,205,140
7170,Meilly-sur-Rouvres,21399,21,19,30,3,62,35,100,49
7171,Le Meix,21400,21,0,12,8,20,8,36,12
7172,Meloisey,21401,21,55,60,20,100,70,190,115
7173,Menesble,21402,21,0,10,0,5,10,15,10
7174,Ménessaire,21403,21,24,8,8,32,8,48,32
7175,Ménétreux-le-Pitois,21404,21,65,85,50,165,60,275,150
7176,Merceuil,21405,21,95,245,50,260,170,480,340
7177,Mesmont,21406,21,24,68,12,72,56,140,92
7178,Messanges,21407,21,12,64,4,77,54,135,76
7179,Messigny-et-Vantoux,21408,21,171,298,133,478,199,810,469
7180,Meuilley,21409,21,44,89,49,160,74,283,133
7181,Meulson,21410,21,0,10,0,20,10,30,10
7182,Meursanges,21411,21,30,150,65,180,119,364,180
7183,Meursault,21412,21,139,313,165,519,234,918,452
7184,Millery,21413,21,35,85,30,170,65,265,120
7185,Mimeure,21414,21,39,70,60,114,44,218,109
7186,Minot,21415,21,60,20,25,50,20,95,80
7187,Mirebeau-sur-Bèze,21416,21,236,541,224,563,367,1154,777
7188,Missery,21417,21,10,20,14,50,14,78,30
7189,Moitron,21418,21,10,5,10,30,0,40,15
7190,Molesme,21419,21,44,56,32,96,44,172,100
7191,Molinot,21420,21,16,19,6,43,31,80,35
7192,Moloy,21421,21,24,52,28,96,16,140,76
7193,Molphey,21422,21,20,25,5,45,35,85,45
7194,Montagny-lès-Beaune,21423,21,80,162,26,254,100,380,242
7195,Montagny-lès-Seurre,21424,21,10,30,5,55,20,80,40
7196,Montbard,21425,21,883,1057,504,1763,867,3134,1940
7197,Montberthault,21426,21,40,40,24,80,36,140,80
7198,Montceau-et-Écharnant,21427,21,24,40,12,68,24,104,64
7199,Monthelie,21428,21,25,21,8,49,21,78,46
7200,Montigny-Montfort,21429,21,32,56,28,140,44,212,88
7201,Montigny-Saint-Barthélemy,21430,21,5,20,10,50,5,65,25
7202,Montigny-sur-Armançon,21431,21,30,40,15,65,15,95,70
7203,Montigny-sur-Aube,21432,21,38,48,21,113,31,165,86
7204,Montigny-Mornay-Villeneuve-sur-Vingeanne,21433,21,68,65,32,126,43,201,133
7205,Montlay-en-Auxois,21434,21,12,51,8,36,41,85,63
7206,Montliot-et-Courcelles,21435,21,21,58,12,143,37,192,79
7207,Montmain,21436,21,0,45,4,46,35,85,45
7208,Montmançon,21437,21,15,65,5,90,50,145,80
7209,Montmoyen,21438,21,41,15,10,0,15,25,56
7210,Montoillot,21439,21,0,10,10,25,20,55,10
7211,Montot,21440,21,35,35,10,100,25,135,70
7212,Mont-Saint-Jean,21441,21,52,44,8,120,28,156,96
7213,Morey-Saint-Denis,21442,21,96,156,36,256,136,428,252
7214,Mosson,21444,21,12,12,6,12,9,27,24
7215,La Motte-Ternant,21445,21,45,10,10,50,25,85,55
7216,Moutiers-Saint-Jean,21446,21,30,27,32,47,18,97,57
7217,Musigny,21447,21,5,10,0,20,20,40,15
7218,Mussy-la-Fosse,21448,21,16,24,0,8,28,36,40
7219,Nan-sous-Thil,21449,21,30,51,15,70,35,120,81
7220,Nantoux,21450,21,16,34,8,54,28,90,50
7221,Nesle-et-Massoult,21451,21,5,10,0,25,25,50,15
7222,Neuilly-lès-Dijon,21452,21,233,362,182,658,235,1075,595
7223,Nicey,21454,21,15,15,5,60,15,80,30
7224,Nod-sur-Seine,21455,21,35,30,35,95,15,145,65
7225,Nogent-lès-Montbard,21456,21,9,33,16,50,19,85,42
7226,Noidan,21457,21,7,19,6,27,9,42,26
7227,Noiron-sous-Gevrey,21458,21,38,382,73,254,288,615,420
7228,Noiron-sur-Bèze,21459,21,16,43,34,68,43,145,59
7229,Noiron-sur-Seine,21460,21,15,10,5,30,15,50,25
7230,Nolay,21461,21,223,270,219,453,165,837,493
7231,Norges-la-Ville,21462,21,78,181,78,305,146,529,259
7232,Normier,21463,21,10,15,0,25,5,30,25
7233,Nuits-Saint-Georges,21464,21,707,1242,718,1662,1043,3423,1949
7234,Obtrée,21465,21,15,15,0,20,15,35,30
7235,Oigny,21466,21,10,10,0,10,5,15,20
7236,Oisilly,21467,21,9,20,6,30,32,68,29
7237,Orain,21468,21,16,17,3,18,19,40,33
7238,Orgeux,21469,21,33,121,6,184,78,268,154
7239,Origny,21470,21,12,28,4,12,8,24,40
7240,Orret,21471,21,8,0,0,8,4,12,8
7241,Orville,21472,21,20,30,5,50,50,105,50
7242,Ouges,21473,21,85,197,62,320,151,533,282
7243,Pagny-la-Ville,21474,21,40,96,28,152,92,272,136
7244,Pagny-le-Château,21475,21,40,140,16,204,80,300,180
7245,Painblanc,21476,21,22,12,12,50,12,74,34
7246,Panges,21477,21,0,20,25,35,10,70,20
7247,Pasques,21478,21,16,53,19,115,42,176,69
7248,Pellerey,21479,21,17,25,16,12,20,48,42
7249,Pernand-Vergelesses,21480,21,53,20,45,105,25,175,73
7250,Perrigny-lès-Dijon,21481,21,143,362,228,679,255,1162,505
7251,Perrigny-sur-l'Ognon,21482,21,140,196,40,140,172,352,336
7252,Pichanges,21483,21,12,88,4,92,80,176,100
7253,Planay,21484,21,8,20,0,16,16,32,28
7254,Plombières-lès-Dijon,21485,21,257,565,272,927,519,1718,822
7255,Pluvault,21486,21,40,148,28,220,112,360,188
7256,Pluvet,21487,21,40,137,20,125,105,250,177
7257,Poinçon-lès-Larrey,21488,21,22,44,3,56,31,90,66
7258,Poiseul-la-Grange,21489,21,3,12,0,28,6,34,15
7259,Poiseul-la-Ville-et-Laperrière,21490,21,20,30,15,65,30,110,50
7260,Poiseul-lès-Saulx,21491,21,12,16,0,20,16,36,28
7261,Pommard,21492,21,109,100,69,144,88,301,209
7262,Poncey-lès-Athée,21493,21,80,168,48,120,144,312,248
7263,Poncey-sur-l'Ignon,21494,21,26,6,0,12,6,18,32
7264,Pont,21495,21,0,32,4,44,32,80,32
7265,Pontailler-sur-Saône,21496,21,167,305,97,418,193,708,472
7266,Pont-et-Massène,21497,21,10,45,3,83,26,112,55
7267,Posanges,21498,21,9,15,0,25,5,30,24
7268,Pothières,21499,21,12,72,16,52,60,128,84
7269,Pouillenay,21500,21,64,167,88,156,108,352,231
7270,Pouilly-en-Auxois,21501,21,269,320,85,475,234,794,589
7271,Pouilly-sur-Saône,21502,21,101,159,40,212,110,362,260
7272,Pouilly-sur-Vingeanne,21503,21,15,20,10,50,20,80,35
7273,Prâlon,21504,21,15,20,0,35,15,50,35
7274,Précy-sous-Thil,21505,21,116,172,72,248,112,432,288
7275,Premeaux-Prissey,21506,21,67,60,56,148,56,260,127
7276,Premières,21507,21,8,30,12,32,35,79,38
7277,Prenois,21508,21,12,87,47,124,68,239,99
7278,Prusly-sur-Ource,21510,21,12,13,22,80,10,112,25
7279,Puits,21511,21,30,20,5,55,15,75,50
7280,Puligny-Montrachet,21512,21,73,65,16,139,39,194,138
7281,Quemigny-Poisot,21513,21,25,40,20,84,30,134,65
7282,Quemigny-sur-Seine,21514,21,0,13,9,37,9,55,13
7283,Quetigny,21515,21,855,2340,995,3360,1750,6105,3195
7284,Quincerot,21516,21,9,19,3,18,15,36,28
7285,Quincey,21517,21,30,129,43,156,97,296,159
7286,Quincy-le-Vicomte,21518,21,12,28,12,97,26,135,40
7287,Recey-sur-Ource,21519,21,60,68,33,111,41,185,128
7288,Remilly-en-Montagne,21520,21,15,30,5,60,30,95,45
7289,Remilly-sur-Tille,21521,21,55,216,74,303,134,511,271
7290,Renève,21522,21,33,75,26,128,71,225,108
7291,Reulle-Vergy,21523,21,4,25,8,37,28,73,29
7292,Riel-les-Eaux,21524,21,13,20,4,37,12,53,33
7293,La Roche-en-Brenil,21525,21,175,190,25,345,150,520,365
7294,Rochefort-sur-Brévon,21526,21,10,0,0,20,0,20,10
7295,La Rochepot,21527,21,30,75,15,105,65,185,105
7296,La Roche-Vanneau,21528,21,35,35,5,40,35,80,70
7297,Roilly,21529,21,8,13,0,16,8,24,21
7298,Rougemont,21530,21,35,45,0,75,20,95,80
7299,Rouvray,21531,21,86,99,47,207,69,323,185
7300,Rouvres-en-Plaine,21532,21,64,295,100,358,224,682,359
7301,Rouvres-sous-Meilly,21533,21,22,10,3,25,9,37,32
7302,Ruffey-lès-Beaune,21534,21,68,172,48,240,136,424,240
7303,Ruffey-lès-Echirey,21535,21,120,335,135,450,240,825,455
7304,Sacquenay,21536,21,49,62,8,95,44,147,111
7305,Saffres,21537,21,15,15,5,45,20,70,30
7306,Saint-Andeux,21538,21,40,20,5,80,0,85,60
7307,Saint-Anthot,21539,21,4,24,0,28,16,44,28
7308,Saint-Apollinaire,21540,21,1038,1583,834,2339,1347,4520,2621
7309,Saint-Aubin,21541,21,40,61,0,55,76,131,101
7310,Saint-Bernard,21542,21,50,149,20,106,134,260,199
7311,Saint-Broing-les-Moines,21543,21,16,36,33,60,21,114,52
7312,Sainte-Colombe-en-Auxois,21544,21,4,12,13,24,4,41,16
7313,Sainte-Colombe-sur-Seine,21545,21,165,225,60,330,155,545,390
7314,Saint-Didier,21546,21,25,40,6,65,37,108,65
7315,Saint-Euphrône,21547,21,15,35,45,80,10,135,50
7316,Saint-Germain-de-Modéon,21548,21,52,21,4,28,27,59,73
7317,Saint-Germain-le-Rocheux,21549,21,10,20,5,45,10,60,30
7318,Saint-Germain-lès-Senailly,21550,21,24,20,8,24,16,48,44
7319,Saint-Hélier,21552,21,3,3,3,15,3,21,6
7320,Saint-Jean-de-Boeuf,21553,21,20,30,10,35,15,60,50
7321,Saint-Jean-de-Losne,21554,21,225,225,146,222,130,498,450
7322,Saint-Julien,21555,21,96,400,124,580,244,948,496
7323,Saint-Léger-Triey,21556,21,20,64,36,64,52,152,84
7324,Saint-Marc-sur-Seine,21557,21,10,15,0,60,10,70,25
7325,Sainte-Marie-la-Blanche,21558,21,76,218,32,360,142,534,294
7326,Sainte-Marie-sur-Ouche,21559,21,70,170,50,270,130,450,240
7327,Saint-Martin-de-la-Mer,21560,21,61,65,19,76,41,136,126
7328,Saint-Martin-du-Mont,21561,21,55,105,35,175,85,295,160
7329,Saint-Maurice-sur-Vingeanne,21562,21,40,80,20,50,50,120,120
7330,Saint-Mesmin,21563,21,15,25,15,25,40,80,40
7331,Saint-Nicolas-lès-Cîteaux,21564,21,20,100,26,125,70,221,120
7332,Saint-Philibert,21565,21,30,105,30,180,75,285,135
7333,Saint-Pierre-en-Vaux,21566,21,20,16,4,28,26,58,36
7334,Saint-Prix-lès-Arnay,21567,21,65,45,0,55,55,110,110
7335,Saint-Rémy,21568,21,122,134,33,275,116,424,256
7336,Saint-Romain,21569,21,40,65,10,90,15,115,105
7337,Sainte-Sabine,21570,21,45,41,4,53,37,94,86
7338,Saint-Sauveur,21571,21,30,75,20,85,55,160,105
7339,Saint-Seine-en-Bâche,21572,21,12,102,50,65,97,212,114
7340,Saint-Seine-l'Abbaye,21573,21,61,76,30,85,55,170,137
7341,Saint-Seine-sur-Vingeanne,21574,21,60,105,30,150,70,250,165
7342,Saint-Symphorien-sur-Saône,21575,21,15,55,25,185,60,270,70
7343,Saint-Thibault,21576,21,50,50,0,40,30,70,100
7344,Saint-Usage,21577,21,165,380,110,426,230,766,545
7345,Saint-Victor-sur-Ouche,21578,21,15,57,28,49,72,149,72
7346,Salives,21579,21,39,68,19,49,40,108,107
7347,Salmaise,21580,21,16,25,9,34,22,65,41
7348,Samerey,21581,21,25,50,20,55,15,90,75
7349,Santenay,21582,21,111,132,93,163,131,387,243
7350,Santosse,21583,21,4,13,13,8,12,33,17
7351,Saulieu,21584,21,465,460,286,720,367,1373,925
7352,Saulon-la-Chapelle,21585,21,136,233,106,320,203,629,369
7353,Saulon-la-Rue,21586,21,12,212,45,206,163,414,224
7354,Saulx-le-Duc,21587,21,40,65,5,80,50,135,105
7355,Saussey,21588,21,20,24,0,20,32,52,44
7356,Saussy,21589,21,0,21,8,36,13,57,21
7357,Savigny-lès-Beaune,21590,21,228,279,139,490,189,818,507
7358,Savigny-le-Sec,21591,21,72,220,28,340,172,540,292
7359,Savigny-sous-Mâlain,21592,21,12,51,12,50,47,109,63
7360,Savilly,21593,21,22,4,4,25,8,37,26
7361,Savoisy,21594,21,25,40,20,75,35,130,65
7362,Savolles,21595,21,12,41,4,36,34,74,53
7363,Savouges,21596,21,0,138,12,82,100,194,138
7364,Segrois,21597,21,5,25,0,30,10,40,30
7365,Seigny,21598,21,30,44,4,54,22,80,74
7366,Selongey,21599,21,218,708,201,726,496,1423,926
7367,Semarey,21600,21,20,35,8,33,12,53,55
7368,Semezanges,21601,21,4,20,5,35,30,70,24
7369,Semond,21602,21,5,0,0,25,0,25,5
7370,Semur-en-Auxois,21603,21,588,762,461,1332,601,2394,1350
7371,Senailly,21604,21,20,25,20,55,30,105,45
7372,Sennecey-lès-Dijon,21605,21,220,575,229,792,305,1326,795
7373,Ladoix-Serrigny,21606,21,200,520,150,585,380,1115,720
7374,Seurre,21607,21,444,470,282,743,315,1340,914
7375,Sincey-lès-Rouvray,21608,21,15,5,15,45,10,70,20
7376,Soirans,21609,21,20,148,40,148,104,292,168
7377,Soissons-sur-Nacey,21610,21,32,108,48,76,80,204,140
7378,Sombernon,21611,21,64,248,90,217,220,527,312
7379,Souhey,21612,21,15,15,15,45,10,70,30
7380,Soussey-sur-Brionne,21613,21,24,32,0,60,40,100,56
7381,Spoy,21614,21,24,90,32,60,81,173,114
7382,Sussey,21615,21,24,68,28,92,56,176,92
7383,Tailly,21616,21,20,30,10,90,40,140,50
7384,Talant,21617,21,1714,2428,1094,3887,1896,6877,4142
7385,Talmay,21618,21,105,136,38,150,94,282,241
7386,Tanay,21619,21,20,55,15,80,60,155,75
7387,Tarsul,21620,21,35,20,10,65,10,85,55
7388,Tart-l'Abbaye,21621,21,20,45,20,75,35,130,65
7389,Tart-le-Bas,21622,21,34,48,16,65,39,120,82
7390,Tart-le-Haut,21623,21,70,455,120,365,385,870,525
7391,Tellecey,21624,21,0,44,12,28,56,96,44
7392,Ternant,21625,21,12,15,6,22,9,37,27
7393,Terrefondrée,21626,21,10,10,5,20,10,35,20
7394,Thenissey,21627,21,28,36,4,40,16,60,64
7395,Thoires,21628,21,9,6,0,25,6,31,15
7396,Thoisy-la-Berchère,21629,21,64,100,16,84,64,164,164
7397,Thoisy-le-Désert,21630,21,29,57,4,59,39,102,86
7398,Thomirey,21631,21,7,12,0,13,9,22,19
7399,Thorey-en-Plaine,21632,21,64,345,81,328,281,690,409
7400,Thorey-sous-Charny,21633,21,33,14,16,64,15,95,47
7401,Thorey-sur-Ouche,21634,21,21,30,13,57,15,85,51
7402,Thoste,21635,21,15,20,0,50,20,70,35
7403,Thury,21636,21,90,70,20,75,45,140,160
7404,Tichey,21637,21,25,80,10,70,30,110,105
7405,Til-Châtel,21638,21,103,286,69,243,265,577,389
7406,Tillenay,21639,21,75,220,75,200,185,460,295
7407,Torcy-et-Pouligny,21640,21,20,36,28,76,20,124,56
7408,Touillon,21641,21,52,102,20,125,91,236,154
7409,Toutry,21642,21,70,105,35,175,50,260,175
7410,Tréclun,21643,21,16,142,21,112,120,253,158
7411,Trochères,21644,21,12,45,3,40,30,73,57
7412,Trouhans,21645,21,40,176,40,196,148,384,216
7413,Trouhaut,21646,21,16,28,4,44,24,72,44
7414,Trugny,21647,21,12,28,4,68,28,100,40
7415,Turcey,21648,21,36,56,20,52,36,108,92
7416,Uncey-le-Franc,21649,21,3,3,0,16,12,28,6
7417,Urcy,21650,21,5,50,0,55,45,100,55
7418,Val-Suzon,21651,21,28,48,24,60,52,136,76
7419,Vandenesse-en-Auxois,21652,21,20,58,16,98,52,166,78
7420,Vannaire,21653,21,0,20,0,20,20,40,20
7421,Vanvey,21655,21,64,30,24,61,12,97,94
7422,Varanges,21656,21,70,225,35,230,165,430,295
7423,Varois-et-Chaignot,21657,21,339,476,75,727,313,1115,815
7424,Vauchignon,21658,21,0,10,5,20,10,35,10
7425,Vaux-Saules,21659,21,30,50,15,65,20,100,80
7426,Veilly,21660,21,5,10,0,20,5,25,15
7427,Velars-sur-Ouche,21661,21,140,370,148,659,335,1142,510
7428,Velogny,21662,21,9,3,0,3,9,12,12
7429,Venarey-les-Laumes,21663,21,600,540,390,950,410,1750,1140
7430,Verdonnet,21664,21,28,16,4,28,8,40,44
7431,Vernois-lès-Vesvres,21665,21,10,45,10,50,55,115,55
7432,Vernot,21666,21,5,20,10,35,15,60,25
7433,Véronnes,21667,21,30,127,40,145,71,256,157
7434,Verrey-sous-Drée,21669,21,20,22,8,0,18,26,42
7435,Verrey-sous-Salmaise,21670,21,30,73,20,132,55,207,103
7436,Vertault,21671,21,4,0,0,20,8,28,4
7437,Vesvres,21672,21,4,0,9,8,4,21,4
7438,Veuvey-sur-Ouche,21673,21,20,75,30,65,35,130,95
7439,Veuxhaulles-sur-Aube,21674,21,36,64,12,92,44,148,100
7440,Vianges,21675,21,20,0,5,20,0,25,20
7441,Vic-de-Chassenay,21676,21,35,55,25,75,40,140,90
7442,Vic-des-Prés,21677,21,20,28,0,28,24,52,48
7443,Vic-sous-Thil,21678,21,56,44,4,56,28,88,100
7444,Vieilmoulin,21679,21,5,35,0,45,30,75,40
7445,Vielverge,21680,21,72,99,19,147,86,252,171
7446,Vieux-Château,21681,21,13,13,3,33,12,48,26
7447,Viévigne,21682,21,20,64,16,92,24,132,84
7448,Viévy,21683,21,74,95,19,152,35,206,169
7449,Vignoles,21684,21,25,255,50,355,180,585,280
7450,Villaines-en-Duesmois,21685,21,50,47,6,81,25,112,97
7451,Villaines-les-Prévôtes,21686,21,30,15,20,50,20,90,45
7452,Villargoix,21687,21,47,12,6,48,7,61,59
7453,Villars-Fontaine,21688,21,25,25,0,64,15,79,50
7454,Villars-et-Villenotte,21689,21,0,50,5,85,30,120,50
7455,Villeberny,21690,21,28,16,8,32,8,48,44
7456,Villebichot,21691,21,40,101,20,144,52,216,141
7457,Villecomte,21692,21,15,60,9,104,29,142,75
7458,Villedieu,21693,21,20,0,0,30,5,35,20
7459,Villeferry,21694,21,5,10,0,15,10,25,15
7460,La Villeneuve-les-Convers,21695,21,12,4,8,8,4,20,16
7461,Villeneuve-sous-Charigny,21696,21,13,12,0,21,15,36,25
7462,Villers-la-Faye,21698,21,48,108,32,148,76,256,156
7463,Villers-les-Pots,21699,21,88,305,68,312,278,658,393
7464,Villers-Patras,21700,21,20,24,4,36,20,60,44
7465,Villers-Rotin,21701,21,35,20,10,40,15,65,55
7466,Villey-sur-Tille,21702,21,9,71,9,89,59,157,80
7467,Villiers-en-Morvan,21703,21,20,12,4,8,4,16,32
7468,Villiers-le-Duc,21704,21,5,15,0,50,10,60,20
7469,Villotte-Saint-Seine,21705,21,0,4,12,20,8,40,4
7470,Villotte-sur-Ource,21706,21,8,20,4,56,12,72,28
7471,Villy-en-Auxois,21707,21,45,31,6,83,18,107,76
7472,Villy-le-Moutier,21708,21,24,104,32,100,80,212,128
7473,Viserny,21709,21,30,45,30,65,25,120,75
7474,Vitteaux,21710,21,85,187,110,299,124,533,272
7475,Vix,21711,21,10,20,10,45,35,90,30
7476,Volnay,21712,21,45,40,25,85,35,145,85
7477,Vonges,21713,21,10,96,35,125,81,241,106
7478,Vosne-Romanée,21714,21,90,85,35,120,40,195,175
7479,Voudenay,21715,21,58,27,9,43,24,76,85
7480,Vougeot,21716,21,35,40,20,50,45,115,75
7481,Voulaines-les-Templiers,21717,21,30,45,45,130,30,205,75
7482,Allineuc,22001,22,75,230,10,155,150,315,305
7483,Andel,22002,22,110,330,55,349,265,669,440
7484,Aucaleuc,22003,22,59,260,115,264,180,559,319
7485,Bégard,22004,22,735,1095,325,1530,775,2630,1830
7486,Belle-Isle-en-Terre,22005,22,183,196,60,362,193,615,379
7487,Berhet,22006,22,32,76,20,64,40,124,108
7488,Binic,22007,22,772,772,161,1349,623,2133,1544
7489,Bobital,22008,22,159,290,72,309,225,606,449
7490,Le Bodéo,22009,22,16,21,30,39,35,104,37
7491,Boqueho,22011,22,100,360,125,205,285,615,460
7492,La Bouillie,22012,22,97,221,47,267,149,463,318
7493,Bourbriac,22013,22,393,532,178,809,354,1341,925
7494,Bourseul,22014,22,119,273,67,355,198,620,392
7495,Bréhand,22015,22,218,445,161,396,338,895,663
7496,Île-de-Bréhat,22016,22,56,61,10,121,60,191,117
7497,Brélidy,22018,22,29,54,13,113,55,181,83
7498,Bringolo,22019,22,45,121,47,75,128,250,166
7499,Broons,22020,22,445,630,245,830,470,1545,1075
7500,Brusvily,22021,22,75,314,97,361,249,707,389
7501,Bulat-Pestivien,22023,22,75,100,10,180,55,245,175
7502,Calanhel,22024,22,56,32,20,76,24,120,88
7503,Callac,22025,22,635,282,85,751,245,1081,917
7504,Calorguen,22026,22,68,207,39,176,157,372,275
7505,Le Cambout,22027,22,120,85,35,165,50,250,205
7506,Camlez,22028,22,45,250,70,355,180,605,295
7507,Canihuel,22029,22,77,84,25,106,46,177,161
7508,Caouënnec-Lanvézéac,22030,22,60,256,60,252,232,544,316
7509,Carnoët,22031,22,103,131,66,228,102,396,234
7510,Caulnes,22032,22,405,568,183,651,448,1282,973
7511,Caurel,22033,22,90,85,15,100,85,200,175
7512,Cavan,22034,22,149,434,110,426,288,824,583
7513,Les Champs-Géraux,22035,22,136,235,71,367,154,592,371
7514,La Chapelle-Blanche,22036,22,29,58,0,60,25,85,87
7515,La Chapelle-Neuve,22037,22,68,96,28,164,80,272,164
7516,Châtelaudren,22038,22,192,146,110,226,160,496,338
7517,La Chèze,22039,22,110,115,20,260,60,340,225
7518,Coadout,22040,22,53,168,16,171,117,304,221
7519,Coatascorn,22041,22,16,64,25,61,47,133,80
7520,Coatréven,22042,22,44,132,48,172,88,308,176
7521,Coëtlogon,22043,22,60,52,24,72,32,128,112
7522,Coëtmieux,22044,22,113,549,104,548,405,1057,662
7523,Cohiniac,22045,22,35,89,61,136,55,252,124
7524,Le Mené,22046,22,1061,1503,512,2036,1032,3580,2564
7525,Corlay,22047,22,230,215,70,265,135,470,445
7526,Corseul,22048,22,204,569,185,782,444,1411,773
7527,Créhen,22049,22,232,319,65,590,228,883,551
7528,Dinan,22050,22,2062,1786,1114,3569,1578,6261,3848
7529,Duault,22052,22,60,70,25,145,50,220,130
7530,Éréac,22053,22,140,125,35,250,80,365,265
7531,Erquy,22054,22,1039,522,180,1675,388,2243,1561
7532,Étables-sur-Mer,22055,22,696,609,153,1077,434,1664,1305
7533,Évran,22056,22,300,350,125,560,280,965,650
7534,Le Faouët,22057,22,61,75,20,112,74,206,136
7535,Le Foeil,22059,22,160,445,145,455,270,870,605
7536,Gausson,22060,22,95,177,45,200,120,365,272
7537,Glomel,22061,22,264,300,120,532,204,856,564
7538,Gomené,22062,22,54,79,82,176,88,346,133
7539,Gommenec'h,22063,22,87,127,71,117,83,271,214
7540,Gouarec,22064,22,172,84,36,220,64,320,256
7541,Goudelin,22065,22,263,495,140,429,405,974,758
7542,Grâces,22067,22,439,496,128,1001,331,1460,935
7543,Grâce-Uzel,22068,22,85,95,45,114,84,243,180
7544,Guenroc,22069,22,40,35,16,46,42,104,75
7545,Guingamp,22070,22,1048,1487,1064,2158,976,4198,2535
7546,Guitté,22071,22,76,201,40,196,152,388,277
7547,Gurunhuel,22072,22,56,124,36,148,76,260,180
7548,La Harmoye,22073,22,35,90,32,138,40,210,125
7549,Le Haut-Corlay,22074,22,100,140,60,248,140,448,240
7550,Hémonstoir,22075,22,64,168,56,220,144,420,232
7551,Hénanbihen,22076,22,224,348,116,464,260,840,572
7552,Hénansal,22077,22,140,320,160,284,260,704,460
7553,Hengoat,22078,22,45,40,9,78,40,127,85
7554,Hénon,22079,22,194,638,122,564,543,1229,832
7555,Hillion,22081,22,549,965,302,1472,681,2455,1514
7556,Le Hinglé,22082,22,94,170,50,360,115,525,264
7557,Illifaut,22083,22,116,156,80,260,100,440,272
7558,Jugon-les-Lacs - Commune nouvelle,22084,22,297,654,203,686,524,1413,951
7559,Kerbors,22085,22,75,40,30,133,35,198,115
7560,Kerfot,22086,22,65,148,108,245,120,473,213
7561,Kergrist-Moëlou,22087,22,108,145,15,205,103,323,253
7562,Kerien,22088,22,32,68,20,64,76,160,100
7563,Kermaria-Sulard,22090,22,125,268,80,339,182,601,393
7564,Kermoroc'h,22091,22,20,155,15,115,130,260,175
7565,Kerpert,22092,22,40,60,25,90,55,170,100
7566,Lamballe,22093,22,1913,3080,1204,4380,2286,7870,4993
7567,Lancieux,22094,22,358,283,51,521,217,789,641
7568,Landebaëron,22095,22,20,40,10,70,35,115,60
7569,Landébia,22096,22,60,130,20,170,125,315,190
7570,La Landec,22097,22,48,240,56,204,196,456,288
7571,Landéhen,22098,22,124,441,164,384,264,812,565
7572,Lanfains,22099,22,124,328,40,320,268,628,452
7573,Langast,22100,22,135,150,25,195,115,335,285
7574,Langoat,22101,22,162,305,115,360,225,700,467
7575,Langrolay-sur-Rance,22103,22,53,258,71,303,156,530,311
7576,Languédias,22104,22,56,108,48,192,60,300,164
7577,Languenan,22105,22,92,332,112,392,240,744,424
7578,Langueux,22106,22,867,1644,620,2737,1297,4654,2511
7579,Laniscat,22107,22,227,135,25,252,90,367,362
7580,Lanleff,22108,22,16,20,4,33,30,67,36
7581,Lanloup,22109,22,48,26,36,92,25,153,74
7582,Lanmérin,22110,22,24,197,34,158,132,324,221
7583,Lanmodez,22111,22,105,75,30,165,50,245,180
7584,Lannebert,22112,22,60,112,48,156,80,284,172
7585,Lannion,22113,22,2574,4302,2111,6703,3173,11987,6876
7586,Lanrelas,22114,22,174,151,71,243,94,408,325
7587,Lanrivain,22115,22,75,101,25,220,47,292,176
7588,Lanrodec,22116,22,79,333,76,315,340,731,412
7589,Lantic,22117,22,150,500,120,555,310,985,650
7590,Lanvallay,22118,22,716,844,299,1326,631,2256,1560
7591,Lanvellec,22119,22,85,110,25,237,115,377,195
7592,Lanvollon,22121,22,242,387,131,492,313,936,629
7593,Laurenan,22122,22,132,168,32,268,124,424,300
7594,Léhon,22123,22,305,740,213,1240,429,1882,1045
7595,Lescouët-Gouarec,22124,22,21,44,8,79,28,115,65
7596,Le Leslay,22126,22,8,39,8,54,27,89,47
7597,Lézardrieux,22127,22,393,267,50,558,172,780,660
7598,Locarn,22128,22,47,77,23,150,69,242,124
7599,Loc-Envel,22129,22,20,0,0,21,8,29,20
7600,Loguivy-Plougras,22131,22,150,190,75,280,185,540,340
7601,Lohuec,22132,22,32,68,24,104,60,188,100
7602,Loscouët-sur-Meu,22133,22,96,164,36,220,124,380,260
7603,Louannec,22134,22,450,688,114,1269,486,1869,1138
7604,Louargat,22135,22,353,559,222,724,464,1410,912
7605,Loudéac,22136,22,1461,2047,1001,2928,1551,5480,3508
7606,Maël-Carhaix,22137,22,278,303,97,569,224,890,581
7607,Maël-Pestivien,22138,22,116,48,20,160,56,236,164
7608,Magoar,22139,22,30,15,5,25,15,45,45
7609,La Malhoure,22140,22,52,156,40,149,123,312,208
7610,Mantallot,22141,22,15,65,10,95,55,160,80
7611,Matignon,22143,22,400,280,116,568,220,904,680
7612,La Méaugon,22144,22,84,279,155,437,207,799,363
7613,Mégrit,22145,22,68,208,70,260,151,481,276
7614,Mellionnec,22146,22,32,78,22,136,80,238,110
7615,Merdrignac,22147,22,480,624,315,876,428,1619,1104
7616,Mérillac,22148,22,49,45,6,64,40,110,94
7617,Merléac,22149,22,96,108,52,172,48,272,204
7618,Le Merzer,22150,22,76,273,144,300,184,628,349
7619,Minihy-Tréguier,22152,22,116,252,68,492,160,720,368
7620,Moncontour,22153,22,142,90,60,170,30,260,232
7621,Morieux,22154,22,119,254,57,285,213,555,373
7622,La Motte,22155,22,240,508,164,740,408,1312,748
7623,Moustéru,22156,22,67,172,45,241,115,401,239
7624,Le Moustoir,22157,22,105,191,35,180,165,380,296
7625,Mûr-de-Bretagne,22158,22,512,390,140,685,255,1080,902
7626,Noyal,22160,22,115,220,44,315,160,519,335
7627,Pabu,22161,22,402,545,152,995,340,1487,947
7628,Paimpol,22162,22,1640,1117,606,2540,845,3991,2757
7629,Paule,22163,22,111,159,35,215,136,386,270
7630,Pédernec,22164,22,226,491,110,686,353,1149,717
7631,Penguily,22165,22,65,220,60,145,135,340,285
7632,Penvénan,22166,22,663,454,101,956,389,1446,1117
7633,Perret,22167,22,34,37,8,86,0,94,71
7634,Perros-Guirec,22168,22,1943,1047,445,2850,860,4155,2990
7635,Peumerit-Quintin,22169,22,20,44,8,72,32,112,64
7636,Plaine-Haute,22170,22,153,430,128,447,339,914,583
7637,Plaintel,22171,22,477,1078,362,1285,930,2577,1555
7638,Plancoët,22172,22,450,630,265,1080,480,1825,1080
7639,Planguenoual,22173,22,340,501,170,747,327,1244,841
7640,Pléboulle,22174,22,121,137,87,308,92,487,258
7641,Plédéliac,22175,22,162,315,138,463,272,873,477
7642,Plédran,22176,22,554,1764,694,2146,1314,4154,2318
7643,Pléguien,22177,22,122,378,63,415,254,732,500
7644,Pléhédel,22178,22,224,317,79,365,202,646,541
7645,Fréhel,22179,22,394,255,110,591,163,864,649
7646,Plélan-le-Petit,22180,22,248,455,210,526,385,1121,703
7647,Plélauff,22181,22,104,124,48,288,112,448,228
7648,Plélo,22182,22,377,1050,268,819,803,1890,1427
7649,Les Moulins,22183,22,551,920,227,1077,700,2004,1471
7650,Plémy,22184,22,224,402,182,413,271,866,626
7651,Plénée-Jugon,22185,22,372,580,196,694,407,1297,952
7652,Pléneuf-Val-André,22186,22,1061,685,163,1551,504,2218,1746
7653,Plérin,22187,22,2161,3133,1142,5215,2158,8515,5294
7654,Plerneuf,22188,22,124,282,128,272,214,614,406
7655,Plésidy,22189,22,45,200,60,180,145,385,245
7656,Pleslin-Trigavou,22190,22,442,955,237,1129,584,1950,1397
7657,Plessix-Balisson,22192,22,20,12,12,20,16,48,32
7658,Plestan,22193,22,216,377,184,448,322,954,593
7659,Plestin-les-Grèves,22194,22,685,625,200,1520,370,2090,1310
7660,Pleubian,22195,22,628,309,85,1041,256,1382,937
7661,Pleudaniel,22196,22,115,205,61,285,179,525,320
7662,Pleudihen-sur-Rance,22197,22,437,690,208,876,504,1588,1127
7663,Pleumeur-Bodou,22198,22,650,821,207,1729,557,2493,1471
7664,Pleumeur-Gautier,22199,22,138,296,92,456,158,706,434
7665,Pléven,22200,22,87,129,42,183,68,293,216
7666,Plévenon,22201,22,205,110,30,285,120,435,315
7667,Plévin,22202,22,126,156,53,217,153,423,282
7668,Ploeuc-L'Hermitage,22203,22,570,1030,395,1160,805,2360,1600
7669,Ploëzal,22204,22,228,272,92,456,192,740,500
7670,Plorec-sur-Arguenon,22205,22,84,96,28,124,72,224,180
7671,Plouagat,22206,22,342,770,305,798,530,1633,1112
7672,Plouaret,22207,22,410,425,180,765,305,1250,835
7673,Plouasne,22208,22,252,495,102,477,360,939,747
7674,Ploubalay,22209,22,496,690,215,1031,533,1779,1186
7675,Ploubazlanec,22210,22,673,467,197,1310,308,1815,1140
7676,Ploubezre,22211,22,450,960,230,1160,765,2155,1410
7677,Plouëc-du-Trieux,22212,22,151,250,93,408,168,669,401
7678,Plouër-sur-Rance,22213,22,325,955,288,1142,639,2069,1280
7679,Plouézec,22214,22,738,611,131,1289,418,1838,1349
7680,Ploufragan,22215,22,1539,2689,959,3966,1893,6818,4228
7681,Plougonver,22216,22,130,150,30,270,130,430,280
7682,Plougras,22217,22,55,90,30,175,65,270,145
7683,Plougrescant,22218,22,291,182,48,503,153,704,473
7684,Plouguenast,22219,22,310,390,175,595,330,1100,700
7685,Plouguernével,22220,22,255,285,115,695,265,1075,540
7686,Plouguiel,22221,22,329,395,98,642,309,1049,724
7687,Plouha,22222,22,1121,845,210,1680,507,2397,1966
7688,Plouisy,22223,22,225,440,240,710,245,1195,665
7689,Ploulec'h,22224,22,179,380,115,685,285,1085,559
7690,Ploumagoar,22225,22,634,1237,439,1709,932,3080,1871
7691,Ploumilliau,22226,22,428,553,149,804,443,1396,981
7692,Plounérin,22227,22,100,190,64,208,160,432,290
7693,Plounévez-Moëdec,22228,22,230,325,105,510,245,860,555
7694,Plounévez-Quintin,22229,22,193,250,85,395,160,640,443
7695,Plourac'h,22231,22,65,60,15,187,35,237,125
7696,Plourhan,22232,22,241,533,76,689,380,1145,774
7697,Plourivo,22233,22,309,521,140,855,373,1368,830
7698,Plouvara,22234,22,107,320,84,366,204,654,427
7699,Plouzélambre,22235,22,27,40,33,61,38,132,67
7700,Pludual,22236,22,140,175,65,220,130,415,315
7701,Pluduno,22237,22,322,560,200,725,355,1280,882
7702,Plufur,22238,22,70,100,65,215,90,370,170
7703,Plumaudan,22239,22,115,330,119,394,290,803,445
7704,Plumaugat,22240,22,199,212,70,393,199,662,411
7705,Plumieux,22241,22,125,225,45,441,185,671,350
7706,Plurien,22242,22,323,282,101,470,221,792,605
7707,Plusquellec,22243,22,130,105,40,200,65,305,235
7708,Plussulien,22244,22,86,79,45,160,65,270,165
7709,Pluzunet,22245,22,125,203,79,370,138,587,328
7710,Pommeret,22246,22,192,573,188,576,503,1267,765
7711,Pommerit-Jaudy,22247,22,143,320,135,315,218,668,463
7712,Pommerit-le-Vicomte,22248,22,260,397,95,628,266,989,657
7713,Pont-Melvez,22249,22,100,136,70,220,100,390,236
7714,Pontrieux,22250,22,240,185,60,297,99,456,425
7715,Pordic,22251,22,773,1743,479,2432,1272,4183,2516
7716,Pouldouran,22253,22,25,20,10,85,40,135,45
7717,Prat,22254,22,115,305,75,405,205,685,420
7718,La Prénessaye,22255,22,174,235,75,230,150,455,409
7719,Quemper-Guézennec,22256,22,200,252,120,368,204,692,452
7720,Quemperven,22257,22,40,95,50,125,60,235,135
7721,Quessoy,22258,22,414,994,487,1109,713,2309,1408
7722,Quévert,22259,22,650,870,170,1325,685,2180,1520
7723,Le Quillio,22260,22,100,120,55,135,60,250,220
7724,Quintenic,22261,22,25,113,25,85,85,195,138
7725,Quintin,22262,22,454,606,226,803,434,1463,1060
7726,Le Quiou,22263,22,50,60,30,95,75,200,110
7727,La Roche-Derrien,22264,22,192,217,95,297,118,510,409
7728,Rospez,22265,22,176,472,116,620,364,1100,648
7729,Rostrenen,22266,22,619,463,256,1072,350,1678,1082
7730,Rouillac,22267,22,60,98,20,112,92,224,158
7731,Ruca,22268,22,100,148,16,191,102,309,248
7732,Runan,22269,22,44,37,9,63,36,108,81
7733,Saint-Adrien,22271,22,28,96,16,140,76,232,124
7734,Saint-Agathon,22272,22,192,579,176,750,372,1298,771
7735,Saint-Alban,22273,22,260,526,89,680,469,1238,786
7736,Saint-André-des-Eaux,22274,22,40,79,33,61,72,166,119
7737,Saint-Barnabé,22275,22,102,294,92,480,191,763,396
7738,Saint-Bihy,22276,22,25,75,16,60,44,120,100
7739,Saint-Brandan,22277,22,265,635,260,796,440,1496,900
7740,Saint-Brieuc,22278,22,6722,10365,5547,12951,7509,26007,17087
7741,Saint-Caradec,22279,22,165,310,95,406,160,661,475
7742,Saint-Carné,22280,22,97,244,85,297,207,589,341
7743,Saint-Carreuc,22281,22,119,374,157,408,334,899,493
7744,Saint-Cast-le-Guildo,22282,22,881,462,207,1358,395,1960,1343
7745,Saint-Clet,22283,22,176,200,30,234,244,508,376
7746,Saint-Connan,22284,22,65,45,20,135,45,200,110
7747,Saint-Connec,22285,22,45,35,40,90,25,155,80
7748,Saint-Denoual,22286,22,28,108,40,136,96,272,136
7749,Saint-Donan,22287,22,152,370,114,476,266,856,522
7750,Saint-Étienne-du-Gué-de-l'Isle,22288,22,60,65,25,140,70,235,125
7751,Saint-Fiacre,22289,22,30,40,20,85,40,145,70
7752,Saint-Gelven,22290,22,52,56,28,132,56,216,108
7753,Saint-Gildas,22291,22,69,65,5,55,65,125,134
7754,Saint-Gilles-les-Bois,22293,22,55,84,59,112,63,234,139
7755,Saint-Gilles-Pligeaux,22294,22,75,65,39,74,50,163,140
7756,Saint-Gilles-Vieux-Marché,22295,22,38,50,21,133,52,206,88
7757,Saint-Glen,22296,22,104,120,75,238,70,383,224
7758,Saint-Guen,22298,22,105,96,28,91,88,207,201
7759,Saint-Hélen,22299,22,148,417,70,398,308,776,565
7760,Saint-Hervé,22300,22,24,104,44,168,72,284,128
7761,Saint-Jacut-de-la-Mer,22302,22,228,104,40,339,80,459,332
7762,Saint-Jean-Kerdaniel,22304,22,4,188,60,112,163,335,192
7763,Saint-Jouan-de-l'Isle,22305,22,34,184,16,113,136,265,218
7764,Saint-Judoce,22306,22,60,140,50,235,80,365,200
7765,Saint-Julien,22307,22,200,565,133,744,417,1294,765
7766,Saint-Juvat,22308,22,64,150,54,210,170,434,214
7767,Saint-Launeuc,22309,22,45,30,5,40,70,115,75
7768,Saint-Laurent,22310,22,50,121,25,218,65,308,171
7769,Saint-Lormel,22311,22,115,190,65,360,130,555,305
7770,Saint-Maden,22312,22,16,50,29,54,36,119,66
7771,Saint-Martin-des-Prés,22313,22,55,75,30,110,65,205,130
7772,Saint-Maudan,22314,22,40,135,30,145,80,255,175
7773,Saint-Maudez,22315,22,20,88,12,72,100,184,108
7774,Saint-Mayeux,22316,22,85,110,15,155,85,255,195
7775,Saint-Méloir-des-Bois,22317,22,45,70,20,90,40,150,115
7776,Saint-Michel-de-Plélan,22318,22,48,100,32,84,80,196,148
7777,Saint-Michel-en-Grève,22319,22,65,60,43,172,58,273,125
7778,Saint-Nicodème,22320,22,35,25,0,70,25,95,60
7779,Saint-Nicolas-du-Pélem,22321,22,355,320,125,570,235,930,675
7780,Saint-Péver,22322,22,60,112,24,112,88,224,172
7781,Saint-Pôtan,22323,22,103,174,63,273,129,465,277
7782,Saint-Quay-Perros,22324,22,210,294,60,604,174,838,504
7783,Saint-Quay-Portrieux,22325,22,819,455,150,1113,310,1573,1274
7784,Saint-Rieul,22326,22,48,131,56,192,80,328,179
7785,Saint-Samson-sur-Rance,22327,22,124,436,108,552,316,976,560
7786,Saint-Servais,22328,22,60,72,32,168,84,284,132
7787,Saint-Thélo,22330,22,50,125,40,125,80,245,175
7788,Sainte-Tréphine,22331,22,35,35,10,80,15,105,70
7789,Saint-Trimoël,22332,22,47,160,37,111,115,263,207
7790,Saint-Vran,22333,22,60,195,45,295,125,465,255
7791,Saint-Igeaux,22334,22,15,25,15,85,10,110,40
7792,Senven-Léhart,22335,22,30,50,15,90,45,150,80
7793,Sévignac,22337,22,155,315,80,405,160,645,470
7794,Squiffiec,22338,22,92,232,64,268,144,476,324
7795,Taden,22339,22,284,544,236,770,434,1440,828
7796,Tonquédec,22340,22,93,282,104,425,270,799,375
7797,Tramain,22341,22,70,168,96,130,139,365,238
7798,Trébédan,22342,22,30,113,40,107,105,252,143
7799,Trébeurden,22343,22,810,630,155,1392,497,2044,1440
7800,Trébrivan,22344,22,103,140,41,188,111,340,243
7801,Trébry,22345,22,101,210,100,313,112,525,311
7802,Trédaniel,22346,22,119,269,50,266,171,487,388
7803,Trédarzec,22347,22,208,280,60,382,185,627,488
7804,Trédias,22348,22,90,125,45,155,70,270,215
7805,Trédrez-Locquémeau,22349,22,244,300,76,600,220,896,544
7806,Tréduder,22350,22,24,31,22,57,27,106,55
7807,Treffrin,22351,22,72,144,28,224,104,356,216
7808,Tréfumel,22352,22,58,56,39,87,17,143,114
7809,Trégastel,22353,22,571,404,127,938,333,1398,975
7810,Tréglamus,22354,22,48,248,100,352,228,680,296
7811,Trégomeur,22356,22,108,296,100,212,228,540,404
7812,Trégon,22357,22,38,57,8,61,67,136,95
7813,Trégonneau,22358,22,46,156,44,172,94,310,202
7814,Trégrom,22359,22,35,83,33,120,66,219,118
7815,Trégueux,22360,22,1306,2018,728,2798,1241,4767,3324
7816,Tréguidel,22361,22,48,115,85,200,93,378,163
7817,Tréguier,22362,22,436,399,181,713,257,1151,835
7818,Trélévern,22363,22,271,204,50,562,154,766,475
7819,Trélivan,22364,22,255,620,270,967,440,1677,875
7820,Trémargat,22365,22,7,30,25,65,12,102,37
7821,Trémel,22366,22,92,84,44,140,60,244,176
7822,Tréméreuc,22368,22,60,195,35,245,179,459,255
7823,Trémeur,22369,22,87,176,64,222,128,414,263
7824,Tréméven,22370,22,40,100,20,120,70,210,140
7825,Trémorel,22371,22,111,293,128,358,205,691,404
7826,Trémuson,22372,22,239,462,215,584,351,1150,701
7827,Tréogan,22373,22,20,8,0,52,16,68,28
7828,Tressignaux,22375,22,56,173,52,192,170,414,229
7829,Trévé,22376,22,147,452,116,516,341,973,599
7830,Tréveneuc,22377,22,130,134,40,353,94,487,264
7831,Trévérec,22378,22,28,68,4,52,72,128,96
7832,Trévou-Tréguignec,22379,22,302,250,65,490,170,725,552
7833,Trévron,22380,22,80,170,95,255,110,460,250
7834,Trézény,22381,22,30,80,40,135,60,235,110
7835,Troguéry,22383,22,34,76,15,55,47,117,110
7836,Uzel,22384,22,246,258,60,328,165,553,504
7837,La Vicomté-sur-Rance,22385,22,105,314,33,337,197,567,419
7838,Le Vieux-Bourg,22386,22,96,220,60,252,144,456,316
7839,Le Vieux-Marché,22387,22,190,313,85,520,223,828,503
7840,Vildé-Guingalan,22388,22,110,375,75,420,260,755,485
7841,Yffiniac,22389,22,429,1352,596,1511,1083,3190,1781
7842,Yvias,22390,22,116,192,32,252,172,456,308
7843,Yvignac-la-Tour,22391,22,145,292,124,368,243,735,437
7844,Ahun,23001,23,286,280,155,423,210,788,566
7845,Ajain,23002,23,126,242,75,278,166,519,368
7846,Alleyrat,23003,23,36,24,8,52,16,76,60
7847,Anzême,23004,23,66,108,63,173,88,324,174
7848,Arfeuille-Châtain,23005,23,13,16,0,82,20,102,29
7849,Arrènes,23006,23,55,20,15,120,10,145,75
7850,Ars,23007,23,44,36,12,120,40,172,80
7851,Aubusson,23008,23,640,442,298,1363,455,2116,1082
7852,Auge,23009,23,24,36,16,20,20,56,60
7853,Augères,23010,23,40,10,5,60,10,75,50
7854,Aulon,23011,23,65,15,15,75,5,95,80
7855,Auriat,23012,23,18,3,3,60,3,66,21
7856,Auzances,23013,23,234,197,80,423,153,656,431
7857,Azat-Châtenet,23014,23,40,13,0,18,20,38,53
7858,Azerables,23015,23,208,105,45,310,105,460,313
7859,Banize,23016,23,20,35,10,95,25,130,55
7860,Basville,23017,23,35,15,0,80,10,90,50
7861,Bazelat,23018,23,84,68,16,96,36,148,152
7862,Beissat,23019,23,0,0,0,15,0,15,0
7863,Bellegarde-en-Marche,23020,23,69,40,8,123,34,165,109
7864,Bénévent-l'Abbaye,23021,23,152,156,32,276,132,440,308
7865,Bétête,23022,23,51,56,24,147,45,216,107
7866,Blaudeix,23023,23,25,10,0,45,10,55,35
7867,Blessac,23024,23,70,105,40,260,55,355,175
7868,Bonnat,23025,23,248,240,75,473,180,728,488
7869,Bord-Saint-Georges,23026,23,50,55,15,190,40,245,105
7870,Bosmoreau-les-Mines,23027,23,45,50,10,133,35,178,95
7871,Bosroger,23028,23,10,20,25,25,25,75,30
7872,Le Bourg-d'Hem,23029,23,30,40,10,110,20,140,70
7873,Bourganeuf,23030,23,424,537,218,847,334,1399,961
7874,Boussac,23031,23,290,190,59,417,175,651,480
7875,Boussac-Bourg,23032,23,118,134,36,317,90,443,252
7876,La Brionne,23033,23,35,95,30,160,100,290,130
7877,Brousse,23034,23,0,13,0,12,8,20,13
7878,Budelière,23035,23,89,126,48,197,100,345,215
7879,Bussière-Dunoise,23036,23,204,200,38,340,128,506,404
7880,Bussière-Nouvelle,23037,23,9,12,3,36,12,51,21
7881,Bussière-Saint-Georges,23038,23,48,44,4,88,48,140,92
7882,La Celle-Dunoise,23039,23,143,60,25,248,70,343,203
7883,La Celle-sous-Gouzon,23040,23,4,40,4,54,29,87,44
7884,La Cellette,23041,23,48,12,4,152,36,192,60
7885,Ceyroux,23042,23,30,20,5,45,20,70,50
7886,Chamberaud,23043,23,8,20,8,26,16,50,28
7887,Chambon-Sainte-Croix,23044,23,25,25,5,20,10,35,50
7888,Chambon-sur-Voueize,23045,23,189,166,28,283,103,414,355
7889,Chambonchard,23046,23,30,23,15,14,14,43,53
7890,Chamborand,23047,23,60,40,4,96,44,144,100
7891,Champagnat,23048,23,114,110,25,119,105,249,224
7892,Champsanglard,23049,23,33,28,26,79,26,131,61
7893,La Chapelle-Baloue,23050,23,25,20,5,50,25,80,45
7894,La Chapelle-Saint-Martial,23051,23,5,20,15,35,25,75,25
7895,La Chapelle-Taillefert,23052,23,41,77,17,96,69,182,118
7896,Chard,23053,23,35,35,10,80,30,120,70
7897,Charron,23054,23,64,22,17,54,37,108,86
7898,Châtelard,23055,23,6,7,7,10,3,20,13
7899,Châtelus-le-Marcheix,23056,23,48,40,28,200,28,256,88
7900,Châtelus-Malvaleix,23057,23,108,124,44,184,84,312,232
7901,Le Chauchet,23058,23,20,60,10,40,10,60,80
7902,La Chaussade,23059,23,12,29,3,21,34,58,41
7903,Chavanat,23060,23,12,16,0,57,28,85,28
7904,Chénérailles,23061,23,160,132,76,284,108,468,292
7905,Chéniers,23062,23,120,75,25,264,79,368,195
7906,Clairavaux,23063,23,55,5,5,60,15,80,60
7907,Clugnat,23064,23,135,110,35,275,65,375,245
7908,Colondannes,23065,23,55,40,20,110,55,185,95
7909,Le Compas,23066,23,70,40,25,65,25,115,110
7910,La Courtine,23067,23,92,83,66,242,57,365,175
7911,Cressat,23068,23,95,95,50,200,95,345,190
7912,Crocq,23069,23,90,35,8,151,57,216,125
7913,Crozant,23070,23,164,32,12,212,40,264,196
7914,Croze,23071,23,16,48,16,84,36,136,64
7915,Domeyrot,23072,23,27,13,13,99,15,127,40
7916,Dontreix,23073,23,96,67,22,154,35,211,163
7917,Le Donzeil,23074,23,46,16,13,43,24,80,62
7918,Dun-le-Palestel,23075,23,270,195,85,368,140,593,465
7919,Évaux-les-Bains,23076,23,294,238,93,469,126,688,532
7920,Faux-la-Montagne,23077,23,62,69,44,119,52,215,131
7921,Faux-Mazuras,23078,23,16,28,12,88,20,120,44
7922,Felletin,23079,23,274,266,199,464,208,871,540
7923,Féniers,23080,23,35,8,0,21,16,37,43
7924,Flayat,23081,23,90,60,15,140,30,185,150
7925,Fleurat,23082,23,24,57,12,90,70,172,81
7926,Fontanières,23083,23,44,56,12,112,36,160,100
7927,La Forêt-du-Temple,23084,23,25,12,12,51,4,67,37
7928,Fransèches,23086,23,46,26,6,85,39,130,72
7929,Fresselines,23087,23,159,90,18,166,54,238,249
7930,Gartempe,23088,23,35,25,30,35,0,65,60
7931,Genouillac,23089,23,151,140,45,238,112,395,291
7932,Gentioux-Pigerolles,23090,23,45,90,45,134,75,254,135
7933,Gioux,23091,23,31,57,6,29,29,64,88
7934,Glénic,23092,23,104,124,40,236,116,392,228
7935,Gouzon,23093,23,270,299,145,544,250,939,569
7936,Le Grand-Bourg,23095,23,224,194,74,467,194,735,418
7937,Guéret,23096,23,2053,2432,1642,4435,2054,8131,4485
7938,Issoudun-Létrieix,23097,23,52,44,32,112,60,204,96
7939,Jalesches,23098,23,16,4,4,56,4,64,20
7940,Janaillat,23099,23,55,60,20,130,55,205,115
7941,Jarnages,23100,23,76,88,56,188,84,328,164
7942,Jouillat,23101,23,57,98,40,124,67,231,155
7943,Ladapeyre,23102,23,49,57,32,107,59,198,106
7944,Lafat,23103,23,70,45,15,145,60,220,115
7945,Lavaufranche,23104,23,75,65,20,70,30,120,140
7946,Lavaveix-les-Mines,23105,23,200,120,55,254,80,389,320
7947,Lépaud,23106,23,45,90,45,104,90,239,135
7948,Lépinas,23107,23,36,12,6,56,9,71,48
7949,Leyrat,23108,23,17,24,6,62,9,77,41
7950,Linard,23109,23,34,30,5,65,30,100,64
7951,Lioux-les-Monges,23110,23,8,12,4,24,4,32,20
7952,Lizières,23111,23,60,50,20,90,40,150,110
7953,Lourdoueix-Saint-Pierre,23112,23,145,120,25,405,100,530,265
7954,Lupersat,23113,23,61,34,13,119,56,188,95
7955,Lussat,23114,23,79,80,44,160,42,246,159
7956,Magnat-l'Étrange,23115,23,27,47,9,77,22,108,74
7957,Mainsat,23116,23,145,65,15,185,95,295,210
7958,Maison-Feyne,23117,23,16,48,12,103,75,190,64
7959,Maisonnisses,23118,23,60,12,20,76,40,136,72
7960,Malleret,23119,23,16,0,0,16,0,16,16
7961,Malleret-Boussac,23120,23,60,35,5,85,15,105,95
7962,Malval,23121,23,16,3,0,9,3,12,19
7963,Mansat-la-Courrière,23122,23,16,12,24,40,8,72,28
7964,Les Mars,23123,23,40,25,25,65,40,130,65
7965,Marsac,23124,23,170,120,30,205,75,310,290
7966,Le Mas-d'Artige,23125,23,29,17,6,16,13,35,46
7967,Masbaraud-Mérignat,23126,23,41,67,26,132,39,197,108
7968,Mautes,23127,23,40,45,25,85,20,130,85
7969,Mazeirat,23128,23,36,32,4,28,40,72,68
7970,La Mazière-aux-Bons-Hommes,23129,23,16,8,12,20,4,36,24
7971,Méasnes,23130,23,132,85,25,228,65,318,217
7972,Mérinchal,23131,23,184,124,56,240,124,420,308
7973,Montaigut-le-Blanc,23132,23,88,55,33,132,47,212,143
7974,Montboucher,23133,23,70,55,35,145,40,220,125
7975,Le Monteil-au-Vicomte,23134,23,50,30,5,50,25,80,80
7976,Mortroux,23136,23,41,55,6,100,43,149,96
7977,Mourioux-Vieilleville,23137,23,102,80,25,171,60,256,182
7978,Moutier-d'Ahun,23138,23,25,25,20,63,16,99,50
7979,Moutier-Malcard,23139,23,107,33,27,228,54,309,140
7980,Moutier-Rozeille,23140,23,75,60,25,215,45,285,135
7981,Naillat,23141,23,112,128,48,256,120,424,240
7982,Néoux,23142,23,30,50,25,135,55,215,80
7983,Noth,23143,23,56,100,52,196,80,328,156
7984,La Nouaille,23144,23,90,50,5,85,20,110,140
7985,Nouhant,23145,23,48,60,16,108,80,204,108
7986,Nouzerines,23146,23,51,45,8,81,44,133,96
7987,Nouzerolles,23147,23,24,20,4,20,32,56,44
7988,Nouziers,23148,23,56,35,13,85,30,128,91
7989,Parsac-Rimondeix,23149,23,96,132,80,249,112,441,228
7990,Peyrabout,23150,23,28,20,20,37,16,73,48
7991,Peyrat-la-Nonière,23151,23,104,75,33,149,80,262,179
7992,Pierrefitte,23152,23,0,12,6,21,19,46,12
7993,Pionnat,23154,23,139,180,55,250,130,435,319
7994,Pontarion,23155,23,76,72,44,140,52,236,148
7995,Pontcharraud,23156,23,20,8,0,24,4,28,28
7996,La Pouge,23157,23,34,20,0,45,0,45,54
7997,Poussanges,23158,23,29,16,4,56,16,76,45
7998,Puy-Malsignat,23159,23,22,23,6,63,19,88,45
7999,Reterre,23160,23,55,35,45,110,55,210,90
8000,Roches,23162,23,60,65,30,130,55,215,125
8001,Rougnat,23164,23,150,95,20,175,75,270,245
8002,Royère-de-Vassivière,23165,23,65,101,60,195,75,330,166
8003,Sagnat,23166,23,65,35,30,60,25,115,100
8004,Sannat,23167,23,80,84,16,123,84,223,164
8005,Sardent,23168,23,189,114,41,245,103,389,303
8006,La Saunière,23169,23,85,130,55,195,135,385,215
8007,Savennes,23170,23,6,40,9,106,32,147,46
8008,Sermur,23171,23,24,12,12,40,8,60,36
8009,La Serre-Bussière-Vieille,23172,23,20,25,0,55,25,80,45
8010,Soubrebost,23173,23,21,25,4,33,24,61,46
8011,Soumans,23174,23,132,152,40,168,116,324,284
8012,Sous-Parsat,23175,23,20,26,5,40,25,70,46
8013,La Souterraine,23176,23,1117,1008,518,1669,724,2911,2125
8014,Saint-Agnant-de-Versillat,23177,23,160,250,28,373,202,603,410
8015,Saint-Agnant-près-Crocq,23178,23,38,30,12,44,32,88,68
8016,Saint-Alpinien,23179,23,50,35,20,115,50,185,85
8017,Saint-Amand,23180,23,50,105,45,185,120,350,155
8018,Saint-Amand-Jartoudeix,23181,23,50,14,5,94,20,119,64
8019,Saint-Avit-de-Tardes,23182,23,10,30,15,95,20,130,40
8020,Saint-Avit-le-Pauvre,23183,23,12,12,8,44,4,56,24
8021,Saint-Bard,23184,23,19,15,3,21,16,40,34
8022,Saint-Chabrais,23185,23,55,51,5,131,62,198,106
8023,Saint-Christophe,23186,23,8,29,12,43,20,75,37
8024,Saint-Dizier-la-Tour,23187,23,52,21,35,73,21,129,73
8025,Saint-Dizier-les-Domaines,23188,23,52,28,0,84,12,96,80
8026,Saint-Dizier-Leyrenne,23189,23,124,150,39,347,123,509,274
8027,Saint-Domet,23190,23,40,41,16,44,8,68,81
8028,Saint-Éloi,23191,23,8,62,12,91,16,119,70
8029,Saint-Étienne-de-Fursac,23192,23,163,108,32,235,93,360,271
8030,Sainte-Feyre,23193,23,215,496,152,1047,452,1651,711
8031,Sainte-Feyre-la-Montagne,23194,23,25,20,25,70,5,100,45
8032,Saint-Fiel,23195,23,140,240,96,360,188,644,380
8033,Saint-Frion,23196,23,28,75,33,68,40,141,103
8034,Saint-Georges-la-Pouge,23197,23,84,84,8,100,88,196,168
8035,Saint-Georges-Nigremont,23198,23,35,10,25,52,10,87,45
8036,Saint-Germain-Beaupré,23199,23,70,105,30,165,80,275,175
8037,Saint-Goussaud,23200,23,40,30,20,60,25,105,70
8038,Saint-Hilaire-la-Plaine,23201,23,35,52,8,46,31,85,87
8039,Saint-Hilaire-le-Château,23202,23,34,23,16,89,30,135,57
8040,Saint-Julien-la-Genête,23203,23,44,56,0,88,44,132,100
8041,Saint-Julien-le-Châtel,23204,23,29,19,19,41,6,66,48
8042,Saint-Junien-la-Bregère,23205,23,29,30,8,43,24,75,59
8043,Saint-Laurent,23206,23,88,140,64,224,144,432,228
8044,Saint-Léger-Bridereix,23207,23,25,45,10,65,40,115,70
8045,Saint-Léger-le-Guérétois,23208,23,20,115,30,195,80,305,135
8046,Saint-Loup,23209,23,32,24,8,80,32,120,56
8047,Saint-Maixant,23210,23,60,36,16,80,28,124,96
8048,Saint-Marc-à-Frongier,23211,23,68,78,12,159,44,215,146
8049,Saint-Marc-à-Loubaud,23212,23,20,30,10,60,15,85,50
8050,Saint-Marien,23213,23,30,40,25,80,35,140,70
8051,Saint-Martial-le-Mont,23214,23,38,38,12,103,21,136,76
8052,Saint-Martial-le-Vieux,23215,23,12,26,4,52,17,73,38
8053,Saint-Martin-Château,23216,23,35,20,0,65,25,90,55
8054,Saint-Martin-Sainte-Catherine,23217,23,41,51,16,144,36,196,92
8055,Saint-Maurice-près-Crocq,23218,23,30,9,3,28,6,37,39
8056,Saint-Maurice-la-Souterraine,23219,23,175,280,90,415,250,755,455
8057,Saint-Médard-la-Rochette,23220,23,134,95,45,225,65,335,229
8058,Saint-Merd-la-Breuille,23221,23,50,37,3,51,34,88,87
8059,Saint-Michel-de-Veisse,23222,23,15,30,10,60,35,105,45
8060,Saint-Moreil,23223,23,34,45,0,125,20,145,79
8061,Saint-Oradoux-de-Chirouze,23224,23,15,0,0,40,0,40,15
8062,Saint-Oradoux-près-Crocq,23225,23,25,15,15,40,15,70,40
8063,Saint-Pardoux-d'Arnet,23226,23,44,20,24,68,12,104,64
8064,Saint-Pardoux-Morterolles,23227,23,45,15,15,115,5,135,60
8065,Saint-Pardoux-le-Neuf,23228,23,21,18,16,55,24,95,39
8066,Saint-Pardoux-les-Cards,23229,23,55,44,15,102,43,160,99
8067,Saint-Pierre-Chérignat,23230,23,35,20,25,65,25,115,55
8068,Saint-Pierre-de-Fursac,23231,23,208,109,49,277,54,380,317
8069,Saint-Pierre-Bellevue,23232,23,52,36,8,88,28,124,88
8070,Saint-Pierre-le-Bost,23233,23,45,15,0,50,10,60,60
8071,Saint-Priest,23234,23,35,15,15,50,35,100,50
8072,Saint-Priest-la-Feuille,23235,23,100,162,50,302,146,498,262
8073,Saint-Priest-la-Plaine,23236,23,76,40,4,87,26,117,116
8074,Saint-Priest-Palus,23237,23,10,0,0,25,0,25,10
8075,Saint-Quentin-la-Chabanne,23238,23,75,67,12,134,57,203,142
8076,Saint-Sébastien,23239,23,145,135,40,240,95,375,280
8077,Saint-Silvain-Bas-le-Roc,23240,23,66,86,10,178,80,268,152
8078,Saint-Silvain-Bellegarde,23241,23,20,28,12,108,36,156,48
8079,Saint-Silvain-Montaigut,23242,23,16,20,25,100,16,141,36
8080,Saint-Silvain-sous-Toulx,23243,23,32,24,4,45,16,65,56
8081,Saint-Sulpice-le-Dunois,23244,23,155,110,35,250,100,385,265
8082,Saint-Sulpice-le-Guérétois,23245,23,244,392,168,820,336,1324,636
8083,Saint-Sulpice-les-Champs,23246,23,50,80,15,150,60,225,130
8084,Saint-Vaury,23247,23,336,370,80,636,260,976,706
8085,Saint-Victor-en-Marche,23248,23,60,90,55,125,65,245,150
8086,Saint-Yrieix-la-Montagne,23249,23,58,29,4,65,39,108,87
8087,Saint-Yrieix-les-Bois,23250,23,40,65,25,100,55,180,105
8088,Tardes,23251,23,50,35,0,40,30,70,85
8089,Tercillat,23252,23,44,13,6,62,6,74,57
8090,Thauron,23253,23,42,30,13,37,26,76,72
8091,Toulx-Sainte-Croix,23254,23,55,10,10,150,45,205,65
8092,Trois-Fonds,23255,23,12,20,12,52,16,80,32
8093,Vallière,23257,23,171,126,45,325,80,450,297
8094,Vareilles,23258,23,32,84,36,104,60,200,116
8095,Verneiges,23259,23,15,30,15,38,20,73,45
8096,Vidaillat,23260,23,55,15,5,45,25,75,70
8097,Viersat,23261,23,60,75,15,90,80,185,135
8098,Vigeville,23262,23,8,32,20,80,20,120,40
8099,Villard,23263,23,72,72,23,118,50,191,144
8100,La Villedieu,23264,23,0,5,10,30,0,40,5
8101,La Villeneuve,23265,23,10,16,0,30,10,40,26
8102,La Villetelle,23266,23,20,40,12,52,36,100,60
8103,Abjat-sur-Bandiat,24001,24,178,81,45,237,66,348,259
8104,Agonac,24002,24,190,365,145,703,270,1118,555
8105,Ajat,24004,24,48,64,24,128,64,216,112
8106,Alles-sur-Dordogne,24005,24,88,76,28,129,60,217,164
8107,Allas-les-Mines,24006,24,29,39,12,50,30,92,68
8108,Allemans,24007,24,125,102,10,238,71,319,227
8109,Angoisse,24008,24,96,148,68,180,128,376,244
8110,Anlhiac,24009,24,70,30,15,110,40,165,100
8111,Annesse-et-Beaulieu,24010,24,128,348,80,476,320,876,476
8112,Antonne-et-Trigonant,24011,24,118,213,60,398,148,606,331
8113,Archignac,24012,24,36,80,28,100,80,208,116
8114,Aubas,24014,24,64,156,44,212,152,408,220
8115,Audrix,24015,24,31,52,22,100,32,154,83
8116,Augignac,24016,24,155,135,20,395,120,535,290
8117,Auriac-du-Périgord,24018,24,75,60,20,181,65,266,135
8118,Azerat,24019,24,56,60,40,208,60,308,116
8119,La Bachellerie,24020,24,140,225,40,350,135,525,365
8120,Badefols-d'Ans,24021,24,97,58,12,167,61,240,155
8121,Badefols-sur-Dordogne,24022,24,28,45,35,68,45,148,73
8122,Baneuil,24023,24,65,60,30,165,40,235,125
8123,Bardou,24024,24,12,8,0,16,0,16,20
8124,Bars,24025,24,32,48,24,96,24,144,80
8125,Bassillac,24026,24,174,341,166,676,306,1148,515
8126,Bayac,24027,24,45,80,20,80,90,190,125
8127,Beaumontois en Périgord,24028,24,411,303,99,698,256,1053,714
8128,Beaupouyet,24029,24,100,100,10,193,75,278,200
8129,Beauregard-de-Terrasson,24030,24,104,160,48,248,140,436,264
8130,Beauregard-et-Bassac,24031,24,35,80,20,105,35,160,115
8131,Beauronne,24032,24,53,48,16,121,72,209,101
8132,Beaussac,24033,24,58,10,10,63,30,103,68
8133,Beleymas,24034,24,56,52,20,56,36,112,108
8134,Pays de Belvès,24035,24,267,290,135,455,235,825,557
8135,Berbiguières,24036,24,25,12,12,62,16,90,37
8136,Bergerac,24037,24,5462,5375,2654,9271,4130,16055,10837
8137,Bertric-Burée,24038,24,68,128,36,156,80,272,196
8138,Besse,24039,24,28,17,3,65,16,84,45
8139,Beynac-et-Cazenac,24040,24,96,108,40,224,100,364,204
8140,Bézenac,24041,24,30,25,10,60,20,90,55
8141,Biras,24042,24,76,188,49,140,178,367,264
8142,Biron,24043,24,44,44,4,68,20,92,88
8143,Blis-et-Born,24044,24,40,128,32,144,120,296,168
8144,Boisse,24045,24,32,64,12,96,48,156,96
8145,Boisseuilh,24046,24,25,18,0,53,17,70,43
8146,La Boissière-d'Ans,24047,24,15,25,15,145,20,180,40
8147,Bonneville-et-Saint-Avit-de-Fumadières,24048,24,29,62,9,128,34,171,91
8148,Borrèze,24050,24,70,75,35,120,45,200,145
8149,Bosset,24051,24,24,27,8,79,30,117,51
8150,Bouillac,24052,24,32,20,8,64,8,80,52
8151,Boulazac Isle Manoire,24053,24,1180,2285,902,3399,1872,6173,3465
8152,Bouniagues,24054,24,76,150,48,168,108,324,226
8153,Bourdeilles,24055,24,124,90,58,262,75,395,214
8154,Le Bourdeix,24056,24,39,50,24,53,33,110,89
8155,Bourg-des-Maisons,24057,24,30,8,0,8,17,25,38
8156,Bourg-du-Bost,24058,24,27,51,3,64,43,110,78
8157,Bourgnac,24059,24,60,78,20,110,65,195,138
8158,Bourniquel,24060,24,12,12,4,24,8,36,24
8159,Bourrou,24061,24,35,38,0,25,38,63,73
8160,Bouteilles-Saint-Sébastien,24062,24,46,20,13,74,10,97,66
8161,Bouzic,24063,24,52,24,0,64,16,80,76
8162,Brantôme en Périgord,24064,24,409,353,159,874,258,1291,762
8163,Breuilh,24065,24,16,72,44,85,48,177,88
8164,Brouchaud,24066,24,32,52,0,104,48,152,84
8165,Le Bugue,24067,24,634,374,175,997,288,1460,1008
8166,Le Buisson-de-Cadouin,24068,24,459,346,80,779,252,1111,805
8167,Bussac,24069,24,40,96,12,136,92,240,136
8168,Busserolles,24070,24,45,65,45,250,94,389,110
8169,Bussière-Badil,24071,24,110,90,20,105,65,190,200
8170,Calès,24073,24,64,80,32,140,72,244,144
8171,Calviac-en-Périgord,24074,24,101,68,26,187,62,275,169
8172,Campagnac-lès-Quercy,24075,24,54,37,6,98,63,167,91
8173,Campagne,24076,24,100,70,20,115,70,205,170
8174,Campsegret,24077,24,50,110,20,183,55,258,160
8175,Cantillac,24079,24,10,35,5,100,30,135,45
8176,Capdrot,24080,24,85,95,30,160,50,240,180
8177,Carlux,24081,24,101,122,30,226,79,335,223
8178,Carsac-Aillac,24082,24,139,308,85,651,318,1054,447
8179,Carsac-de-Gurson,24083,24,41,33,9,51,27,87,74
8180,Carves,24084,24,56,12,4,36,4,44,68
8181,La Cassagne,24085,24,16,32,8,56,32,96,48
8182,Castelnaud-la-Chapelle,24086,24,96,80,40,180,64,284,176
8183,Castels,24087,24,112,84,20,280,60,360,196
8184,Cause-de-Clérans,24088,24,72,60,36,128,40,204,132
8185,Cazoulès,24089,24,72,64,48,208,80,336,136
8186,Celles,24090,24,108,132,40,176,108,324,240
8187,Cénac-et-Saint-Julien,24091,24,214,271,46,440,157,643,485
8188,Cendrieux,24092,24,95,115,60,225,90,375,210
8189,Cercles,24093,24,5,35,0,120,30,150,40
8190,Chalagnac,24094,24,40,101,36,148,80,264,141
8191,Chalais,24095,24,69,48,6,171,42,219,117
8192,Champagnac-de-Belair,24096,24,120,115,65,275,115,455,235
8193,Champagne-et-Fontaine,24097,24,84,55,5,194,60,259,139
8194,Champcevinel,24098,24,387,567,280,1107,422,1809,954
8195,Champeaux-et-la-Chapelle-Pommier,24099,24,30,12,0,61,22,83,42
8196,Champniers-et-Reilhac,24100,24,102,69,29,206,41,276,171
8197,Champs-Romain,24101,24,40,52,16,124,68,208,92
8198,Chancelade,24102,24,653,816,279,1760,605,2644,1469
8199,Le Change,24103,24,76,120,60,220,128,408,196
8200,Chantérac,24104,24,75,140,45,232,120,397,215
8201,Chapdeuil,24105,24,10,5,15,85,5,105,15
8202,La Chapelle-Aubareil,24106,24,67,131,20,144,102,266,198
8203,La Chapelle-Faucher,24107,24,70,90,20,140,85,245,160
8204,La Chapelle-Gonaguet,24108,24,56,227,91,369,216,676,283
8205,La Chapelle-Grésignac,24109,24,15,10,20,65,15,100,25
8206,La Chapelle-Montabourlet,24110,24,16,4,12,40,8,60,20
8207,La Chapelle-Montmoreau,24111,24,25,5,5,25,10,40,30
8208,La Chapelle-Saint-Jean,24113,24,20,10,0,45,5,50,30
8209,Chassaignes,24114,24,20,12,4,32,8,44,32
8210,Château-l'Évêque,24115,24,262,477,150,680,410,1240,739
8211,Châtres,24116,24,55,45,0,55,35,90,100
8212,Chavagnac,24117,24,29,95,20,104,93,217,124
8213,Cherval,24119,24,80,35,20,100,40,160,115
8214,Cherveix-Cubas,24120,24,113,65,25,305,83,413,178
8215,Chourgnac,24121,24,30,0,0,31,5,36,30
8216,Cladech,24122,24,8,8,0,43,12,55,16
8217,Clermont-de-Beauregard,24123,24,15,20,10,30,20,60,35
8218,Clermont-d'Excideuil,24124,24,44,40,12,112,24,148,84
8219,Colombier,24126,24,16,38,36,61,34,131,54
8220,Coly,24127,24,45,35,20,80,30,130,80
8221,Comberanche-et-Épeluche,24128,24,3,23,3,70,32,105,26
8222,Condat-sur-Trincou,24129,24,48,95,33,134,97,264,143
8223,Condat-sur-Vézère,24130,24,108,204,68,332,184,584,312
8224,Connezac,24131,24,12,8,0,44,12,56,20
8225,Conne-de-Labarde,24132,24,28,44,4,104,44,152,72
8226,La Coquille,24133,24,284,200,80,498,169,747,484
8227,Corgnac-sur-l'Isle,24134,24,158,132,34,348,76,458,290
8228,Cornille,24135,24,62,147,21,250,138,409,209
8229,Coubjours,24136,24,25,20,0,75,20,95,45
8230,Coulaures,24137,24,140,160,52,248,152,452,300
8231,Coulounieix-Chamiers,24138,24,1449,1791,787,2569,1275,4631,3240
8232,Coursac,24139,24,65,518,123,861,439,1423,583
8233,Cours-de-Pile,24140,24,184,392,112,564,300,976,576
8234,Coutures,24141,24,20,40,10,85,35,130,60
8235,Coux et Bigaroque-Mouzens,24142,24,157,216,61,466,225,752,373
8236,Couze-et-Saint-Front,24143,24,136,107,36,287,91,414,243
8237,Creyssac,24144,24,12,8,4,36,12,52,20
8238,Creysse,24145,24,255,370,130,720,285,1135,625
8239,Creyssensac-et-Pissot,24146,24,20,72,8,116,44,168,92
8240,Cubjac,24147,24,188,129,50,257,129,436,317
8241,Cunèges,24148,24,50,55,35,110,25,170,105
8242,Daglan,24150,24,72,112,40,272,64,376,184
8243,Doissat,24151,24,45,15,0,35,15,50,60
8244,Domme,24152,24,129,140,50,354,140,544,269
8245,La Dornac,24153,24,20,112,12,156,132,300,132
8246,Douchapt,24154,24,36,84,20,124,76,220,120
8247,Douville,24155,24,48,86,47,168,49,264,134
8248,La Douze,24156,24,122,276,95,337,215,647,398
8249,Douzillac,24157,24,157,184,45,217,133,395,341
8250,Dussac,24158,24,95,45,35,185,55,275,140
8251,Échourgnac,24159,24,50,80,35,170,40,245,130
8252,Église-Neuve-de-Vergt,24160,24,35,130,35,178,135,348,165
8253,Église-Neuve-d'Issac,24161,24,8,31,9,54,29,92,39
8254,Escoire,24162,24,21,80,16,185,77,278,101
8255,Étouars,24163,24,42,9,26,60,0,86,51
8256,Excideuil,24164,24,256,185,50,360,135,545,441
8257,Eygurande-et-Gardedeuil,24165,24,50,80,5,145,90,240,130
8258,Eyliac,24166,24,90,165,40,255,181,476,255
8259,Eymet,24167,24,618,484,178,928,335,1441,1102
8260,Plaisance,24168,24,90,55,25,175,65,265,145
8261,Eyvirat,24170,24,35,70,40,90,60,190,105
8262,Eyzerac,24171,24,44,100,24,264,116,404,144
8263,Les Eyzies-de-Tayac-Sireuil,24172,24,171,84,48,326,100,474,255
8264,Fanlac,24174,24,18,19,3,42,18,63,37
8265,Les Farges,24175,24,60,64,16,108,60,184,124
8266,Faurilles,24176,24,6,7,6,9,3,18,13
8267,Faux,24177,24,104,123,28,195,101,324,227
8268,Festalemps,24178,24,28,44,12,152,36,200,72
8269,La Feuillade,24179,24,105,145,45,295,135,475,250
8270,Firbeix,24180,24,64,44,16,94,41,151,108
8271,Flaugeac,24181,24,25,65,20,115,65,200,90
8272,Le Fleix,24182,24,256,328,68,516,292,876,584
8273,Fleurac,24183,24,48,30,12,84,33,129,78
8274,Florimont-Gaumier,24184,24,56,16,8,36,20,64,72
8275,Fonroque,24186,24,40,76,36,112,48,196,116
8276,Fossemagne,24188,24,122,82,30,225,80,335,204
8277,Fougueyrolles,24189,24,50,120,35,185,100,320,170
8278,Fouleix,24190,24,30,40,10,90,55,155,70
8279,Fraisse,24191,24,24,40,4,68,32,104,64
8280,Gabillou,24192,24,5,15,5,53,10,68,20
8281,Gageac-et-Rouillac,24193,24,54,77,28,117,67,212,131
8282,Gardonne,24194,24,246,337,101,481,297,879,583
8283,Gaugeac,24195,24,14,25,3,49,13,65,39
8284,Génis,24196,24,104,53,9,201,43,253,157
8285,Ginestet,24197,24,115,125,40,345,105,490,240
8286,La Gonterie-Boulouneix,24198,24,30,55,10,115,40,165,85
8287,Gout-Rossignol,24199,24,47,50,12,93,45,150,97
8288,Grand-Brassac,24200,24,85,134,40,164,115,319,219
8289,Granges-d'Ans,24202,24,63,16,3,46,12,61,79
8290,Les Graulges,24203,24,14,0,4,21,8,33,14
8291,Grèzes,24204,24,22,38,10,79,23,112,60
8292,Grignols,24205,24,64,106,80,247,93,420,170
8293,Grives,24206,24,8,44,12,56,32,100,52
8294,Groléjac,24207,24,120,132,48,244,96,388,252
8295,Grun-Bordas,24208,24,20,50,35,70,45,150,70
8296,Hautefaye,24209,24,28,12,12,56,8,76,40
8297,Hautefort,24210,24,192,90,55,457,90,602,282
8298,Issac,24211,24,85,72,46,120,43,209,157
8299,Issigeac,24212,24,130,124,55,271,90,416,254
8300,Jaure,24213,24,15,50,5,40,65,110,65
8301,Javerlhac-et-la-Chapelle-Saint-Robert,24214,24,190,145,63,325,160,548,335
8302,Jayac,24215,24,28,29,4,71,16,91,57
8303,La Jemaye,24216,24,0,5,20,65,15,100,5
8304,Journiac,24217,24,48,60,44,188,72,304,108
8305,Jumilhac-le-Grand,24218,24,239,214,61,503,162,726,453
8306,Lacropte,24220,24,76,115,81,250,74,405,191
8307,Rudeau-Ladosse,24221,24,15,30,15,40,20,75,45
8308,La Force,24222,24,340,596,153,730,384,1267,936
8309,Lalinde,24223,24,872,416,130,1014,315,1459,1288
8310,Lamonzie-Montastruc,24224,24,40,180,70,285,125,480,220
8311,Lamonzie-Saint-Martin,24225,24,325,541,133,861,427,1421,866
8312,Lamothe-Montravel,24226,24,234,245,85,497,175,757,479
8313,Lanouaille,24227,24,195,160,95,370,140,605,355
8314,Lanquais,24228,24,105,100,35,195,75,305,205
8315,Le Lardin-Saint-Lazare,24229,24,286,362,178,746,243,1167,648
8316,Larzac,24230,24,4,28,8,52,32,92,32
8317,Lavalade,24231,24,25,10,0,45,0,45,35
8318,Lavaur,24232,24,24,13,0,6,13,19,37
8319,Laveyssière,24233,24,17,25,29,29,20,78,42
8320,Les Lèches,24234,24,76,48,28,140,60,228,124
8321,Léguillac-de-Cercles,24235,24,60,66,5,152,15,172,126
8322,Léguillac-de-l'Auche,24236,24,80,290,60,280,290,630,370
8323,Lembras,24237,24,181,160,70,536,185,791,341
8324,Lempzours,24238,24,50,15,0,40,15,55,65
8325,Limeuil,24240,24,50,70,5,175,50,230,120
8326,Limeyrat,24241,24,35,105,30,155,115,300,140
8327,Liorac-sur-Louyre,24242,24,38,60,3,98,29,130,98
8328,Lisle,24243,24,228,156,80,340,92,512,384
8329,Lolme,24244,24,21,8,0,47,8,55,29
8330,Loubejac,24245,24,35,70,10,135,30,175,105
8331,Lunas,24246,24,36,74,36,112,41,189,110
8332,Lusignac,24247,24,35,40,20,50,55,125,75
8333,Lussas-et-Nontronneau,24248,24,65,55,5,138,50,193,120
8334,Manaurie,24249,24,30,25,10,65,0,75,55
8335,Manzac-sur-Vern,24251,24,62,129,37,183,140,360,191
8336,Marcillac-Saint-Quentin,24252,24,95,179,70,298,125,493,274
8337,Mareuil,24253,24,196,168,48,361,125,534,364
8338,Marnac,24254,24,40,35,5,79,34,118,75
8339,Marquay,24255,24,96,101,46,203,65,314,197
8340,Marsac-sur-l'Isle,24256,24,388,797,327,967,597,1891,1185
8341,Marsalès,24257,24,60,40,12,96,24,132,100
8342,Marsaneix,24258,24,50,279,105,405,268,778,329
8343,Maurens,24259,24,86,218,54,457,181,692,304
8344,Mauzac-et-Grand-Castang,24260,24,76,100,48,244,92,384,176
8345,Mauzens-et-Miremont,24261,24,60,45,5,155,20,180,105
8346,Mayac,24262,24,51,72,13,114,51,178,123
8347,Mazeyrolles,24263,24,71,45,19,99,42,160,116
8348,Ménesplet,24264,24,266,393,87,568,365,1020,659
8349,Mensignac,24266,24,250,390,100,415,375,890,640
8350,Mescoules,24267,24,20,44,32,48,28,108,64
8351,Meyrals,24268,24,81,113,25,216,116,357,194
8352,Mialet,24269,24,155,80,40,291,50,381,235
8353,Milhac-d'Auberoche,24270,24,64,136,24,216,116,356,200
8354,Milhac-de-Nontron,24271,24,131,64,9,222,37,268,195
8355,Minzac,24272,24,67,91,42,128,80,250,158
8356,Molières,24273,24,65,75,15,125,40,180,140
8357,Monbazillac,24274,24,123,167,48,343,129,520,290
8358,Monestier,24276,24,56,80,32,148,68,248,136
8359,Monfaucon,24277,24,55,70,15,135,40,190,125
8360,Monmadalès,24278,24,0,35,5,30,25,60,35
8361,Monmarvès,24279,24,4,12,0,16,20,36,16
8362,Monpazier,24280,24,87,73,46,148,90,284,160
8363,Monsac,24281,24,40,40,10,95,5,110,80
8364,Monsaguel,24282,24,28,28,8,72,12,92,56
8365,Monsec,24283,24,30,30,5,95,20,120,60
8366,Montagnac-d'Auberoche,24284,24,15,40,0,30,45,75,55
8367,Montagnac-la-Crempse,24285,24,48,64,16,101,45,162,112
8368,Montagrier,24286,24,75,120,40,223,90,353,195
8369,Montaut,24287,24,28,12,8,48,20,76,40
8370,Montazeau,24288,24,35,45,40,155,30,225,80
8371,Montcaret,24289,24,274,272,83,493,236,812,546
8372,Montferrand-du-Périgord,24290,24,60,16,12,53,3,68,76
8373,Montignac,24291,24,557,521,188,1008,393,1589,1078
8374,Montpeyroux,24292,24,85,90,20,180,65,265,175
8375,Monplaisant,24293,24,34,61,16,97,28,141,95
8376,Montpon-Ménestérol,24294,24,1130,970,425,1900,785,3110,2100
8377,Montrem,24295,24,160,340,90,450,235,775,500
8378,Mouleydier,24296,24,241,271,60,381,195,636,512
8379,Moulin-Neuf,24297,24,136,208,56,320,144,520,344
8380,Mussidan,24299,24,639,478,205,997,352,1554,1117
8381,Nabirat,24300,24,60,96,32,112,80,224,156
8382,Nadaillac,24301,24,104,56,24,104,56,184,160
8383,Nailhac,24302,24,50,57,0,99,65,164,107
8384,Nanteuil-Auriac-de-Bourzac,24303,24,41,34,3,67,38,108,75
8385,Nantheuil,24304,24,154,177,43,336,167,546,331
8386,Nanthiat,24305,24,42,24,13,112,12,137,66
8387,Nastringues,24306,24,18,20,0,37,9,46,38
8388,Naussannes,24307,24,38,52,22,58,38,118,90
8389,Négrondes,24308,24,124,188,84,240,200,524,312
8390,Neuvic,24309,24,628,648,220,1013,522,1755,1276
8391,Nontron,24311,24,605,514,251,1016,496,1763,1119
8392,Notre-Dame-de-Sanilhac,24312,24,333,728,244,1161,574,1979,1061
8393,Orliac,24313,24,0,20,0,30,10,40,20
8394,Orliaguet,24314,24,6,15,12,29,16,57,21
8395,Parcoul-Chenaud,24316,24,153,133,52,247,93,392,286
8396,Paulin,24317,24,45,45,10,125,25,160,90
8397,Paunat,24318,24,65,75,5,120,55,180,140
8398,Paussac-et-Saint-Vivien,24319,24,92,68,28,148,84,260,160
8399,Payzac,24320,24,247,162,55,303,113,471,409
8400,Pazayac,24321,24,95,164,73,243,128,444,259
8401,Périgueux,24322,24,4644,6234,4112,8509,5215,17836,10878
8402,Petit-Bersac,24323,24,31,17,17,60,21,98,48
8403,Peyrignac,24324,24,93,140,30,190,110,330,233
8404,Peyrillac-et-Millac,24325,24,29,30,25,69,16,110,59
8405,Peyzac-le-Moustier,24326,24,35,35,10,75,25,110,70
8406,Pezuls,24327,24,21,12,3,44,10,57,33
8407,Piégut-Pluviers,24328,24,351,120,115,486,115,716,471
8408,Le Pizou,24329,24,235,310,110,450,165,725,545
8409,Plazac,24330,24,105,87,12,330,76,418,192
8410,Pomport,24331,24,149,161,50,284,144,478,310
8411,Ponteyraud,24333,24,18,5,0,20,0,20,23
8412,Pontours,24334,24,25,35,15,92,51,158,60
8413,Port-Sainte-Foy-et-Ponchapt,24335,24,450,435,145,955,270,1370,885
8414,Prats-de-Carlux,24336,24,35,115,60,214,90,364,150
8415,Prats-du-Périgord,24337,24,17,25,7,52,25,84,42
8416,Pressignac-Vicq,24338,24,65,80,25,223,45,293,145
8417,Preyssac-d'Excideuil,24339,24,12,44,20,56,40,116,56
8418,Prigonrieux,24340,24,629,764,214,1567,589,2370,1393
8419,Proissans,24341,24,128,200,76,367,152,595,328
8420,Puyrenier,24344,24,10,20,5,20,15,40,30
8421,Queyssac,24345,24,55,81,29,190,67,286,136
8422,Quinsac,24346,24,65,45,15,190,45,250,110
8423,Rampieux,24347,24,26,43,0,46,21,67,69
8424,Razac-d'Eymet,24348,24,55,60,25,95,60,180,115
8425,Razac-de-Saussignac,24349,24,35,65,25,160,60,245,100
8426,Razac-sur-l'Isle,24350,24,350,550,210,755,470,1435,900
8427,Ribagnac,24351,24,56,72,16,120,56,192,128
8428,Ribérac,24352,24,835,692,256,1271,565,2092,1527
8429,La Rochebeaucourt-et-Argentine,24353,24,69,46,12,119,31,162,115
8430,La Roche-Chalais,24354,24,461,669,250,999,442,1691,1130
8431,La Roque-Gageac,24355,24,112,52,28,184,60,272,164
8432,Rouffignac-Saint-Cernin-de-Reilhac,24356,24,345,255,65,630,260,955,600
8433,Rouffignac-de-Sigoulès,24357,24,29,68,29,125,48,202,97
8434,Sadillac,24359,24,16,18,4,28,21,53,34
8435,Sagelat,24360,24,46,43,22,114,26,162,89
8436,Saint-Agne,24361,24,56,76,40,156,88,284,132
8437,Sainte-Alvère-Saint-Laurent Les Bâtons,24362,24,182,133,75,463,101,639,315
8438,Saint-Amand-de-Coly,24364,24,40,105,40,119,90,249,145
8439,Saint-Amand-de-Vergt,24365,24,72,44,20,84,28,132,116
8440,Saint-André-d'Allas,24366,24,90,180,85,341,140,566,270
8441,Saint-André-de-Double,24367,24,44,16,4,60,36,100,60
8442,Saint-Antoine-Cumond,24368,24,92,32,0,208,28,236,124
8443,Saint-Antoine-d'Auberoche,24369,24,4,36,20,56,36,112,40
8444,Saint-Antoine-de-Breuilh,24370,24,289,457,71,635,335,1041,746
8445,Saint-Aquilin,24371,24,64,80,44,240,64,348,144
8446,Saint-Astier,24372,24,964,1156,456,1809,868,3133,2120
8447,Saint-Aubin-de-Cadelech,24373,24,33,25,16,179,28,223,58
8448,Saint-Aubin-de-Lanquais,24374,24,36,64,16,116,68,200,100
8449,Saint-Aubin-de-Nabirat,24375,24,27,9,6,40,21,67,36
8450,Saint Aulaye-Puymangou,24376,24,287,219,78,515,190,783,506
8451,Saint-Avit-de-Vialard,24377,24,46,40,0,40,25,65,86
8452,Saint-Avit-Rivière,24378,24,15,0,5,50,0,55,15
8453,Saint-Avit-Sénieur,24379,24,84,108,4,172,92,268,192
8454,Saint-Barthélemy-de-Bellegarde,24380,24,40,100,30,245,95,370,140
8455,Saint-Barthélemy-de-Bussière,24381,24,34,26,12,84,28,124,60
8456,Saint-Capraise-de-Lalinde,24382,24,115,75,80,185,55,320,190
8457,Saint-Capraise-d'Eymet,24383,24,32,20,6,52,0,58,52
8458,Saint-Cassien,24384,24,3,3,0,12,0,12,6
8459,Saint-Cernin-de-Labarde,24385,24,40,35,25,85,25,135,75
8460,Saint-Cernin-de-l'Herm,24386,24,17,64,4,104,30,138,81
8461,Saint-Chamassy,24388,24,90,90,15,200,123,338,180
8462,Saint-Cirq,24389,24,16,16,4,80,16,100,32
8463,Saint-Crépin-d'Auberoche,24390,24,21,84,16,104,70,190,105
8464,Saint-Crépin-de-Richemont,24391,24,24,51,4,68,41,113,75
8465,Saint-Crépin-et-Carlucet,24392,24,50,100,10,262,100,372,150
8466,Sainte-Croix,24393,24,20,10,5,40,10,55,30
8467,Sainte-Croix-de-Mareuil,24394,24,28,17,4,36,20,60,45
8468,Saint-Cybranet,24395,24,76,76,24,156,84,264,152
8469,Saint-Cyprien,24396,24,385,248,100,622,216,938,633
8470,Saint-Cyr-les-Champagnes,24397,24,46,46,10,108,46,164,92
8471,Saint-Estèphe,24398,24,74,81,40,284,80,404,155
8472,Saint-Étienne-de-Puycorbier,24399,24,16,20,20,36,16,72,36
8473,Sainte-Eulalie-d'Ans,24401,24,90,45,30,80,35,145,135
8474,Sainte-Eulalie-d'Eymet,24402,24,17,4,13,24,8,45,21
8475,Saint-Félix-de-Bourdeilles,24403,24,16,20,8,20,16,44,36
8476,Saint-Félix-de-Reillac-et-Mortemart,24404,24,15,25,10,120,15,145,40
8477,Saint-Félix-de-Villadeix,24405,24,31,43,12,104,29,145,74
8478,Sainte-Foy-de-Belvès,24406,24,12,0,8,32,12,52,12
8479,Sainte-Foy-de-Longas,24407,24,50,25,20,110,40,170,75
8480,Saint-Front-d'Alemps,24408,24,45,45,10,114,50,174,90
8481,Saint-Front-de-Pradoux,24409,24,240,265,40,455,160,655,505
8482,Saint-Front-la-Rivière,24410,24,124,60,30,225,70,325,184
8483,Saint-Front-sur-Nizonne,24411,24,36,16,4,64,24,92,52
8484,Saint-Geniès,24412,24,139,248,79,313,174,566,387
8485,Saint-Georges-Blancaneix,24413,24,6,55,3,79,42,124,61
8486,Saint-Georges-de-Montclard,24414,24,60,40,5,125,40,170,100
8487,Saint-Géraud-de-Corps,24415,24,12,57,4,84,48,136,69
8488,Saint-Germain-de-Belvès,24416,24,28,36,16,56,36,108,64
8489,Saint-Germain-des-Prés,24417,24,92,108,20,180,116,316,200
8490,Saint-Germain-du-Salembre,24418,24,163,200,57,348,123,528,363
8491,Saint-Germain-et-Mons,24419,24,94,150,85,325,139,549,244
8492,Saint-Géry,24420,24,36,48,4,88,36,128,84
8493,Saint-Geyrac,24421,24,34,45,0,95,20,115,79
8494,Saint-Hilaire-d'Estissac,24422,24,9,12,0,50,15,65,21
8495,Sainte-Innocence,24423,24,20,20,5,40,20,65,40
8496,Saint-Jean-d'Ataux,24424,24,24,20,8,48,20,76,44
8497,Saint-Jean-de-Côle,24425,24,80,55,34,140,40,214,135
8498,Saint-Jean-d'Estissac,24426,24,25,21,17,47,20,84,46
8499,Saint-Jean-d'Eyraud,24427,24,36,44,0,84,32,116,80
8500,Saint-Jory-de-Chalais,24428,24,74,78,39,234,66,339,152
8501,Saint-Jory-las-Bloux,24429,24,35,45,5,95,50,150,80
8502,Saint-Julien-de-Crempse,24431,24,40,65,5,55,55,115,105
8503,Saint-Julien-de-Lampon,24432,24,110,95,60,275,75,410,205
8504,Saint-Julien-d'Eymet,24433,24,26,9,0,24,12,36,35
8505,Saint-Just,24434,24,29,25,9,33,15,57,54
8506,Saint-Laurent-des-Hommes,24436,24,187,157,73,416,136,625,344
8507,Saint-Laurent-des-Vignes,24437,24,95,255,35,400,115,550,350
8508,Saint-Laurent-la-Vallée,24438,24,72,45,9,87,20,116,117
8509,Saint-Léon-d'Issigeac,24441,24,12,13,3,54,3,60,25
8510,Saint-Léon-sur-l'Isle,24442,24,335,406,140,675,350,1165,741
8511,Saint-Léon-sur-Vézère,24443,24,48,43,26,201,58,285,91
8512,Saint-Louis-en-l'Isle,24444,24,55,61,8,54,62,124,116
8513,Saint-Marcel-du-Périgord,24445,24,30,0,20,85,5,110,30
8514,Saint-Marcory,24446,24,8,16,4,16,16,36,24
8515,Sainte-Marie-de-Chignac,24447,24,49,138,57,169,107,333,187
8516,Saint-Martial-d'Albarède,24448,24,115,75,20,200,65,285,190
8517,Saint-Martial-d'Artenset,24449,24,165,150,65,435,135,635,315
8518,Saint-Martial-de-Nabirat,24450,24,141,85,15,223,87,325,226
8519,Saint-Martial-de-Valette,24451,24,165,130,45,315,150,510,295
8520,Saint-Martial-Viveyrol,24452,24,65,25,10,85,15,110,90
8521,Saint-Martin-de-Fressengeas,24453,24,96,62,17,89,54,160,158
8522,Saint-Martin-de-Gurson,24454,24,100,145,50,270,105,425,245
8523,Saint-Martin-de-Ribérac,24455,24,164,132,32,240,156,428,296
8524,Saint-Martin-des-Combes,24456,24,25,30,0,80,45,125,55
8525,Saint-Martin-l'Astier,24457,24,25,25,10,40,25,75,50
8526,Saint-Martin-le-Pin,24458,24,50,40,15,104,25,144,90
8527,Saint-Maime-de-Péreyrol,24459,24,52,55,8,86,39,133,107
8528,Saint-Méard-de-Drône,24460,24,45,121,26,150,81,257,166
8529,Saint-Méard-de-Gurçon,24461,24,163,137,48,252,129,429,300
8530,Saint-Médard-de-Mussidan,24462,24,335,340,120,615,225,960,675
8531,Saint-Médard-d'Excideuil,24463,24,87,96,25,163,93,281,183
8532,Saint-Mesmin,24464,24,45,65,20,134,65,219,110
8533,Saint-Michel-de-Double,24465,24,50,45,5,105,30,140,95
8534,Saint-Michel-de-Montaigne,24466,24,5,89,10,168,70,248,94
8535,Saint-Michel-de-Villadeix,24468,24,64,72,16,92,60,168,136
8536,Sainte-Mondane,24470,24,35,50,5,120,50,175,85
8537,Sainte-Nathalène,24471,24,89,145,20,178,160,358,234
8538,Saint-Nexans,24472,24,104,204,72,419,120,611,308
8539,Sainte-Orse,24473,24,70,65,25,165,50,240,135
8540,Saint-Pancrace,24474,24,16,34,13,61,16,90,50
8541,Saint-Pantaly-d'Ans,24475,24,20,35,10,60,20,90,55
8542,Saint-Pantaly-d'Excideuil,24476,24,45,30,5,45,30,80,75
8543,Saint-Pardoux-de-Drône,24477,24,25,30,15,70,45,130,55
8544,Saint-Pardoux-et-Vielvic,24478,24,40,50,15,70,25,110,90
8545,Saint-Pardoux-la-Rivière,24479,24,271,165,85,470,145,700,436
8546,Saint-Paul-de-Serre,24480,24,31,57,8,73,64,145,88
8547,Saint-Paul-la-Roche,24481,24,80,101,30,207,63,300,181
8548,Saint-Paul-Lizonne,24482,24,72,16,12,132,28,172,88
8549,Saint-Perdoux,24483,24,30,15,10,60,20,90,45
8550,Saint-Pierre-de-Chignac,24484,24,108,177,48,298,180,526,285
8551,Saint-Pierre-de-Côle,24485,24,100,100,60,128,100,288,200
8552,Saint-Pierre-de-Frugie,24486,24,86,48,16,127,41,184,134
8553,Saint-Pierre-d'Eyraud,24487,24,228,400,128,580,300,1008,628
8554,Saint-Pompont,24488,24,84,88,28,152,76,256,172
8555,Saint-Priest-les-Fougères,24489,24,89,44,20,125,34,179,133
8556,Saint-Privat-des-Prés,24490,24,80,55,10,175,30,215,135
8557,Saint-Rabier,24491,24,104,120,40,236,104,380,224
8558,Sainte-Radegonde,24492,24,12,8,0,16,8,24,20
8559,Saint-Raphaël,24493,24,20,5,20,75,0,95,25
8560,Saint-Rémy,24494,24,54,97,38,191,60,289,151
8561,Saint-Romain-de-Monpazier,24495,24,8,12,8,44,12,64,20
8562,Saint-Romain-et-Saint-Clément,24496,24,72,64,24,112,52,188,136
8563,Saint-Saud-Lacoussière,24498,24,205,130,35,355,125,515,335
8564,Saint-Sauveur,24499,24,88,176,40,379,140,559,264
8565,Saint-Sauveur-Lalande,24500,24,39,16,12,32,8,52,55
8566,Saint-Seurin-de-Prats,24501,24,74,85,40,165,57,262,159
8567,Saint-Séverin-d'Estissac,24502,24,30,20,15,20,10,45,50
8568,Saint-Sulpice-de-Mareuil,24503,24,30,25,5,35,20,60,55
8569,Saint-Sulpice-de-Roumagnac,24504,24,60,44,48,68,40,156,104
8570,Saint-Sulpice-d'Excideuil,24505,24,56,48,4,132,60,196,104
8571,Sainte-Trie,24507,24,29,13,6,41,3,50,42
8572,Saint-Victor,24508,24,35,50,5,75,40,120,85
8573,Saint-Vincent-de-Connezac,24509,24,95,185,40,195,120,355,280
8574,Saint-Vincent-de-Cosse,24510,24,38,56,18,181,35,234,94
8575,Saint-Vincent-Jalmoutiers,24511,24,40,41,19,75,29,123,81
8576,Saint-Vincent-le-Paluel,24512,24,24,52,28,124,44,196,76
8577,Saint-Vincent-sur-l'Isle,24513,24,22,50,19,81,67,167,72
8578,Saint-Vivien,24514,24,75,50,10,95,35,140,125
8579,Salagnac,24515,24,90,80,30,165,65,260,170
8580,Salignac-Eyvigues,24516,24,184,220,88,408,160,656,404
8581,Salles-de-Belvès,24517,24,10,10,5,30,15,50,20
8582,Salon,24518,24,36,52,24,92,60,176,88
8583,Sarlande,24519,24,21,76,41,153,87,281,97
8584,Sarlat-la-Canéda,24520,24,1700,1563,801,3322,1356,5479,3263
8585,Sarliac-sur-l'Isle,24521,24,145,275,80,400,140,620,420
8586,Sarrazac,24522,24,56,48,12,179,43,234,104
8587,Saussignac,24523,24,64,104,28,132,104,264,168
8588,Savignac-de-Miremont,24524,24,4,32,0,57,59,116,36
8589,Savignac-de-Nontron,24525,24,30,15,6,81,18,105,45
8590,Savignac-Lédrier,24526,24,145,100,40,343,85,468,245
8591,Savignac-les-Églises,24527,24,179,250,80,310,115,505,429
8592,Sceau-Saint-Angel,24528,24,32,32,16,16,40,72,64
8593,Segonzac,24529,24,45,40,25,65,20,110,85
8594,Sencenac-Puy-de-Fourches,24530,24,20,65,30,70,55,155,85
8595,Sergeac,24531,24,25,40,5,122,35,162,65
8596,Serres-et-Montguyard,24532,24,24,36,28,84,44,156,60
8597,Servanches,24533,24,24,20,8,40,16,64,44
8598,Sigoulès,24534,24,148,176,92,280,148,520,324
8599,Simeyrols,24535,24,55,50,20,100,40,160,105
8600,Singleyrac,24536,24,5,75,45,100,75,220,80
8601,Siorac-de-Ribérac,24537,24,60,36,16,120,20,156,96
8602,Siorac-en-Périgord,24538,24,212,220,72,364,136,572,432
8603,Sorges et Ligueux en Périgord,24540,24,212,363,60,576,319,955,575
8604,Soudat,24541,24,24,12,8,24,12,44,36
8605,Soulaures,24542,24,8,12,8,8,37,53,20
8606,Sourzac,24543,24,184,221,66,443,130,639,405
8607,Tamniès,24544,24,26,65,39,145,56,240,91
8608,Teillots,24545,24,16,9,9,27,21,57,25
8609,Temple-Laguyon,24546,24,0,10,5,20,5,30,10
8610,Terrasson-Lavilledieu,24547,24,1014,1273,594,2082,950,3626,2287
8611,Teyjat,24548,24,88,50,0,110,35,145,138
8612,Thénac,24549,24,32,75,4,136,60,200,107
8613,Thenon,24550,24,260,250,100,445,165,710,510
8614,Thiviers,24551,24,712,461,235,976,347,1558,1173
8615,Thonac,24552,24,60,35,5,145,20,170,95
8616,Tocane-Saint-Apre,24553,24,319,315,55,604,290,949,634
8617,La Tour-Blanche,24554,24,95,55,20,145,30,195,150
8618,Tourtoirac,24555,24,220,80,35,225,95,355,300
8619,Trélissac,24557,24,1302,1136,690,2368,985,4043,2438
8620,Trémolat,24558,24,99,81,51,285,38,374,180
8621,Tursac,24559,24,28,56,24,168,60,252,84
8622,Urval,24560,24,26,16,6,18,24,48,42
8623,Valeuil,24561,24,40,83,20,174,45,239,123
8624,Vallereuil,24562,24,40,60,15,135,35,185,100
8625,Valojoulx,24563,24,40,35,15,134,45,194,75
8626,Vanxains,24564,24,144,155,67,268,99,434,299
8627,Varaignes,24565,24,70,70,30,190,60,280,140
8628,Varennes,24566,24,108,97,20,120,66,206,205
8629,Vaunac,24567,24,54,65,35,104,30,169,119
8630,Vélines,24568,24,150,311,115,329,209,653,461
8631,Vendoire,24569,24,20,25,25,40,30,95,45
8632,Verdon,24570,24,0,4,8,29,0,37,4
8633,Vergt,24571,24,265,328,174,516,263,953,593
8634,Vergt-de-Biron,24572,24,25,20,25,83,25,133,45
8635,Verteillac,24573,24,148,125,29,215,82,326,273
8636,Veyrignac,24574,24,70,85,0,115,70,185,155
8637,Veyrines-de-Domme,24575,24,23,48,19,60,37,116,71
8638,Veyrines-de-Vergt,24576,24,30,70,0,105,45,150,100
8639,Vézac,24577,24,65,120,40,308,80,428,185
8640,Vieux-Mareuil,24579,24,64,76,24,128,64,216,140
8641,Villac,24580,24,36,33,20,85,35,140,69
8642,Villamblard,24581,24,121,144,68,288,136,492,265
8643,Villars,24582,24,88,72,44,216,80,340,160
8644,Villefranche-de-Lonchat,24584,24,125,180,89,340,200,629,305
8645,Villefranche-du-Périgord,24585,24,155,84,40,243,59,342,239
8646,Villetoureix,24586,24,212,179,40,271,137,448,391
8647,Vitrac,24587,24,161,100,85,397,95,577,261
8648,Abbans-Dessous,25001,25,16,57,12,83,41,136,73
8649,Abbans-Dessus,25002,25,30,72,33,95,42,170,102
8650,Abbenans,25003,25,49,65,20,135,60,215,114
8651,Abbévillers,25004,25,89,267,139,315,233,687,356
8652,Accolans,25005,25,5,20,10,40,25,75,25
8653,Adam-lès-Passavant,25006,25,10,35,10,20,20,50,45
8654,Adam-lès-Vercel,25007,25,10,35,5,5,35,45,45
8655,Aibre,25008,25,56,116,32,192,96,320,172
8656,Aïssey,25009,25,24,64,20,44,36,100,88
8657,Allenjoie,25011,25,135,190,50,210,155,415,325
8658,Les Alliés,25012,25,0,48,24,32,40,96,48
8659,Allondans,25013,25,26,50,16,54,62,132,76
8660,Amagney,25014,25,130,142,54,255,101,410,272
8661,Amancey,25015,25,94,163,73,176,101,350,257
8662,Amathay-Vésigneux,25016,25,8,33,33,42,24,99,41
8663,Amondans,25017,25,10,25,10,35,15,60,35
8664,Anteuil,25018,25,90,210,20,195,144,359,300
8665,Appenans,25019,25,25,90,35,180,60,275,115
8666,Arbouans,25020,25,170,195,80,345,165,590,365
8667,Arc-et-Senans,25021,25,288,356,116,516,284,916,644
8668,Arcey,25022,25,230,420,90,460,225,775,650
8669,Arçon,25024,25,95,237,36,231,164,431,332
8670,Arc-sous-Cicon,25025,25,96,196,76,172,136,384,292
8671,Arc-sous-Montenot,25026,25,15,60,10,110,30,150,75
8672,Arguel,25027,25,32,64,16,104,44,164,96
8673,Aubonne,25029,25,25,65,15,100,35,150,90
8674,Audeux,25030,25,17,103,36,129,97,262,120
8675,Audincourt,25031,25,1725,3537,1798,4156,2515,8469,5262
8676,Autechaux,25032,25,40,130,35,140,75,250,170
8677,Autechaux-Roide,25033,25,68,108,44,183,97,324,176
8678,Les Auxons,25035,25,168,728,204,892,548,1644,896
8679,Avanne-Aveney,25036,25,305,487,150,696,335,1181,792
8680,Avilley,25038,25,24,36,32,52,28,112,60
8681,Avoudrey,25039,25,81,191,90,302,162,554,272
8682,Badevel,25040,25,90,185,65,305,180,550,275
8683,Bannans,25041,25,10,85,45,145,55,245,95
8684,Le Barboux,25042,25,16,88,16,80,48,144,104
8685,Bart,25043,25,344,395,155,703,328,1186,739
8686,Bartherans,25044,25,0,16,16,16,8,40,16
8687,Battenans-les-Mines,25045,25,4,12,4,24,4,32,16
8688,Battenans-Varin,25046,25,10,25,0,25,15,40,35
8689,Baume-les-Dames,25047,25,778,1063,518,1678,854,3050,1841
8690,Bavans,25048,25,480,970,320,1315,605,2240,1450
8691,Belfays,25049,25,0,48,28,8,40,76,48
8692,Le Bélieu,25050,25,20,122,40,98,99,237,142
8693,Belleherbe,25051,25,65,135,53,184,109,346,200
8694,Belmont,25052,25,12,12,16,12,8,36,24
8695,Belvoir,25053,25,20,30,10,20,25,55,50
8696,Berche,25054,25,75,130,45,145,75,265,205
8697,Berthelange,25055,25,16,92,36,88,68,192,108
8698,Besançon,25056,25,12859,26037,21818,30606,20265,72689,38896
8699,Bethoncourt,25057,25,719,1687,676,1627,946,3249,2406
8700,Beure,25058,25,200,308,184,456,208,848,508
8701,Beutal,25059,25,12,76,16,88,84,188,88
8702,Bians-les-Usiers,25060,25,64,169,65,183,155,403,233
8703,Bief,25061,25,9,13,0,59,9,68,22
8704,Le Bizot,25062,25,21,91,4,57,103,164,112
8705,Blamont,25063,25,150,225,118,365,180,663,375
8706,Blarians,25065,25,12,12,4,16,12,32,24
8707,Blussangeaux,25066,25,16,16,8,16,16,40,32
8708,Blussans,25067,25,16,47,20,50,24,94,63
8709,Bolandoz,25070,25,56,92,56,88,88,232,148
8710,Bondeval,25071,25,85,95,55,140,110,305,180
8711,Bonnal,25072,25,10,5,0,10,5,15,15
8712,Bonnay,25073,25,50,255,40,318,195,553,305
8713,Bonnétage,25074,25,95,250,90,215,215,520,345
8714,Bonnevaux,25075,25,40,120,40,85,80,205,160
8715,La Bosse,25077,25,6,24,3,12,28,43,30
8716,Bouclans,25078,25,102,279,61,282,168,511,381
8717,Boujailles,25079,25,76,76,64,94,71,229,152
8718,Bourguignon,25082,25,80,256,56,320,240,616,336
8719,Bournois,25083,25,20,40,20,70,25,115,60
8720,Boussières,25084,25,135,300,70,350,260,680,435
8721,Bouverans,25085,25,44,99,30,78,65,173,143
8722,Braillans,25086,25,21,47,8,41,48,97,68
8723,Branne,25087,25,18,26,6,39,32,77,44
8724,Breconchaux,25088,25,5,35,0,20,25,45,40
8725,Bremondans,25089,25,15,25,0,30,25,55,40
8726,Brères,25090,25,8,14,0,12,20,32,22
8727,Les Bréseux,25091,25,20,144,24,144,144,312,164
8728,La Bretenière,25092,25,4,16,0,25,12,37,20
8729,Bretigney,25093,25,0,15,5,35,10,50,15
8730,Bretigney-Notre-Dame,25094,25,15,20,15,35,15,65,35
8731,Bretonvillers,25095,25,40,64,24,104,48,176,104
8732,Brey-et-Maison-du-Bois,25096,25,4,12,16,33,12,61,16
8733,Brognard,25097,25,60,100,30,190,65,285,160
8734,Buffard,25098,25,19,20,3,63,15,81,39
8735,Bugny,25099,25,20,60,24,44,56,124,80
8736,Bulle,25100,25,12,96,40,140,104,284,108
8737,Burgille,25101,25,65,165,20,160,120,300,230
8738,Burnevillers,25102,25,12,28,0,0,17,17,40
8739,Busy,25103,25,58,139,75,174,120,369,197
8740,By,25104,25,4,12,8,20,16,44,16
8741,Byans-sur-Doubs,25105,25,52,120,48,172,104,324,172
8742,Cademène,25106,25,23,6,3,21,9,33,29
8743,Cendrey,25107,25,0,37,13,82,42,137,37
8744,Cernay-l'Église,25108,25,40,65,30,95,65,190,105
8745,Cessey,25109,25,10,75,55,140,50,245,85
8746,Chaffois,25110,25,72,232,68,310,235,613,304
8747,Chalèze,25111,25,60,95,30,130,65,225,155
8748,Chalezeule,25112,25,91,280,172,403,189,764,371
8749,Chamesey,25113,25,16,35,12,45,17,74,51
8750,Chamesol,25114,25,45,75,35,135,65,235,120
8751,Champagney,25115,25,33,38,12,88,61,161,71
8752,Champlive,25116,25,35,65,10,105,40,155,100
8753,Champoux,25117,25,0,32,3,19,27,49,32
8754,Champvans-les-Moulins,25119,25,49,90,10,134,60,204,139
8755,Chantrans,25120,25,55,105,25,140,75,240,160
8756,Chapelle-des-Bois,25121,25,35,80,20,60,60,140,115
8757,Chapelle-d'Huin,25122,25,25,170,45,130,150,325,195
8758,Charbonnières-les-Sapins,25123,25,33,55,6,24,38,68,88
8759,Charmauvillers,25124,25,25,65,15,70,70,155,90
8760,Charmoille,25125,25,56,84,24,112,60,196,140
8761,Charnay,25126,25,32,116,40,172,104,316,148
8762,Charquemont,25127,25,320,561,421,714,535,1670,881
8763,Chassagne-Saint-Denis,25129,25,24,16,8,52,8,68,40
8764,Châteauvieux-les-Fossés,25130,25,10,0,0,0,0,0,10
8765,Châtelblanc,25131,25,15,35,25,30,20,75,50
8766,Châtillon-Guyotte,25132,25,25,40,5,40,25,70,65
8767,Châtillon-le-Duc,25133,25,282,460,124,752,333,1209,742
8768,Châtillon-sur-Lison,25134,25,0,0,0,10,0,10,0
8769,Chaucenne,25136,25,65,155,50,150,85,285,220
8770,Chaudefontaine,25137,25,16,55,17,70,31,118,71
8771,Les Terres-de-Chaux,25138,25,20,32,4,44,40,88,52
8772,La Chaux,25139,25,36,127,56,127,80,263,163
8773,Chaux-lès-Clerval,25140,25,25,25,10,55,30,95,50
8774,Chaux-lès-Passavant,25141,25,30,10,10,40,5,55,40
8775,Chaux-Neuve,25142,25,28,88,32,64,92,188,116
8776,Chay,25143,25,17,51,4,60,34,98,68
8777,Chazot,25145,25,9,12,12,51,9,72,21
8778,Chemaudin,25147,25,140,420,125,510,250,885,560
8779,La Chenalotte,25148,25,4,136,48,112,156,316,140
8780,Chenecey-Buillon,25149,25,40,125,54,155,160,369,165
8781,Chevigney-sur-l'Ognon,25150,25,8,66,12,66,78,156,74
8782,Chevigney-lès-Vercel,25151,25,4,42,4,49,12,65,46
8783,La Chevillotte,25152,25,0,60,8,33,34,75,60
8784,Chevroz,25153,25,4,30,4,53,16,73,34
8785,Chouzelot,25154,25,35,85,10,105,35,150,120
8786,Cléron,25155,25,24,88,28,112,72,212,112
8787,Clerval,25156,25,130,265,100,305,215,620,395
8788,La Cluse-et-Mijoux,25157,25,94,308,274,356,253,883,402
8789,Colombier-Fontaine,25159,25,199,265,91,436,215,742,464
8790,Les Combes,25160,25,50,190,120,240,120,480,240
8791,Consolation-Maisonnettes,25161,25,0,8,4,16,16,36,8
8792,Corcelles-Ferrières,25162,25,12,53,0,68,39,107,65
8793,Corcelle-Mieslot,25163,25,9,12,17,30,12,59,21
8794,Corcondray,25164,25,20,40,10,40,20,70,60
8795,Côtebrune,25166,25,12,24,0,24,12,36,36
8796,Courcelles-lès-Montbéliard,25170,25,180,196,120,396,172,688,376
8797,Courcelles,25171,25,12,24,24,20,20,64,36
8798,Courchapon,25172,25,8,52,20,56,44,120,60
8799,Cour-Saint-Maurice,25173,25,40,40,0,45,35,80,80
8800,Courtefontaine,25174,25,40,72,16,72,52,140,112
8801,Courtetain-et-Salans,25175,25,10,40,15,25,5,45,50
8802,Courvières,25176,25,5,105,35,118,55,208,110
8803,Crosey-le-Grand,25177,25,40,15,10,60,30,100,55
8804,Crosey-le-Petit,25178,25,20,35,20,45,10,75,55
8805,Le Crouzet,25179,25,3,18,9,18,6,33,21
8806,Crouzet-Migette,25180,25,5,40,10,45,25,80,45
8807,Cubrial,25181,25,25,14,21,34,12,67,39
8808,Cubry,25182,25,4,18,4,33,13,50,22
8809,Cusance,25183,25,10,15,10,30,0,40,25
8810,Cuse-et-Adrisans,25184,25,18,71,16,54,59,129,89
8811,Cussey-sur-Lison,25185,25,4,12,0,16,12,28,16
8812,Cussey-sur-l'Ognon,25186,25,42,325,75,302,223,600,367
8813,Dambelin,25187,25,64,128,28,152,112,292,192
8814,Dambenois,25188,25,50,160,65,285,165,515,210
8815,Dammartin-les-Templiers,25189,25,16,80,8,72,40,120,96
8816,Dampierre-les-Bois,25190,25,267,404,164,540,280,984,671
8817,Dampierre-sur-le-Doubs,25191,25,64,88,26,202,50,278,152
8818,Dampjoux,25192,25,8,40,16,60,36,112,48
8819,Damprichard,25193,25,230,410,206,572,354,1132,640
8820,Dannemarie,25194,25,20,25,10,35,25,70,45
8821,Dannemarie-sur-Crète,25195,25,88,395,116,364,302,782,483
8822,Dasle,25196,25,235,275,110,575,225,910,510
8823,Deluz,25197,25,120,115,55,185,125,365,235
8824,Désandans,25198,25,90,140,60,235,65,360,230
8825,Déservillers,25199,25,45,105,25,95,80,200,150
8826,Devecey,25200,25,176,337,115,535,187,837,513
8827,Dommartin,25201,25,95,175,95,165,130,390,270
8828,Dompierre-les-Tilleuls,25202,25,13,85,25,56,46,127,98
8829,Domprel,25203,25,12,48,28,48,24,100,60
8830,Doubs,25204,25,205,652,275,925,444,1644,857
8831,Dung,25207,25,80,164,44,288,84,416,244
8832,Durnes,25208,25,4,34,8,65,30,103,38
8833,Échay,25209,25,10,70,0,45,25,70,80
8834,Échenans,25210,25,4,43,4,60,31,95,47
8835,Échevannes,25211,25,21,12,4,25,4,33,33
8836,École-Valentin,25212,25,218,640,225,811,456,1492,858
8837,Les Écorces,25213,25,40,207,64,208,169,441,247
8838,Écot,25214,25,40,135,25,183,125,333,175
8839,L'Écouvotte,25215,25,6,28,6,18,18,42,34
8840,Écurcey,25216,25,54,52,6,98,34,138,106
8841,Émagny,25217,25,60,128,72,216,104,392,188
8842,Épenouse,25218,25,8,41,0,28,38,66,49
8843,Épenoy,25219,25,111,166,16,126,152,294,277
8844,Épeugney,25220,25,44,155,68,170,125,363,199
8845,Esnans,25221,25,4,25,4,8,16,28,29
8846,Étalans,25222,25,160,355,60,295,279,634,515
8847,Éternoz,25223,25,90,70,25,75,75,175,160
8848,Étouvans,25224,25,148,139,74,233,146,453,287
8849,Étrabonne,25225,25,24,68,16,44,48,108,92
8850,Étrappe,25226,25,21,52,0,73,41,114,73
8851,Étray,25227,25,16,79,29,50,61,140,95
8852,Étupes,25228,25,542,900,333,1030,810,2173,1442
8853,Évillers,25229,25,36,88,32,96,80,208,124
8854,Exincourt,25230,25,624,695,168,1001,591,1760,1319
8855,Eysson,25231,25,5,25,10,35,25,70,30
8856,Faimbe,25232,25,5,40,0,55,15,70,45
8857,Fallerans,25233,25,32,72,24,72,60,156,104
8858,Ferrières-le-Lac,25234,25,0,60,25,35,50,110,60
8859,Ferrières-les-Bois,25235,25,22,74,20,81,69,170,96
8860,Fertans,25236,25,15,60,25,95,60,180,75
8861,Fesches-le-Châtel,25237,25,247,548,220,696,455,1371,795
8862,Fessevillers,25238,25,15,35,10,55,34,99,50
8863,Feule,25239,25,15,60,5,60,45,110,75
8864,Les Fins,25240,25,275,731,390,990,586,1966,1006
8865,Flagey,25241,25,8,29,25,38,35,98,37
8866,Flagey-Rigney,25242,25,4,20,8,21,25,54,24
8867,Flangebouche,25243,25,70,235,75,175,154,404,305
8868,Fleurey,25244,25,10,35,5,30,25,60,45
8869,Fontain,25245,25,95,259,46,347,187,580,354
8870,Fontaine-lès-Clerval,25246,25,26,70,25,50,57,132,96
8871,Fontenelle-Montby,25247,25,10,35,0,40,15,55,45
8872,Les Fontenelles,25248,25,54,151,46,139,124,309,205
8873,Fontenotte,25249,25,0,25,20,5,15,40,25
8874,Foucherans,25250,25,32,128,32,144,108,284,160
8875,Fourbanne,25251,25,9,44,0,44,41,85,53
8876,Fourcatier-et-Maison-Neuve,25252,25,8,36,16,28,20,64,44
8877,Fourg,25253,25,34,124,16,90,69,175,158
8878,Les Fourgs,25254,25,84,332,193,332,312,837,416
8879,Fournet-Blancheroche,25255,25,28,88,48,104,72,224,116
8880,Frambouhans,25256,25,60,259,92,164,272,528,319
8881,Franey,25257,25,5,66,35,106,35,176,71
8882,Franois,25258,25,288,557,234,673,321,1228,845
8883,Frasne,25259,25,248,546,236,440,424,1100,794
8884,Froidevaux,25261,25,8,12,8,28,12,48,20
8885,Fuans,25262,25,50,134,84,115,104,303,184
8886,Gellin,25263,25,8,54,54,56,33,143,62
8887,Gémonval,25264,25,0,16,4,30,12,46,16
8888,Geneuille,25265,25,95,415,40,440,335,815,510
8889,Geney,25266,25,10,20,10,68,10,88,30
8890,Gennes,25267,25,55,190,80,215,125,420,245
8891,Germéfontaine,25268,25,16,36,12,44,16,72,52
8892,Germondans,25269,25,30,5,0,0,15,15,35
8893,Gevresin,25270,25,24,17,4,33,8,45,41
8894,Gilley,25271,25,120,429,208,412,354,974,549
8895,Glamondans,25273,25,8,52,16,59,42,117,60
8896,Glay,25274,25,25,85,40,115,80,235,110
8897,Glère,25275,25,12,57,8,69,52,129,69
8898,Gondenans-Montby,25276,25,32,32,8,56,40,104,64
8899,Gondenans-les-Moulins,25277,25,20,15,0,25,10,35,35
8900,Gonsans,25278,25,52,152,56,172,120,348,204
8901,Gouhelans,25279,25,10,12,10,47,6,63,22
8902,Goumois,25280,25,19,19,26,46,25,97,38
8903,Goux-lès-Dambelin,25281,25,21,76,47,64,48,159,97
8904,Goux-les-Usiers,25282,25,80,240,55,190,170,415,320
8905,Goux-sous-Landet,25283,25,24,12,4,20,4,28,36
8906,Grand-Charmont,25284,25,961,1342,553,1497,997,3047,2303
8907,Grand'Combe-Châteleu,25285,25,150,374,154,502,288,944,524
8908,Grand'Combe-des-Bois,25286,25,20,40,15,25,35,75,60
8909,Grandfontaine,25287,25,145,430,130,522,299,951,575
8910,Fournets-Luisans,25288,25,60,169,88,176,152,416,229
8911,Grandfontaine-sur-Creuse,25289,25,12,16,0,14,12,26,28
8912,La Grange,25290,25,13,26,0,20,21,41,39
8913,Granges-Narboz,25293,25,76,396,76,261,284,621,472
8914,Les Grangettes,25295,25,33,48,28,49,63,140,81
8915,Les Gras,25296,25,96,244,100,196,168,464,340
8916,Le Gratteris,25297,25,10,60,20,50,40,110,70
8917,Grosbois,25298,25,20,58,16,62,39,117,78
8918,Guillon-les-Bains,25299,25,24,22,3,30,9,42,46
8919,Guyans-Durnes,25300,25,17,86,4,74,67,145,103
8920,Guyans-Vennes,25301,25,88,242,100,168,190,458,330
8921,Hauterive-la-Fresse,25303,25,16,64,16,64,40,120,80
8922,Hérimoncourt,25304,25,300,907,443,1031,753,2227,1207
8923,L'Hôpital-du-Grosbois,25305,25,45,147,71,145,106,322,192
8924,L'Hôpital-Saint-Lieffroy,25306,25,0,33,8,20,37,65,33
8925,Les Hôpitaux-Neufs,25307,25,80,189,158,156,205,519,269
8926,Les Hôpitaux-Vieux,25308,25,20,108,48,124,100,272,128
8927,Houtaud,25309,25,84,304,140,328,176,644,388
8928,Huanne-Montmartin,25310,25,0,15,20,20,20,60,15
8929,Hyémondans,25311,25,12,40,24,51,28,103,52
8930,Hyèvre-Magny,25312,25,0,15,15,30,20,65,15
8931,Hyèvre-Paroisse,25313,25,19,33,23,51,21,95,52
8932,Indevillers,25314,25,15,75,30,50,41,121,90
8933,L'Isle-sur-le-Doubs,25315,25,438,755,269,1007,579,1855,1193
8934,Issans,25316,25,50,45,10,111,30,151,95
8935,Jallerange,25317,25,28,66,4,41,61,106,94
8936,Jougne,25318,25,143,423,270,396,410,1076,566
8937,Labergement-du-Navois,25319,25,12,36,8,28,20,56,48
8938,Labergement-Sainte-Marie,25320,25,104,263,204,359,224,787,367
8939,Villers-le-Lac,25321,25,407,1182,639,1438,1018,3095,1589
8940,Laire,25322,25,16,86,33,133,80,246,102
8941,Laissey,25323,25,60,110,60,150,45,255,170
8942,Lanans,25324,25,9,29,16,40,29,85,38
8943,Landresse,25325,25,45,70,15,75,40,130,115
8944,Lantenne-Vertière,25326,25,24,156,40,152,148,340,180
8945,Lanthenans,25327,25,5,25,5,15,20,40,30
8946,Larnod,25328,25,48,234,52,236,160,448,282
8947,Laval-le-Prieuré,25329,25,0,4,0,20,8,28,4
8948,Lavans-Quingey,25330,25,16,64,12,52,52,116,80
8949,Lavans-Vuillafans,25331,25,27,62,12,48,39,99,89
8950,Lavernay,25332,25,20,168,60,196,116,372,188
8951,Laviron,25333,25,50,80,35,95,70,200,130
8952,Levier,25334,25,255,511,216,486,357,1059,766
8953,Liebvillers,25335,25,10,30,40,65,19,124,40
8954,Liesle,25336,25,43,95,52,175,77,304,138
8955,Lizine,25338,25,19,3,9,28,0,37,22
8956,Lods,25339,25,46,37,12,65,32,109,83
8957,Lombard,25340,25,20,40,5,107,15,127,60
8958,Lomont-sur-Crête,25341,25,9,34,6,49,37,92,43
8959,Longechaux,25342,25,12,19,0,12,13,25,31
8960,Longemaison,25343,25,38,39,12,21,22,55,77
8961,Longevelle-lès-Russey,25344,25,3,10,0,18,6,24,13
8962,Longevelle-sur-Doubs,25345,25,60,164,48,236,172,456,224
8963,Longeville,25346,25,16,48,20,60,16,96,64
8964,La Longeville,25347,25,42,210,62,256,142,460,252
8965,Longevilles-Mont-d'Or,25348,25,36,139,49,104,126,279,175
8966,Loray,25349,25,75,145,85,85,120,290,220
8967,Lougres,25350,25,115,190,30,263,175,468,305
8968,Le Luhier,25351,25,12,28,56,64,28,148,40
8969,Luxiol,25354,25,35,35,10,30,40,80,70
8970,Magny-Châtelard,25355,25,5,25,5,10,20,35,30
8971,Maîche,25356,25,632,899,601,1191,761,2553,1531
8972,Maisons-du-Bois-Lièvremont,25357,25,24,215,92,194,174,460,239
8973,Malans,25359,25,15,45,5,35,65,105,60
8974,Malbrans,25360,25,12,40,0,56,32,88,52
8975,Malbuisson,25361,25,84,240,123,202,218,543,324
8976,Malpas,25362,25,8,69,28,55,69,152,77
8977,Mamirolle,25364,25,108,420,132,520,292,944,528
8978,Mancenans,25365,25,55,85,35,85,60,180,140
8979,Mancenans-Lizerne,25366,25,8,48,20,48,56,124,56
8980,Mandeure,25367,25,717,1023,530,1685,844,3059,1740
8981,Marchaux,25368,25,118,343,106,409,197,712,461
8982,Marvelise,25369,25,0,35,17,44,29,90,35
8983,Mathay,25370,25,292,524,192,820,344,1356,816
8984,Mazerolles-le-Salin,25371,25,35,60,10,90,15,115,95
8985,Médière,25372,25,25,55,5,162,46,213,80
8986,Le Mémont,25373,25,9,4,4,0,8,12,13
8987,Mercey-le-Grand,25374,25,52,156,60,145,106,311,208
8988,Mérey-sous-Montrond,25375,25,53,130,20,118,95,233,183
8989,Mérey-Vieilley,25376,25,26,34,12,24,33,69,60
8990,Mésandans,25377,25,10,75,10,65,55,130,85
8991,Meslières,25378,25,68,80,24,108,76,208,148
8992,Mesmay,25379,25,12,13,0,26,0,26,25
8993,Métabief,25380,25,67,245,179,353,278,810,312
8994,Miserey-Salines,25381,25,264,534,215,811,459,1485,798
8995,Moncey,25382,25,45,157,55,130,152,337,202
8996,Moncley,25383,25,15,80,39,69,54,162,95
8997,Mondon,25384,25,8,34,8,18,21,47,42
8998,Montagney-Servigney,25385,25,8,29,12,52,12,76,37
8999,Montancy,25386,25,0,35,10,45,40,95,35
9000,Montandon,25387,25,37,125,24,91,103,218,162
9001,Montbéliard,25388,25,3229,6327,3154,7304,4644,15102,9556
9002,Montbéliardot,25389,25,12,32,8,40,24,72,44
9003,Montbenoît,25390,25,10,135,40,110,115,265,145
9004,Mont-de-Laval,25391,25,18,38,6,57,26,89,56
9005,Mont-de-Vougney,25392,25,13,44,9,37,40,86,57
9006,Montécheroux,25393,25,80,148,48,212,112,372,228
9007,Montenois,25394,25,104,464,112,504,336,952,568
9008,Montfaucon,25395,25,192,390,68,558,281,907,582
9009,Montferrand-le-Château,25397,25,225,451,150,656,371,1177,676
9010,Montflovin,25398,25,3,24,6,23,16,45,27
9011,Montfort,25399,25,10,20,0,30,25,55,30
9012,Montgesoye,25400,25,75,110,30,165,90,285,185
9013,Montivernage,25401,25,5,5,5,10,10,25,10
9014,Montjoie-le-Château,25402,25,5,5,5,0,5,10,10
9015,Montlebon,25403,25,180,513,208,644,453,1305,693
9016,Montmahoux,25404,25,16,38,0,27,31,58,54
9017,Montperreux,25405,25,106,247,70,179,181,430,353
9018,Montrond-le-Château,25406,25,50,165,35,210,120,365,215
9019,Montussaint,25408,25,15,20,0,20,10,30,35
9020,Morre,25410,25,140,340,124,412,290,826,480
9021,Morteau,25411,25,641,1487,1155,1888,1434,4477,2128
9022,Mouthe,25413,25,131,213,127,260,174,561,344
9023,Le Moutherot,25414,25,0,55,10,40,40,90,55
9024,Mouthier-Haute-Pierre,25415,25,55,42,9,128,41,178,97
9025,Myon,25416,25,30,33,9,70,19,98,63
9026,Naisey-les-Granges,25417,25,72,233,104,196,184,484,305
9027,Nancray,25418,25,141,329,125,498,195,818,470
9028,Nans,25419,25,15,5,15,40,5,60,20
9029,Nans-sous-Sainte-Anne,25420,25,18,30,0,38,30,68,48
9030,Narbief,25421,25,15,25,5,5,20,30,40
9031,Neuchâtel-Urtière,25422,25,22,46,27,63,12,102,68
9032,Les Premiers Sapins,25424,25,195,427,111,426,315,852,622
9033,Noël-Cerneux,25425,25,16,116,48,108,96,252,132
9034,Noirefontaine,25426,25,24,100,52,140,88,280,124
9035,Noironte,25427,25,32,92,36,128,76,240,124
9036,Nommay,25428,25,336,396,120,484,332,936,732
9037,Novillars,25429,25,140,425,135,415,250,800,565
9038,Ollans,25430,25,3,3,0,15,6,21,6
9039,Onans,25431,25,40,80,15,136,80,231,120
9040,Orchamps-Vennes,25432,25,197,510,286,576,431,1293,707
9041,Orgeans-Blanchefontaine,25433,25,0,8,16,8,16,40,8
9042,Ornans,25434,25,709,976,336,1358,790,2484,1685
9043,Orsans,25435,25,0,39,12,48,36,96,39
9044,Orve,25436,25,9,17,3,22,13,38,26
9045,Osse,25437,25,34,72,24,108,52,184,106
9046,Osselle-Routelle,25438,25,133,220,93,296,174,563,353
9047,Ougney-Douvot,25439,25,25,49,4,70,35,109,74
9048,Ouhans,25440,25,31,99,26,97,64,187,130
9049,Ouvans,25441,25,5,15,5,30,10,45,20
9050,Oye-et-Pallet,25442,25,36,194,60,215,175,450,230
9051,Palantine,25443,25,0,34,4,4,24,32,34
9052,Palise,25444,25,10,40,10,60,25,95,50
9053,Paroy,25445,25,4,22,0,42,30,72,26
9054,Passavant,25446,25,20,65,25,65,35,125,85
9055,Passonfontaine,25447,25,24,100,24,68,67,159,124
9056,Pelousey,25448,25,88,496,104,469,280,853,584
9057,Péseux,25449,25,20,16,8,44,16,68,36
9058,Pessans,25450,25,5,35,0,20,35,55,40
9059,Petite-Chaux,25451,25,5,40,20,60,30,110,45
9060,Pierrefontaine-lès-Blamont,25452,25,43,112,30,121,83,234,155
9061,Pierrefontaine-les-Varans,25453,25,240,375,110,405,285,800,615
9062,Pirey,25454,25,210,500,140,715,395,1250,710
9063,Placey,25455,25,15,50,5,75,45,125,65
9064,Plaimbois-du-Miroir,25456,25,25,55,60,30,50,140,80
9065,Plaimbois-Vennes,25457,25,24,16,0,44,0,44,40
9066,Les Plains-et-Grands-Essarts,25458,25,5,70,29,90,54,173,75
9067,La Planée,25459,25,32,68,36,68,48,152,100
9068,Pointvillers,25460,25,8,38,24,25,34,83,46
9069,Pompierre-sur-Doubs,25461,25,12,72,4,113,57,174,84
9070,Pontarlier,25462,25,2316,3799,2591,5044,3311,10946,6115
9071,Pont-de-Roide-Vermondans,25463,25,705,848,394,1498,651,2543,1553
9072,Les Pontets,25464,25,6,52,0,44,13,57,58
9073,Pont-les-Moulins,25465,25,27,36,16,48,19,83,63
9074,Pouilley-Français,25466,25,75,235,60,220,210,490,310
9075,Pouilley-les-Vignes,25467,25,221,488,92,761,287,1140,709
9076,Pouligney-Lusans,25468,25,75,233,54,223,191,468,308
9077,Présentevillers,25469,25,54,69,32,195,33,260,123
9078,La Prétière,25470,25,30,30,10,70,15,95,60
9079,Provenchère,25471,25,12,34,0,40,16,56,46
9080,Puessans,25472,25,5,15,5,10,5,20,20
9081,Pugey,25473,25,120,165,50,250,146,446,285
9082,Le Puy,25474,25,8,43,28,4,21,53,51
9083,Quingey,25475,25,109,337,182,244,231,657,446
9084,Rahon,25476,25,20,35,30,35,20,85,55
9085,Rancenay,25477,25,12,44,16,119,40,175,56
9086,Randevillers,25478,25,32,20,4,40,16,60,52
9087,Rang,25479,25,75,100,40,110,95,245,175
9088,Raynans,25481,25,35,100,50,80,75,205,135
9089,Recologne,25482,25,64,162,76,196,124,396,226
9090,Reculfoz,25483,25,4,4,8,24,0,32,8
9091,Rémondans-Vaivre,25485,25,42,51,13,41,64,118,93
9092,Remoray-Boujeons,25486,25,37,129,16,86,123,225,166
9093,Renédale,25487,25,4,12,0,12,4,16,16
9094,Rennes-sur-Loue,25488,25,4,17,4,25,21,50,21
9095,Reugney,25489,25,25,120,30,90,50,170,145
9096,Rigney,25490,25,50,105,30,125,85,240,155
9097,Rignosot,25491,25,44,16,12,28,24,64,60
9098,Rillans,25492,25,6,17,9,29,12,50,23
9099,La Rivière-Drugeon,25493,25,75,265,120,230,205,555,340
9100,Rochejean,25494,25,32,207,92,130,174,396,239
9101,Roche-lez-Beaupré,25495,25,333,384,181,633,429,1243,717
9102,Roche-lès-Clerval,25496,25,12,40,20,32,16,68,52
9103,Roches-lès-Blamont,25497,25,65,147,73,268,80,421,212
9104,Rognon,25498,25,12,4,4,20,0,24,16
9105,Romain,25499,25,12,37,24,20,32,76,49
9106,Ronchaux,25500,25,20,32,12,4,20,36,52
9107,Rondefontaine,25501,25,0,3,6,3,3,12,3
9108,Roset-Fluans,25502,25,52,144,84,120,100,304,196
9109,Rosières-sur-Barbèche,25503,25,15,30,5,40,30,75,45
9110,Rosureux,25504,25,15,15,5,15,25,45,30
9111,Rougemont,25505,25,139,238,84,398,169,651,377
9112,Rougemontot,25506,25,4,22,0,60,8,68,26
9113,Rouhe,25507,25,16,24,4,28,16,48,40
9114,Roulans,25508,25,135,280,85,415,215,715,415
9115,Ruffey-le-Château,25510,25,21,81,17,91,104,212,102
9116,Rurey,25511,25,45,95,30,80,75,185,140
9117,Le Russey,25512,25,264,563,397,560,463,1420,827
9118,Sainte-Anne,25513,25,0,5,0,25,5,30,5
9119,Saint-Antoine,25514,25,4,87,33,131,39,203,91
9120,Sainte-Colombe,25515,25,31,98,33,99,97,229,129
9121,Saint-Georges-Armont,25516,25,5,40,5,60,20,85,45
9122,Saint-Gorgon-Main,25517,25,40,85,35,40,75,150,125
9123,Saint-Hilaire,25518,25,5,50,14,34,40,88,55
9124,Saint-Hippolyte,25519,25,200,175,60,290,175,525,375
9125,Saint-Juan,25520,25,25,45,20,35,40,95,70
9126,Saint-Julien-lès-Montbéliard,25521,25,9,29,6,75,12,93,38
9127,Saint-Julien-lès-Russey,25522,25,20,44,4,36,36,76,64
9128,Sainte-Marie,25523,25,125,156,15,283,105,403,281
9129,Saint-Maurice-Colombier,25524,25,120,232,76,256,200,532,352
9130,Saint-Point-Lac,25525,25,20,56,33,67,47,147,76
9131,Sainte-Suzanne,25526,25,168,409,204,408,336,948,577
9132,Saint-Vit,25527,25,498,1302,499,1486,921,2906,1800
9133,Samson,25528,25,5,20,0,20,30,50,25
9134,Sancey,25529,25,211,324,111,404,191,706,535
9135,Santoche,25531,25,0,25,0,25,25,50,25
9136,Saône,25532,25,435,896,228,933,639,1800,1331
9137,Saraz,25533,25,0,0,10,5,0,15,0
9138,Sarrageois,25534,25,36,48,16,28,40,84,84
9139,Saules,25535,25,15,75,10,75,65,150,90
9140,Sauvagney,25536,25,20,30,20,41,30,91,50
9141,Scey-Maisières,25537,25,40,70,25,85,75,185,110
9142,Séchin,25538,25,30,35,25,20,15,60,65
9143,Seloncourt,25539,25,899,1158,626,2076,930,3632,2057
9144,Semondans,25540,25,30,62,22,79,51,152,92
9145,Septfontaines,25541,25,20,95,35,130,60,225,115
9146,Serre-les-Sapins,25542,25,155,435,120,525,327,972,590
9147,Servin,25544,25,24,48,24,56,28,108,72
9148,Silley-Amancey,25545,25,28,32,16,48,12,76,60
9149,Silley-Bléfond,25546,25,6,13,7,23,10,40,19
9150,Sochaux,25547,25,450,950,341,1213,757,2311,1400
9151,Solemont,25548,25,24,36,20,60,28,108,60
9152,Sombacour,25549,25,48,196,60,196,124,380,244
9153,La Sommette,25550,25,16,66,34,41,34,109,82
9154,Soulce-Cernay,25551,25,9,19,0,46,15,61,28
9155,Sourans,25552,25,0,30,15,55,35,105,30
9156,Soye,25553,25,45,105,20,105,105,230,150
9157,Surmont,25554,25,24,36,16,32,28,76,60
9158,Taillecourt,25555,25,169,240,80,325,210,615,409
9159,Tallans,25556,25,0,16,12,4,12,28,16
9160,Tallenay,25557,25,40,85,25,190,65,280,125
9161,Tarcenay,25558,25,81,308,72,249,263,584,389
9162,Thiébouhans,25559,25,28,80,24,40,60,124,108
9163,Thise,25560,25,553,658,160,1166,426,1752,1211
9164,Thoraise,25561,25,34,84,30,79,89,198,118
9165,Thulay,25562,25,9,59,30,60,38,128,68
9166,Thurey-le-Mont,25563,25,12,21,4,40,20,64,33
9167,Torpes,25564,25,97,355,97,247,283,627,452
9168,Touillon-et-Loutelet,25565,25,8,69,38,38,55,131,77
9169,La Tour-de-Sçay,25566,25,15,70,0,85,80,165,85
9170,Tournans,25567,25,20,28,25,68,18,111,48
9171,Trépot,25569,25,69,151,33,101,130,264,220
9172,Tressandans,25570,25,5,5,0,10,10,20,10
9173,Trévillers,25571,25,49,83,62,126,104,292,132
9174,Trouvans,25572,25,15,25,0,35,15,50,40
9175,Urtière,25573,25,0,3,0,3,0,3,3
9176,Uzelle,25574,25,20,44,12,76,20,108,64
9177,Vaire-Arcier,25575,25,47,88,51,189,110,350,135
9178,Vaire-le-Petit,25576,25,45,60,10,64,50,124,105
9179,Valdahon,25578,25,574,1354,522,1237,945,2704,1928
9180,Val-de-Roulans,25579,25,0,61,33,52,36,121,61
9181,Valentigney,25580,25,1536,2437,1027,3242,1620,5889,3973
9182,Valleroy,25582,25,15,60,5,55,35,95,75
9183,Valonne,25583,25,20,49,20,79,43,142,69
9184,Valoreille,25584,25,16,44,12,32,28,72,60
9185,Vandoncourt,25586,25,85,235,65,326,160,551,320
9186,Vauchamps,25587,25,5,35,15,60,15,90,40
9187,Vaucluse,25588,25,4,16,8,16,33,57,20
9188,Vauclusotte,25589,25,12,24,8,36,12,56,36
9189,Vaudrivillers,25590,25,21,16,0,16,12,28,37
9190,Vaufrey,25591,25,24,21,16,28,28,72,45
9191,Vaux-et-Chantegrue,25592,25,68,132,64,123,117,304,200
9192,Vaux-les-Prés,25593,25,21,71,48,126,65,239,92
9193,Velesmes-Essarts,25594,25,28,88,12,132,68,212,116
9194,Vellerot-lès-Belvoir,25595,25,0,10,5,60,20,85,10
9195,Vellerot-lès-Vercel,25596,25,4,24,0,28,8,36,28
9196,Vellevans,25597,25,55,54,13,42,34,89,109
9197,Venise,25598,25,35,175,25,125,145,295,210
9198,Vennans,25599,25,20,70,35,60,65,160,90
9199,Vennes,25600,25,4,40,16,64,32,112,44
9200,Vercel-Villedieu-le-Camp,25601,25,156,416,148,388,336,872,572
9201,Vergranne,25602,25,4,27,12,24,16,52,31
9202,Verne,25604,25,15,25,10,35,30,75,40
9203,Vernierfontaine,25605,25,56,128,88,108,68,264,184
9204,Vernois-lès-Belvoir,25607,25,0,8,4,24,8,36,8
9205,Le Vernoy,25608,25,10,45,35,40,30,105,55
9206,Verrières-de-Joux,25609,25,60,103,31,93,74,198,163
9207,Verrières-du-Grosbois,25610,25,0,21,12,12,4,28,21
9208,La Vèze,25611,25,65,100,65,129,110,304,165
9209,Vieilley,25612,25,81,161,84,189,106,379,242
9210,Viéthorey,25613,25,15,35,0,40,25,65,50
9211,Vieux-Charmont,25614,25,542,581,260,767,540,1567,1123
9212,Villars-lès-Blamont,25615,25,35,110,55,140,95,290,145
9213,Villars-Saint-Georges,25616,25,26,56,30,76,35,141,82
9214,Villars-sous-Dampjoux,25617,25,80,80,25,125,55,205,160
9215,Villars-sous-Écot,25618,25,26,60,23,137,58,218,86
9216,Les Villedieu,25619,25,20,52,20,52,40,112,72
9217,Ville-du-Pont,25620,25,25,80,15,115,60,190,105
9218,Villeneuve-d'Amont,25621,25,24,36,29,59,19,107,60
9219,Villers-Buzon,25622,25,27,62,20,69,48,137,89
9220,Villers-Chief,25623,25,12,25,8,40,25,73,37
9221,Villers-Grélot,25624,25,10,35,25,50,30,105,45
9222,Villers-la-Combe,25625,25,4,13,12,24,0,36,17
9223,Villers-Saint-Martin,25626,25,25,40,35,90,25,150,65
9224,Villers-sous-Chalamont,25627,25,34,44,62,80,20,162,78
9225,Villers-sous-Montrond,25628,25,25,55,20,60,35,115,80
9226,Voillans,25629,25,8,60,28,80,36,144,68
9227,Voires,25630,25,5,20,0,35,20,55,25
9228,Vorges-les-Pins,25631,25,30,172,38,195,113,346,202
9229,Voujeaucourt,25632,25,404,750,306,1285,580,2171,1154
9230,Vuillafans,25633,25,116,197,37,165,139,341,313
9231,Vuillecin,25634,25,94,151,81,157,107,345,245
9232,Vyt-lès-Belvoir,25635,25,29,29,13,40,29,82,58
9233,Solaure en Diois,26001,26,80,100,44,113,68,225,180
9234,Albon,26002,26,123,466,177,678,316,1171,589
9235,Aleyrac,26003,26,10,0,0,25,5,30,10
9236,Alixan,26004,26,181,642,271,772,508,1551,823
9237,Allan,26005,26,173,408,108,610,296,1014,581
9238,Allex,26006,26,217,650,150,894,470,1514,867
9239,Ambonil,26007,26,12,36,28,32,16,76,48
9240,Ancône,26008,26,129,372,151,331,331,813,501
9241,Andancette,26009,26,143,330,113,400,263,776,473
9242,Anneyron,26010,26,576,921,368,1199,736,2303,1497
9243,Aouste-sur-Sye,26011,26,252,660,212,756,492,1460,912
9244,Arnayon,26012,26,0,4,0,12,4,16,4
9245,Arpavon,26013,26,5,15,15,25,15,55,20
9246,Arthémonay,26014,26,28,160,56,160,156,372,188
9247,Aubenasson,26015,26,3,26,0,12,20,32,29
9248,Aubres,26016,26,81,82,8,112,70,190,163
9249,Aucelon,26017,26,4,8,0,8,0,8,12
9250,Aulan,26018,26,0,4,0,8,0,8,4
9251,Aurel,26019,26,56,41,12,58,28,98,97
9252,La Répara-Auriples,26020,26,43,15,15,109,35,159,58
9253,Autichamp,26021,26,25,30,5,30,30,65,55
9254,Ballons,26022,26,16,12,0,28,8,36,28
9255,Barbières,26023,26,136,299,80,233,231,544,435
9256,Barcelonne,26024,26,33,92,12,83,83,178,125
9257,Barnave,26025,26,34,41,4,63,33,100,75
9258,Barret-de-Lioure,26026,26,28,0,8,44,0,52,28
9259,Barsac,26027,26,15,41,15,35,50,100,56
9260,Bathernay,26028,26,15,65,25,75,55,155,80
9261,La Bâtie-des-Fonds,26030,26,0,0,0,0,0,0,0
9262,La Bâtie-Rolland,26031,26,104,228,73,313,193,579,332
9263,La Baume-Cornillane,26032,26,45,95,55,155,95,305,140
9264,La Baume-de-Transit,26033,26,69,215,80,270,160,510,284
9265,La Baume-d'Hostun,26034,26,20,172,56,192,124,372,192
9266,Beaufort-sur-Gervanne,26035,26,56,136,28,128,104,260,192
9267,Beaumont-en-Diois,26036,26,0,16,0,44,20,64,16
9268,Beaumont-lès-Valence,26037,26,610,833,335,1323,560,2218,1443
9269,Beaumont-Monteux,26038,26,46,328,103,455,261,819,374
9270,Beauregard-Baret,26039,26,71,196,49,245,155,449,267
9271,Beaurières,26040,26,44,24,0,20,8,28,68
9272,Beausemblant,26041,26,95,439,100,453,348,901,534
9273,Beauvallon,26042,26,168,290,66,631,236,933,458
9274,Beauvoisin,26043,26,9,33,3,47,34,84,42
9275,La Bégude-de-Mazenc,26045,26,191,417,134,621,300,1055,608
9276,Bellecombe-Tarendol,26046,26,15,10,3,24,12,39,25
9277,Bellegarde-en-Diois,26047,26,15,13,0,15,16,31,28
9278,Bénivay-Ollon,26048,26,9,6,0,31,9,40,15
9279,Bésayes,26049,26,119,272,60,342,214,616,391
9280,Bésignan,26050,26,20,8,0,20,8,28,28
9281,Bézaudun-sur-Bîne,26051,26,16,20,3,9,25,37,36
9282,Bonlieu-sur-Roubion,26052,26,25,134,21,103,122,246,159
9283,Bouchet,26054,26,181,372,97,416,303,816,553
9284,Boulc,26055,26,20,40,5,45,20,70,60
9285,Bourdeaux,26056,26,128,108,32,188,100,320,236
9286,Bourg-de-Péage,26057,26,1441,2388,1025,3202,1860,6087,3829
9287,Bourg-lès-Valence,26058,26,2544,4712,1958,6526,3504,11988,7256
9288,Bouvante,26059,26,40,52,20,84,56,160,92
9289,Bouvières,26060,26,24,20,0,56,24,80,44
9290,Bren,26061,26,76,108,76,188,84,348,184
9291,Brette,26062,26,0,8,0,8,12,20,8
9292,Buis-les-Baronnies,26063,26,470,386,73,797,330,1200,856
9293,Chabeuil,26064,26,628,1765,711,2333,1322,4366,2393
9294,Chabrillan,26065,26,100,168,64,192,140,396,268
9295,Le Chaffal,26066,26,9,9,6,9,6,21,18
9296,Chalancon,26067,26,6,0,3,15,6,24,6
9297,Le Chalon,26068,26,15,55,5,90,45,140,70
9298,Chamaloc,26069,26,13,16,16,32,12,60,29
9299,Chamaret,26070,26,84,120,40,236,84,360,204
9300,Chanos-Curson,26071,26,80,314,64,333,210,607,394
9301,Chantemerle-les-Blés,26072,26,96,377,120,369,273,762,473
9302,Chantemerle-lès-Grignan,26073,26,4,48,20,140,36,196,52
9303,La Chapelle-en-Vercors,26074,26,141,132,16,208,101,325,273
9304,La Charce,26075,26,17,8,0,0,8,8,25
9305,Charens,26076,26,0,4,0,25,0,25,4
9306,Charmes-sur-l'Herbasse,26077,26,88,238,94,265,187,546,326
9307,Charols,26078,26,69,273,44,209,222,475,342
9308,Charpey,26079,26,176,360,136,320,294,750,536
9309,Chastel-Arnaud,26080,26,0,10,0,25,5,30,10
9310,Châteaudouble,26081,26,68,164,48,152,144,344,232
9311,Châteauneuf-de-Bordette,26082,26,20,10,5,50,5,60,30
9312,Châteauneuf-de-Galaure,26083,26,253,401,89,398,259,746,654
9313,Châteauneuf-sur-Isère,26084,26,390,945,400,1301,649,2350,1335
9314,Châteauneuf-du-Rhône,26085,26,229,659,274,941,487,1702,888
9315,Châtillon-en-Diois,26086,26,109,70,60,230,64,354,179
9316,Châtillon-Saint-Jean,26087,26,152,420,66,429,202,697,572
9317,Chatuzange-le-Goubet,26088,26,416,1340,470,1946,989,3405,1756
9318,Chaudebonne,26089,26,15,5,15,15,0,30,20
9319,La Chaudière,26090,26,0,4,0,16,0,16,4
9320,Chauvac-Laux-Montaux,26091,26,15,6,0,16,6,22,21
9321,Chavannes,26092,26,55,193,75,185,162,422,248
9322,Clansayes,26093,26,56,100,24,232,84,340,156
9323,Claveyson,26094,26,130,235,70,255,170,495,365
9324,Cléon-d'Andran,26095,26,200,180,55,260,160,475,380
9325,Clérieux,26096,26,256,549,120,610,369,1099,805
9326,Cliousclat,26097,26,95,130,55,270,105,430,225
9327,Cobonne,26098,26,25,35,25,55,45,125,60
9328,Colonzelle,26099,26,63,87,38,196,95,329,150
9329,Combovin,26100,26,38,100,5,169,115,289,138
9330,Comps,26101,26,4,56,0,80,32,112,60
9331,Condillac,26102,26,25,30,5,55,25,85,55
9332,Condorcet,26103,26,48,85,20,178,80,278,133
9333,Cornillac,26104,26,25,10,0,25,10,35,35
9334,Cornillon-sur-l'Oule,26105,26,45,5,0,30,0,30,50
9335,La Coucourde,26106,26,92,284,100,320,204,624,376
9336,Crépol,26107,26,90,170,40,180,85,305,260
9337,Crest,26108,26,1223,1810,709,2608,1460,4777,3033
9338,Crozes-Hermitage,26110,26,40,194,30,178,163,371,234
9339,Crupies,26111,26,20,20,8,12,28,48,40
9340,Curnier,26112,26,35,45,5,60,40,105,80
9341,Die,26113,26,712,905,349,1639,625,2613,1617
9342,Dieulefit,26114,26,630,517,156,1081,414,1651,1147
9343,Divajeu,26115,26,71,151,61,185,83,329,222
9344,Donzère,26116,26,506,1533,638,1646,1030,3314,2039
9345,Échevis,26117,26,15,20,0,24,5,29,35
9346,Épinouze,26118,26,171,468,159,483,322,964,639
9347,Érôme,26119,26,52,222,102,244,152,498,274
9348,Espeluche,26121,26,170,245,70,405,170,645,415
9349,Espenel,26122,26,20,40,12,68,16,96,60
9350,Establet,26123,26,0,16,4,20,4,28,16
9351,Étoile-sur-Rhône,26124,26,484,1392,546,1710,1040,3296,1876
9352,Eurre,26125,26,133,315,85,484,235,804,448
9353,Eygalayes,26126,26,9,7,0,27,3,30,16
9354,Eygaliers,26127,26,8,27,17,29,8,54,35
9355,Eygluy-Escoulin,26128,26,16,8,0,12,8,20,24
9356,Eymeux,26129,26,60,339,60,245,319,624,399
9357,Eyroles,26130,26,0,4,0,16,4,20,4
9358,Eyzahut,26131,26,16,22,0,56,16,72,38
9359,Fay-le-Clos,26133,26,12,32,12,76,36,124,44
9360,Félines-sur-Rimandoule,26134,26,3,10,0,25,17,42,13
9361,Ferrassières,26135,26,30,15,0,65,10,75,45
9362,Val-Maravel,26136,26,0,5,0,35,9,44,5
9363,Francillon-sur-Roubion,26137,26,25,39,0,74,16,90,64
9364,La Garde-Adhémar,26138,26,150,225,105,457,115,677,375
9365,Génissieux,26139,26,228,488,76,868,292,1236,716
9366,Geyssans,26140,26,40,192,72,249,144,465,232
9367,Gigors-et-Lozeron,26141,26,28,40,0,56,52,108,68
9368,Glandage,26142,26,12,12,8,41,4,53,24
9369,Le Grand-Serre,26143,26,128,244,88,244,168,500,372
9370,Grane,26144,26,222,420,149,570,431,1150,642
9371,Les Granges-Gontardes,26145,26,60,165,50,220,115,385,225
9372,Grignan,26146,26,255,250,60,657,200,917,505
9373,Gumiane,26147,26,5,0,5,10,0,15,5
9374,Hauterives,26148,26,272,432,140,592,292,1024,704
9375,Hostun,26149,26,114,238,81,265,190,536,352
9376,Izon-la-Bruisse,26150,26,0,5,0,0,10,10,5
9377,Jonchères,26152,26,0,3,0,15,3,18,3
9378,Laborel,26153,26,10,15,10,55,10,75,25
9379,Lachau,26154,26,63,26,12,70,8,90,89
9380,Lapeyrouse-Mornay,26155,26,137,303,120,320,250,690,440
9381,Larnage,26156,26,92,296,95,324,193,612,388
9382,La Laupie,26157,26,56,228,56,206,209,471,284
9383,Laval-d'Aix,26159,26,10,15,10,90,10,110,25
9384,Laveyron,26160,26,114,364,84,350,177,611,478
9385,Lemps,26161,26,4,0,8,28,0,36,4
9386,Lens-Lestang,26162,26,105,192,49,297,103,449,297
9387,Léoncel,26163,26,0,18,0,36,12,48,18
9388,Lesches-en-Diois,26164,26,9,0,0,19,0,19,9
9389,Livron-sur-Drôme,26165,26,1035,2300,905,2875,1695,5475,3335
9390,Loriol-sur-Drôme,26166,26,766,1693,572,2031,1142,3745,2459
9391,Luc-en-Diois,26167,26,119,52,32,96,61,189,171
9392,Lus-la-Croix-Haute,26168,26,101,118,30,159,81,270,219
9393,Malataverne,26169,26,193,496,201,664,351,1216,689
9394,Malissard,26170,26,436,663,280,1412,440,2132,1099
9395,Manas,26171,26,23,45,30,84,25,139,68
9396,Manthes,26172,26,76,180,80,212,116,408,256
9397,Marches,26173,26,80,194,95,242,90,427,274
9398,Margès,26174,26,57,299,91,316,258,665,356
9399,Marignac-en-Diois,26175,26,31,48,4,52,48,104,79
9400,Marsanne,26176,26,132,302,100,467,198,765,434
9401,Marsaz,26177,26,75,240,88,283,95,466,315
9402,Menglon,26178,26,84,92,24,164,80,268,176
9403,Mercurol-Veaunes,26179,26,264,642,172,798,516,1486,906
9404,Mérindol-les-Oliviers,26180,26,39,26,25,64,29,118,65
9405,Mévouillon,26181,26,28,56,8,92,44,144,84
9406,Mirabel-aux-Baronnies,26182,26,249,286,125,573,227,925,535
9407,Mirabel-et-Blacons,26183,26,164,225,100,320,190,610,389
9408,Miribel,26184,26,20,84,44,100,60,204,104
9409,Mirmande,26185,26,42,110,37,178,110,325,152
9410,Miscon,26186,26,0,5,10,25,15,50,5
9411,Mollans-sur-Ouvèze,26188,26,250,180,94,364,159,617,430
9412,Montauban-sur-l'Ouvèze,26189,26,12,4,4,45,16,65,16
9413,Montaulieu,26190,26,12,13,0,16,17,33,25
9414,Montboucher-sur-Jabron,26191,26,243,499,245,765,422,1432,742
9415,Montbrison-sur-Lez,26192,26,45,54,21,93,39,153,99
9416,Montbrun-les-Bains,26193,26,80,57,30,157,61,248,137
9417,Montchenu,26194,26,68,160,20,224,104,348,228
9418,Montclar-sur-Gervanne,26195,26,43,17,13,48,29,90,60
9419,Montéléger,26196,26,234,333,108,495,213,816,567
9420,Montélier,26197,26,375,1047,317,1445,687,2449,1422
9421,Montélimar,26198,26,5126,8659,4582,11474,6624,22680,13785
9422,Montferrand-la-Fare,26199,26,25,0,0,5,0,5,25
9423,Montfroc,26200,26,20,10,0,45,5,50,30
9424,Montguers,26201,26,3,9,0,15,9,24,12
9425,Montjoux,26202,26,44,60,53,101,70,224,104
9426,Montjoyer,26203,26,12,81,0,90,34,124,93
9427,Montlaur-en-Diois,26204,26,12,34,3,38,22,63,46
9428,Montmaur-en-Diois,26205,26,8,12,16,32,12,60,20
9429,Montmeyran,26206,26,320,755,195,1070,535,1800,1075
9430,Montmiral,26207,26,87,177,68,154,109,331,264
9431,Montoison,26208,26,108,541,158,678,355,1191,649
9432,Montréal-les-Sources,26209,26,6,3,0,15,0,15,9
9433,Montrigaud,26210,26,76,100,28,200,72,300,176
9434,Montségur-sur-Lauzon,26211,26,133,311,75,528,214,817,444
9435,Montvendre,26212,26,85,330,110,296,238,644,415
9436,Moras-en-Valloire,26213,26,108,140,44,180,144,368,248
9437,Mornans,26214,26,15,5,0,15,25,40,20
9438,La Motte-Chalancon,26215,26,82,69,26,137,28,191,151
9439,La Motte-de-Galaure,26216,26,108,240,36,248,160,444,348
9440,La Motte-Fanjas,26217,26,16,46,12,41,47,100,62
9441,Mours-Saint-Eusèbe,26218,26,352,731,211,1025,524,1760,1083
9442,Mureils,26219,26,40,134,42,144,70,256,174
9443,Nyons,26220,26,1500,1077,440,2356,786,3582,2577
9444,Omblèze,26221,26,8,12,8,24,12,44,20
9445,Orcinas,26222,26,4,13,0,4,16,20,17
9446,Oriol-en-Royans,26223,26,85,120,50,195,70,315,205
9447,Ourches,26224,26,24,55,16,90,43,149,79
9448,Parnans,26225,26,40,172,60,212,116,388,212
9449,Le Pègue,26226,26,60,55,10,168,80,258,115
9450,Pelonne,26227,26,0,10,0,10,10,20,10
9451,Pennes-le-Sec,26228,26,0,12,0,8,12,20,12
9452,La Penne-sur-l'Ouvèze,26229,26,20,16,0,40,20,60,36
9453,Peyrins,26231,26,356,643,195,929,439,1563,999
9454,Peyrus,26232,26,53,139,42,182,147,371,192
9455,Piégon,26233,26,35,35,15,133,30,178,70
9456,Piégros-la-Clastre,26234,26,135,205,60,335,125,520,340
9457,Pierrelatte,26235,26,1799,3262,1450,4105,2258,7813,5061
9458,Pierrelongue,26236,26,30,51,0,86,40,126,81
9459,Les Pilles,26238,26,22,49,12,103,39,154,71
9460,Plaisians,26239,26,25,40,10,64,57,131,65
9461,Plan-de-Baix,26240,26,12,28,8,44,28,80,40
9462,Le Poët-Célard,26241,26,21,17,4,42,35,81,38
9463,Le Poët-en-Percip,26242,26,0,4,4,8,0,12,4
9464,Le Poët-Laval,26243,26,119,181,43,332,112,487,300
9465,Le Poët-Sigillat,26244,26,10,45,15,55,25,95,55
9466,Pommerol,26245,26,12,0,0,4,4,8,12
9467,Ponet-et-Saint-Auban,26246,26,10,15,5,60,25,90,25
9468,Ponsas,26247,26,80,150,35,170,100,305,230
9469,Pontaix,26248,26,25,30,10,35,75,120,55
9470,Pont-de-Barret,26249,26,52,164,72,192,152,416,216
9471,Pont-de-l'Isère,26250,26,289,888,307,999,703,2009,1177
9472,Portes-en-Valdaine,26251,26,70,52,17,154,63,234,122
9473,Portes-lès-Valence,26252,26,1328,2652,1081,2844,1846,5771,3980
9474,Poyols,26253,26,9,7,6,22,13,41,16
9475,Pradelle,26254,26,0,5,0,5,10,15,5
9476,Les Prés,26255,26,0,0,6,6,3,15,0
9477,Propiac,26256,26,16,32,8,32,20,60,48
9478,Puygiron,26257,26,42,98,15,114,87,216,140
9479,Puy-Saint-Martin,26258,26,125,228,44,237,174,455,353
9480,Ratières,26259,26,37,58,0,105,40,145,95
9481,Réauville,26261,26,43,67,8,136,87,231,110
9482,Recoubeau-Jansac,26262,26,24,49,13,94,41,148,73
9483,Reilhanette,26263,26,28,12,16,68,20,104,40
9484,Rémuzat,26264,26,44,56,24,136,64,224,100
9485,Rimon-et-Savel,26266,26,10,15,0,20,0,20,25
9486,Rioms,26267,26,0,4,0,16,0,16,4
9487,Rochebaudin,26268,26,12,44,4,52,24,80,56
9488,Rochebrune,26269,26,0,27,0,34,14,48,27
9489,Rochechinard,26270,26,24,12,12,48,8,68,36
9490,La Roche-de-Glun,26271,26,272,853,284,1060,619,1963,1125
9491,Rochefort-en-Valdaine,26272,26,27,67,16,125,55,196,94
9492,Rochefort-Samson,26273,26,80,252,92,344,196,632,332
9493,Rochefourchat,26274,26,0,0,0,0,0,0,0
9494,Rochegude,26275,26,154,360,142,533,298,973,514
9495,Roche-Saint-Secret-Béconne,26276,26,52,88,28,184,60,272,140
9496,La Roche-sur-Grane,26277,26,28,36,8,55,13,76,64
9497,La Roche-sur-le-Buis,26278,26,24,76,20,132,56,208,100
9498,La Rochette-du-Buis,26279,26,5,15,10,30,10,50,20
9499,Romans-sur-Isère,26281,26,5043,7836,3737,10023,5731,19491,12879
9500,Romeyer,26282,26,15,65,15,65,50,130,80
9501,Rottier,26283,26,0,0,0,10,5,15,0
9502,Roussas,26284,26,48,92,20,128,80,228,140
9503,Rousset-les-Vignes,26285,26,20,40,35,168,25,228,60
9504,Roussieux,26286,26,4,0,0,8,0,8,4
9505,Roynac,26287,26,120,90,55,150,65,270,210
9506,Sahune,26288,26,45,75,20,125,59,204,120
9507,Saillans,26289,26,187,268,50,447,233,730,455
9508,Saint-Agnan-en-Vercors,26290,26,47,92,21,116,65,202,139
9509,Saint-Andéol,26291,26,12,12,0,20,12,32,24
9510,Saint-Auban-sur-l'Ouvèze,26292,26,32,35,0,82,30,112,67
9511,Saint-Avit,26293,26,25,107,13,62,68,143,132
9512,Saint-Bardoux,26294,26,56,153,38,187,113,338,209
9513,Saint-Barthélemy-de-Vals,26295,26,190,475,160,687,359,1206,665
9514,Saint-Benoit-en-Diois,26296,26,0,10,0,25,0,25,10
9515,Saint-Bonnet-de-Valclérieux,26297,26,25,50,30,80,30,140,75
9516,Saint-Christophe-et-le-Laris,26298,26,76,105,34,76,75,185,181
9517,Sainte-Croix,26299,26,25,20,5,39,15,59,45
9518,Saint-Dizier-en-Diois,26300,26,8,12,0,8,8,16,20
9519,Saint-Donat-sur-l'Herbasse,26301,26,570,967,359,1107,812,2278,1537
9520,Sainte-Eulalie-en-Royans,26302,26,85,135,40,180,95,315,220
9521,Sainte-Euphémie-sur-Ouvèze,26303,26,15,15,5,40,10,55,30
9522,Saint-Ferréol-Trente-Pas,26304,26,17,64,4,58,50,112,81
9523,Saint-Gervais-sur-Roubion,26305,26,84,258,113,246,212,571,342
9524,Sainte-Jalle,26306,26,52,48,12,96,60,168,100
9525,Saint-Jean-en-Royans,26307,26,473,561,280,1047,452,1779,1034
9526,Saint-Julien-en-Quint,26308,26,36,32,16,48,28,92,68
9527,Saint-Julien-en-Vercors,26309,26,52,44,28,100,16,144,96
9528,Saint-Laurent-d'Onay,26310,26,9,21,9,21,41,71,30
9529,Saint-Laurent-en-Royans,26311,26,183,290,100,398,184,682,473
9530,Saint-Marcel-lès-Sauzet,26312,26,148,326,96,389,217,702,474
9531,Saint-Marcel-lès-Valence,26313,26,651,1731,516,1663,1296,3475,2382
9532,Saint-Martin-d'Août,26314,26,35,95,50,110,80,240,130
9533,Saint-Martin-en-Vercors,26315,26,55,92,10,167,55,232,147
9534,Saint-Martin-le-Colonel,26316,26,8,45,16,60,39,115,53
9535,Saint-Maurice-sur-Eygues,26317,26,88,195,84,200,157,441,283
9536,Saint-May,26318,26,10,5,0,20,10,30,15
9537,Saint-Michel-sur-Savasse,26319,26,30,155,30,186,122,338,185
9538,Saint-Nazaire-en-Royans,26320,26,76,188,96,228,188,512,264
9539,Saint-Nazaire-le-Désert,26321,26,16,32,8,76,16,100,48
9540,Saint-Pantaléon-les-Vignes,26322,26,109,48,24,148,49,221,157
9541,Saint-Paul-lès-Romans,26323,26,135,415,206,614,297,1117,550
9542,Saint-Paul-Trois-Châteaux,26324,26,1044,2252,957,2831,1681,5469,3296
9543,Saint-Rambert-d'Albon,26325,26,625,1868,659,1630,1276,3565,2493
9544,Saint-Restitut,26326,26,172,276,136,560,212,908,448
9545,Saint-Roman,26327,26,44,48,12,68,4,84,92
9546,Saint-Sauveur-en-Diois,26328,26,20,16,0,16,8,24,36
9547,Saint-Sauveur-Gouvernet,26329,26,32,40,8,52,52,112,72
9548,Saint-Sorlin-en-Valloire,26330,26,247,618,161,654,405,1220,865
9549,Saint-Thomas-en-Royans,26331,26,48,121,36,136,114,286,169
9550,Saint-Uze,26332,26,214,561,145,533,470,1148,775
9551,Saint-Vallier,26333,26,445,874,425,1202,684,2311,1319
9552,Salettes,26334,26,32,32,8,36,24,68,64
9553,Salles-sous-Bois,26335,26,8,29,4,82,29,115,37
9554,Saou,26336,26,60,128,36,196,100,332,188
9555,Saulce-sur-Rhône,26337,26,240,466,191,608,268,1067,706
9556,Sauzet,26338,26,240,400,178,747,315,1240,640
9557,Savasse,26339,26,136,333,115,539,263,917,469
9558,Séderon,26340,26,75,45,10,120,25,155,120
9559,Serves-sur-Rhône,26341,26,40,185,75,255,160,490,225
9560,Solérieux,26342,26,40,80,30,120,75,225,120
9561,Souspierre,26343,26,25,15,0,45,15,60,40
9562,Soyans,26344,26,20,107,8,145,82,235,127
9563,Suze-la-Rousse,26345,26,226,502,148,692,405,1245,728
9564,Suze,26346,26,26,40,13,93,30,136,66
9565,Tain-l'Hermitage,26347,26,910,1369,659,1599,1135,3393,2279
9566,Taulignan,26348,26,324,308,100,580,280,960,632
9567,Tersanne,26349,26,10,130,25,135,65,225,140
9568,Teyssières,26350,26,4,8,0,24,21,45,12
9569,Les Tonils,26351,26,0,0,0,9,0,9,0
9570,La Touche,26352,26,21,46,20,75,34,129,67
9571,Les Tourrettes,26353,26,95,360,80,235,275,590,455
9572,Treschenu-Creyers,26354,26,25,15,5,70,0,75,40
9573,Triors,26355,26,60,145,20,210,84,314,205
9574,Truinas,26356,26,40,25,10,45,10,65,65
9575,Tulette,26357,26,264,448,216,632,332,1180,712
9576,Upie,26358,26,140,400,60,540,289,889,540
9577,Vachères-en-Quint,26359,26,0,0,10,10,10,30,0
9578,Valaurie,26360,26,80,126,48,168,99,315,206
9579,Valdrôme,26361,26,20,38,8,46,20,74,58
9580,Valence,26362,26,8757,14570,8606,17206,11265,37077,23327
9581,Valouse,26363,26,3,7,3,15,0,18,10
9582,Vassieux-en-Vercors,26364,26,75,70,35,115,35,185,145
9583,Vaunaveys-la-Rochette,26365,26,72,120,40,244,116,400,192
9584,Venterol,26367,26,59,110,49,282,111,442,169
9585,Vercheny,26368,26,56,124,20,103,69,192,180
9586,Verclause,26369,26,25,0,0,25,0,25,25
9587,Vercoiran,26370,26,12,36,8,68,20,96,48
9588,Véronne,26371,26,4,16,0,12,8,20,20
9589,Vers-sur-Méouge,26372,26,4,12,8,24,4,36,16
9590,Vesc,26373,26,52,49,12,64,52,128,101
9591,Villebois-les-Pins,26374,26,4,0,0,8,4,12,4
9592,Villefranche-le-Château,26375,26,0,12,0,8,8,16,12
9593,Villeperdrix,26376,26,36,8,0,34,16,50,44
9594,Vinsobres,26377,26,165,228,65,513,184,762,393
9595,Volvent,26378,26,0,28,0,20,16,36,28
9596,Granges-les-Beaumont,26379,26,100,200,110,398,130,638,300
9597,Gervans,26380,26,52,176,36,180,128,344,228
9598,Jaillans,26381,26,72,268,108,260,184,552,340
9599,Saint-Vincent-la-Commanderie,26382,26,36,136,76,128,132,336,172
9600,Aclou,27001,27,60,65,35,100,45,180,125
9601,Acon,27002,27,52,128,40,168,88,296,180
9602,Acquigny,27003,27,151,380,116,485,286,887,531
9603,Aigleville,27004,27,4,139,43,85,93,221,143
9604,Ailly,27005,27,80,370,55,355,290,700,450
9605,Aizier,27006,27,10,45,5,70,15,90,55
9606,Alizay,27008,27,92,396,176,428,360,964,488
9607,Ambenay,27009,27,64,164,56,184,116,356,228
9608,Amécourt,27010,27,10,30,20,70,25,115,40
9609,Amfreville-Saint-Amand,27011,27,144,311,122,370,222,714,455
9610,Amfreville-les-Champs,27012,27,10,140,63,185,70,318,150
9611,Amfreville-sous-les-Monts,27013,27,28,160,40,152,120,312,188
9612,Amfreville-sur-Iton,27014,27,77,205,44,258,146,448,282
9613,Andé,27015,27,93,322,48,427,276,751,415
9614,Les Andelys,27016,27,1019,2044,1018,2493,1323,4834,3063
9615,Angerville-la-Campagne,27017,27,48,276,88,468,228,784,324
9616,Appeville-Annebault,27018,27,130,190,110,338,205,653,320
9617,Armentières-sur-Avre,27019,27,20,55,5,60,40,105,75
9618,Arnières-sur-Iton,27020,27,156,398,84,563,275,922,554
9619,Asnières,27021,27,45,60,40,125,45,210,105
9620,Le Val d'Hazey,27022,27,445,1673,482,1752,1015,3249,2118
9621,Aulnay-sur-Iton,27023,27,140,200,34,204,165,403,340
9622,Autheuil-Authouillet,27025,27,60,249,116,289,212,617,309
9623,Authevernes,27026,27,8,94,43,102,75,220,102
9624,Les Authieux,27027,27,15,80,15,100,65,180,95
9625,Authou,27028,27,47,78,34,68,47,149,125
9626,Aviron,27031,27,114,230,54,455,187,696,344
9627,Chambois,27032,27,107,390,80,445,295,820,497
9628,Bacquepuis,27033,27,20,100,10,140,55,205,120
9629,Bacqueville,27034,27,51,183,61,148,120,329,234
9630,Bailleul-la-Vallée,27035,27,20,20,5,40,25,70,40
9631,Bâlines,27036,27,81,157,47,131,97,275,238
9632,Barc,27037,27,55,362,86,394,224,704,417
9633,Les Barils,27038,27,20,95,8,48,66,122,115
9634,Barneville-sur-Seine,27039,27,32,140,52,168,92,312,172
9635,Barquet,27040,27,29,101,31,121,116,268,130
9636,Barville,27042,27,0,6,3,25,9,37,6
9637,Les Baux-de-Breteuil,27043,27,125,173,65,183,133,381,298
9638,Les Baux-Sainte-Croix,27044,27,141,135,45,408,120,573,276
9639,Bazincourt-sur-Epte,27045,27,48,236,40,248,164,452,284
9640,Bazoques,27046,27,20,50,15,65,25,105,70
9641,Beaubray,27047,27,12,79,29,84,66,179,91
9642,Beauficel-en-Lyons,27048,27,28,48,0,88,32,120,76
9643,Mesnil-en-Ouche,27049,27,761,1201,348,1545,849,2742,1962
9644,Beaumontel,27050,27,111,150,23,258,95,376,261
9645,Beaumont-le-Roger,27051,27,500,780,316,780,552,1648,1280
9646,Le Bec-Hellouin,27052,27,60,68,16,160,84,260,128
9647,Le Bec-Thomas,27053,27,26,58,0,93,20,113,84
9648,Bémécourt,27054,27,48,88,36,182,80,298,136
9649,Bérengeville-la-Campagne,27055,27,32,88,12,116,64,192,120
9650,Bernay,27056,27,1697,2142,1047,3373,1685,6105,3839
9651,Bernienville,27057,27,16,60,20,96,72,188,76
9652,Bernières-sur-Seine,27058,27,16,76,20,128,84,232,92
9653,Bernouville,27059,27,15,82,34,81,49,164,97
9654,Berthouville,27061,27,55,75,15,80,65,160,130
9655,Berville-en-Roumois,27062,27,72,225,64,301,160,525,297
9656,Berville-la-Campagne,27063,27,12,76,12,52,62,126,88
9657,Berville-sur-Mer,27064,27,65,190,58,215,155,428,255
9658,Beuzeville,27065,27,646,1097,648,1099,889,2636,1743
9659,Bézu-la-Forêt,27066,27,12,101,0,106,43,149,113
9660,Bézu-Saint-Éloi,27067,27,125,430,140,475,305,920,555
9661,Bois-Anzeray,27068,27,36,48,12,52,36,100,84
9662,Bois-Arnault,27069,27,60,192,56,248,123,427,252
9663,Boisemont,27070,27,56,179,61,294,106,461,235
9664,Le Bois-Hellain,27071,27,25,65,25,45,70,140,90
9665,Bois-Jérôme-Saint-Ouen,27072,27,82,164,52,274,123,449,246
9666,Bois-le-Roi,27073,27,92,335,84,340,240,664,427
9667,Boisney,27074,27,40,64,20,112,64,196,104
9668,Bois-Normand-près-Lyre,27075,27,65,72,25,126,40,191,137
9669,Boisset-les-Prévanches,27076,27,68,112,36,112,112,260,180
9670,Boissey-le-Châtel,27077,27,88,236,84,276,192,552,324
9671,La Boissière,27078,27,21,65,17,89,37,143,86
9672,Boissy-Lamberville,27079,27,48,56,20,156,48,224,104
9673,Boncourt,27081,27,4,48,8,48,60,116,52
9674,La Bonneville-sur-Iton,27082,27,236,594,188,718,495,1401,830
9675,Bonneville-Aptot,27083,27,12,73,8,88,52,148,85
9676,Flancourt-Crescy-en-Roumois,27085,27,69,415,122,378,319,819,484
9677,Bosc-Renoult-en-Roumois,27089,27,30,85,10,190,85,285,115
9678,Le Bosc-Roger-en-Roumois,27090,27,368,769,287,1114,561,1962,1137
9679,Bosgouet,27091,27,76,164,56,220,132,408,240
9680,Bosguérard-de-Marcouville,27092,27,56,144,52,220,132,404,200
9681,Bosnormand,27093,27,30,81,23,103,57,183,111
9682,Bosquentin,27094,27,12,40,8,48,32,88,52
9683,Bosrobert,27095,27,43,178,33,189,139,361,221
9684,Les Bottereaux,27096,27,60,132,24,92,72,188,192
9685,Bouafles,27097,27,66,133,27,226,104,357,199
9686,Bouchevilliers,27098,27,4,21,8,24,12,44,25
9687,Le Boulay-Morin,27099,27,48,220,92,204,168,464,268
9688,Boulleville,27100,27,110,304,129,314,196,639,414
9689,Bouquelon,27101,27,24,117,60,144,76,280,141
9690,Bouquetot,27102,27,76,304,96,404,204,704,380
9691,Bourg-Achard,27103,27,423,925,234,908,728,1870,1348
9692,Bourg-Beaudouin,27104,27,31,217,63,230,126,419,248
9693,Grand Bourgtheroulde,27105,27,394,948,276,1124,822,2222,1342
9694,Bournainville-Faverolles,27106,27,58,123,50,184,68,302,181
9695,Bourneville-Sainte-Croix,27107,27,150,320,112,414,253,779,470
9696,Bourth,27108,27,200,290,105,445,205,755,490
9697,Bray,27109,27,35,96,44,87,56,187,131
9698,Brestot,27110,27,52,118,68,170,94,332,170
9699,Bretagnolles,27111,27,12,56,12,52,60,124,68
9700,Breteuil,27112,27,684,990,473,1323,750,2546,1674
9701,Brétigny,27113,27,10,30,20,55,25,100,40
9702,Breuilpont,27114,27,85,320,145,450,205,800,405
9703,Breux-sur-Avre,27115,27,35,70,20,180,25,225,105
9704,Brionne,27116,27,666,1035,438,1288,690,2416,1701
9705,Broglie,27117,27,116,284,104,388,216,708,400
9706,Brosville,27118,27,50,150,55,235,115,405,200
9707,Bueil,27119,27,173,364,100,541,288,929,537
9708,Burey,27120,27,30,105,30,125,80,235,135
9709,Caillouet-Orgeville,27123,27,33,110,35,145,90,270,143
9710,Cailly-sur-Eure,27124,27,28,56,20,64,52,136,84
9711,Calleville,27125,27,45,145,70,310,80,460,190
9712,Campigny,27126,27,71,352,90,376,232,698,423
9713,Canappeville,27127,27,50,170,55,180,185,420,220
9714,Caorches-Saint-Nicolas,27129,27,80,130,45,215,115,375,210
9715,Capelle-les-Grands,27130,27,56,124,32,132,80,244,180
9716,Carsix,27131,27,24,68,8,78,53,139,92
9717,Caugé,27132,27,90,214,43,292,174,509,304
9718,Caumont,27133,27,121,198,72,432,125,629,319
9719,Cauverville-en-Roumois,27134,27,8,68,12,56,80,148,76
9720,Cesseville,27135,27,37,105,43,99,130,272,142
9721,Chaignes,27136,27,12,47,24,103,29,156,59
9722,Chaise-Dieu-du-Theil,27137,27,57,41,6,86,23,115,98
9723,Chamblac,27138,27,77,85,26,106,71,203,162
9724,Chambord,27139,27,20,25,0,46,29,75,45
9725,Chambray,27140,27,40,95,65,175,45,285,135
9726,Champ-Dolent,27141,27,8,12,8,32,8,48,20
9727,Champenard,27142,27,0,75,40,50,78,168,75
9728,Champignolles,27143,27,0,0,5,20,5,30,0
9729,Champigny-la-Futelaye,27144,27,24,39,21,99,37,157,63
9730,La Chapelle-Bayvel,27146,27,60,108,12,100,96,208,168
9731,La Chapelle-du-Bois-des-Faulx,27147,27,24,153,60,176,145,381,177
9732,La Chapelle-Gauthier,27148,27,58,93,21,129,63,213,151
9733,La Chapelle-Hareng,27149,27,12,16,0,24,24,48,28
9734,La Chapelle-Réanville,27150,27,76,332,128,352,216,696,408
9735,Charleval,27151,27,245,425,200,615,315,1130,670
9736,Château-sur-Epte,27152,27,24,161,68,216,140,424,185
9737,Chauvincourt-Provemont,27153,27,8,90,9,121,61,191,98
9738,Chavigny-Bailleul,27154,27,30,135,56,183,102,341,165
9739,Chennebrun,27155,27,15,35,10,25,25,60,50
9740,Chéronvilliers,27156,27,70,145,25,180,120,325,215
9741,Marbois,27157,27,102,364,142,425,307,874,466
9742,Cierrey,27158,27,55,145,55,328,120,503,200
9743,Claville,27161,27,104,295,110,419,170,699,399
9744,Collandres-Quincarnon,27162,27,16,56,12,60,60,132,72
9745,Colletot,27163,27,8,49,9,48,43,100,57
9746,Combon,27164,27,76,238,64,172,248,484,314
9747,Conches-en-Ouche,27165,27,656,1323,535,1572,791,2898,1979
9748,Condé-sur-Risle,27167,27,24,176,40,228,140,408,200
9749,Connelles,27168,27,24,56,12,56,40,108,80
9750,Conteville,27169,27,116,286,79,208,226,513,402
9751,Cormeilles,27170,27,224,280,140,328,184,652,504
9752,Le Cormier,27171,27,65,110,50,125,65,240,175
9753,Corneville-la-Fouquetière,27173,27,8,40,0,56,8,64,48
9754,Corneville-sur-Risle,27174,27,120,315,35,578,255,868,435
9755,Corny,27175,27,30,100,30,100,74,204,130
9756,Coudray,27176,27,24,64,24,44,52,120,88
9757,Coudres,27177,27,60,124,80,176,100,356,184
9758,Courbépine,27179,27,95,200,70,183,175,428,295
9759,Courcelles-sur-Seine,27180,27,193,513,159,636,385,1180,706
9760,Courdemanche,27181,27,70,195,30,170,135,335,265
9761,Courteilles,27182,27,4,30,8,58,24,90,34
9762,La Couture-Boussey,27183,27,256,588,232,712,444,1388,844
9763,Crasville,27184,27,15,30,10,50,15,75,45
9764,Crestot,27185,27,24,163,48,112,121,281,187
9765,Criquebeuf-la-Campagne,27187,27,16,95,17,94,45,156,111
9766,Criquebeuf-sur-Seine,27188,27,149,347,98,425,276,799,496
9767,La Croisille,27189,27,17,95,47,154,73,274,112
9768,Croisy-sur-Eure,27190,27,15,50,15,80,40,135,65
9769,Clef Vallée d'Eure,27191,27,275,643,192,838,469,1499,918
9770,Crosville-la-Vieille,27192,27,48,148,36,216,108,360,196
9771,Croth,27193,27,105,376,90,398,327,815,481
9772,Cuverville,27194,27,8,57,8,75,61,144,65
9773,Les Damps,27196,27,148,316,104,396,268,768,464
9774,Mesnils-sur-Iton,27198,27,470,1236,408,1207,940,2555,1706
9775,Dangu,27199,27,33,145,52,189,128,369,178
9776,Dardez,27200,27,20,45,20,60,25,105,65
9777,Daubeuf-la-Campagne,27201,27,5,70,5,60,85,150,75
9778,Daubeuf-près-Vatteville,27202,27,19,118,24,154,95,273,137
9779,Douains,27203,27,53,130,13,139,101,253,183
9780,Doudeauville-en-Vexin,27204,27,35,110,5,115,55,175,145
9781,Douville-sur-Andelle,27205,27,29,116,43,106,92,241,145
9782,Droisy,27206,27,52,93,24,157,92,273,145
9783,Drucourt,27207,27,70,127,20,205,101,326,197
9784,Duranville,27208,27,13,26,13,60,23,96,39
9785,Écaquelon,27209,27,73,170,79,167,125,371,243
9786,Écardenville-la-Campagne,27210,27,20,140,25,140,120,285,160
9787,Écauville,27212,27,4,28,20,40,12,72,32
9788,Vexin-sur-Epte,27213,27,504,1671,484,2061,1237,3782,2175
9789,Écouis,27214,27,96,212,56,228,168,452,308
9790,Ecquetot,27215,27,32,118,24,97,110,231,150
9791,Émalleville,27216,27,34,155,50,185,115,350,189
9792,Émanville,27217,27,40,168,20,212,156,388,208
9793,Épaignes,27218,27,171,413,113,466,247,826,584
9794,Épégard,27219,27,26,170,21,144,168,333,196
9795,Épieds,27220,27,35,70,15,135,100,250,105
9796,Épreville-en-Lieuvin,27222,27,24,48,20,84,40,144,72
9797,Épreville-près-le-Neubourg,27224,27,60,105,60,145,115,320,165
9798,Étrépagny,27226,27,385,1092,367,1218,784,2369,1477
9799,Étréville,27227,27,60,205,85,185,135,405,265
9800,Éturqueraye,27228,27,7,59,26,44,78,148,66
9801,Évreux,27229,27,4914,12836,7396,13098,9185,29679,17750
9802,Ézy-sur-Eure,27230,27,508,904,403,1007,638,2048,1412
9803,Fains,27231,27,19,84,18,165,55,238,103
9804,Farceaux,27232,27,24,122,28,104,40,172,146
9805,Fatouville-Grestain,27233,27,64,200,36,288,168,492,264
9806,Fauville,27234,27,48,72,72,80,36,188,120
9807,Faverolles-la-Campagne,27235,27,20,47,9,30,38,77,67
9808,Le Favril,27237,27,10,50,10,65,45,120,60
9809,Ferrières-Haut-Clocher,27238,27,60,452,64,283,358,705,512
9810,Ferrières-Saint-Hilaire,27239,27,24,72,16,204,84,304,96
9811,La Ferrière-sur-Risle,27240,27,57,37,6,92,15,113,94
9812,Feuguerolles,27241,27,8,40,32,56,44,132,48
9813,Le Fidelaire,27242,27,120,276,104,312,200,616,396
9814,Fiquefleur-Équainville,27243,27,84,168,56,232,136,424,252
9815,Fleury-la-Forêt,27245,27,40,40,10,120,50,180,80
9816,Fleury-sur-Andelle,27246,27,336,437,207,612,269,1088,773
9817,Flipou,27247,27,15,85,49,89,66,204,100
9818,Folleville,27248,27,30,35,10,80,40,130,65
9819,Fontaine-Bellenger,27249,27,44,342,96,344,274,714,386
9820,Fontaine-l'Abbé,27251,27,80,115,80,185,80,345,195
9821,Fontaine-la-Louvet,27252,27,40,72,44,128,36,208,112
9822,Fontaine-la-Soret,27253,27,35,92,12,128,89,229,127
9823,Fontaine-sous-Jouy,27254,27,45,210,75,334,170,579,255
9824,La Forêt-du-Parc,27256,27,40,150,60,195,115,370,190
9825,Fort-Moville,27258,27,48,132,49,137,81,267,180
9826,Foucrainville,27259,27,5,20,15,15,20,50,25
9827,Foulbec,27260,27,36,219,36,165,170,371,255
9828,Fouqueville,27261,27,50,120,20,175,80,275,170
9829,Fourmetot,27263,27,51,174,70,184,145,399,225
9830,Francheville,27265,27,115,360,85,424,265,774,475
9831,Franqueville,27266,27,16,74,33,87,70,190,90
9832,Freneuse-sur-Risle,27267,27,24,64,28,169,60,257,88
9833,Le Fresne,27268,27,12,68,28,128,68,224,80
9834,Fresne-Cauverville,27269,27,52,40,16,68,36,120,92
9835,Fresne-l'Archevêque,27270,27,20,185,30,195,135,360,205
9836,Fresney,27271,27,21,113,12,75,78,165,134
9837,Gadencourt,27273,27,40,95,40,115,80,235,135
9838,Gaillardbois-Cressenville,27274,27,35,110,25,125,125,275,145
9839,Gaillon,27275,27,639,1933,987,1973,1365,4325,2572
9840,Gamaches-en-Vexin,27276,27,29,63,32,89,44,165,92
9841,La Baronnie,27277,27,19,168,56,226,149,431,187
9842,Garennes-sur-Eure,27278,27,223,469,165,599,399,1163,692
9843,Gasny,27279,27,430,790,245,1070,535,1850,1220
9844,Gauciel,27280,27,36,144,40,140,116,296,180
9845,Gaudreville-la-Rivière,27281,27,3,46,12,100,32,144,49
9846,Gauville-la-Campagne,27282,27,58,125,25,203,83,311,183
9847,Gisors,27284,27,1514,2691,1430,3221,1988,6639,4205
9848,Giverny,27285,27,80,104,32,208,76,316,184
9849,Giverville,27286,27,40,91,52,100,54,206,131
9850,Glisolles,27287,27,38,185,72,309,148,529,223
9851,Glos-sur-Risle,27288,27,64,153,64,152,100,316,217
9852,La Goulafrière,27289,27,15,30,10,70,40,120,45
9853,Goupillières,27290,27,63,250,70,283,195,548,313
9854,Gournay-le-Guérin,27291,27,15,40,20,30,35,85,55
9855,Grainville,27294,27,14,159,21,226,109,356,173
9856,Grand-Camp,27295,27,43,126,12,156,89,257,169
9857,Grandvilliers,27297,27,25,80,5,140,80,225,105
9858,Graveron-Sémerville,27298,27,22,61,24,94,29,147,83
9859,Gravigny,27299,27,565,928,506,1164,776,2446,1493
9860,Grosley-sur-Risle,27300,27,84,118,36,130,119,285,202
9861,Grossoeuvre,27301,27,96,291,83,401,179,663,387
9862,Le Bosc du Theil,27302,27,139,369,79,331,348,758,508
9863,Guerny,27304,27,8,31,12,57,31,100,39
9864,Guichainville,27306,27,265,571,173,873,458,1504,836
9865,Guiseniers,27307,27,38,110,47,155,65,267,148
9866,L'Habit,27309,27,36,140,36,176,136,348,176
9867,Hacqueville,27310,27,24,140,48,148,96,292,164
9868,Harcourt,27311,27,104,192,76,228,180,484,296
9869,Hardencourt-Cocherel,27312,27,21,38,28,102,26,156,59
9870,La Harengère,27313,27,28,152,84,188,92,364,180
9871,Harquency,27315,27,20,85,15,120,50,185,105
9872,Hauville,27316,27,104,340,108,472,268,848,444
9873,La Haye-Aubrée,27317,27,52,140,40,112,112,264,192
9874,La Haye-de-Calleville,27318,27,10,73,12,57,81,150,83
9875,La Haye-de-Routot,27319,27,34,71,16,102,61,179,105
9876,La Haye-du-Theil,27320,27,36,80,32,92,52,176,116
9877,La Haye-le-Comte,27321,27,12,28,8,60,16,84,40
9878,La Haye-Malherbe,27322,27,135,320,115,618,240,973,455
9879,La Haye-Saint-Sylvestre,27323,27,60,45,20,110,50,180,105
9880,Hébécourt,27324,27,25,170,25,220,146,391,195
9881,Hecmanville,27325,27,0,53,13,41,35,89,53
9882,Hécourt,27326,27,48,96,16,160,52,228,144
9883,Hectomare,27327,27,40,60,35,35,50,120,100
9884,Hennezis,27329,27,34,195,48,261,168,477,229
9885,Herqueville,27330,27,22,19,15,40,12,67,41
9886,Heubécourt-Haricourt,27331,27,24,140,36,160,100,296,164
9887,Heudebouville,27332,27,78,157,99,224,148,471,235
9888,Heudicourt,27333,27,40,208,44,248,132,424,248
9889,Heudreville-en-Lieuvin,27334,27,12,12,8,52,4,64,24
9890,Heudreville-sur-Eure,27335,27,90,252,71,382,160,613,342
9891,La Heunière,27336,27,36,64,20,88,56,164,100
9892,Heuqueville,27337,27,40,60,30,130,85,245,100
9893,Les Hogues,27338,27,60,150,40,200,185,425,210
9894,Hondouville,27339,27,76,217,60,240,210,510,293
9895,Honguemare-Guenouville,27340,27,16,170,62,261,134,457,186
9896,L'Hosmes,27341,27,5,15,0,42,10,52,20
9897,Houetteville,27342,27,12,37,19,64,32,115,49
9898,Houlbec-Cocherel,27343,27,94,320,115,585,210,910,414
9899,Houlbec-près-le-Gros-Theil,27344,27,9,45,9,28,16,53,54
9900,La Houssaye,27345,27,55,35,5,93,25,123,90
9901,Houville-en-Vexin,27346,27,0,58,37,45,56,138,58
9902,Huest,27347,27,61,192,32,277,160,469,253
9903,Igoville,27348,27,116,423,188,455,390,1033,539
9904,Illeville-sur-Montfort,27349,27,38,229,44,269,221,534,267
9905,Illiers-l'Évêque,27350,27,101,246,84,245,187,516,347
9906,Incarville,27351,27,180,277,106,491,234,831,457
9907,Irreville,27353,27,16,140,56,144,112,312,156
9908,Iville,27354,27,56,156,16,172,116,304,212
9909,Ivry-la-Bataille,27355,27,229,659,323,831,601,1755,888
9910,Jouy-sur-Eure,27358,27,36,110,40,220,82,342,146
9911,Juignettes,27359,27,23,33,9,45,25,79,56
9912,Jumelles,27360,27,28,96,24,88,68,180,124
9913,La Lande-Saint-Léger,27361,27,40,81,30,91,72,193,121
9914,Le Landin,27363,27,10,55,5,75,40,120,65
9915,Launay,27364,27,25,55,15,75,30,120,80
9916,Léry,27365,27,220,506,290,645,395,1330,726
9917,Letteguives,27366,27,28,56,7,30,62,99,84
9918,Lieurey,27367,27,160,330,116,480,306,902,490
9919,Lignerolles,27368,27,16,94,9,113,57,179,110
9920,Lilly,27369,27,8,21,8,22,8,38,29
9921,Lisors,27370,27,54,98,20,62,64,146,152
9922,Livet-sur-Authou,27371,27,20,10,25,80,5,110,30
9923,Longchamps,27372,27,15,238,54,169,164,387,253
9924,Lorleau,27373,27,12,30,4,64,17,85,42
9925,Louversey,27374,27,85,147,40,140,115,295,232
9926,Louviers,27375,27,2047,4547,2149,5085,3405,10639,6594
9927,Louye,27376,27,20,64,32,92,52,176,84
9928,Lyons-la-Forêt,27377,27,80,152,48,292,136,476,232
9929,La Madeleine-de-Nonancourt,27378,27,130,280,135,465,165,765,410
9930,Mainneville,27379,27,44,98,30,150,83,263,142
9931,Malleville-sur-le-Bec,27380,27,25,75,0,85,75,160,100
9932,Malouy,27381,27,35,30,5,50,25,80,65
9933,Mandeville,27382,27,12,80,24,128,64,216,92
9934,Mandres,27383,27,40,81,13,149,51,213,121
9935,Manneville-la-Raoult,27384,27,72,140,36,188,84,308,212
9936,Manneville-sur-Risle,27385,27,70,429,175,469,282,926,499
9937,Le Manoir,27386,27,109,384,149,272,232,653,493
9938,Marais-Vernier,27388,27,50,145,35,180,85,300,195
9939,Marbeuf,27389,27,28,112,49,129,84,262,140
9940,Marcilly-la-Campagne,27390,27,89,375,100,333,240,673,464
9941,Marcilly-sur-Eure,27391,27,95,495,125,490,360,975,590
9942,Martagny,27392,27,25,25,4,57,4,65,50
9943,Martainville,27393,27,41,118,60,95,101,256,159
9944,Martot,27394,27,30,140,45,160,90,295,170
9945,Mélicourt,27395,27,20,20,5,30,10,45,40
9946,Ménesqueville,27396,27,44,124,40,124,105,269,168
9947,Ménilles,27397,27,188,454,140,480,321,941,642
9948,Menneval,27398,27,242,304,37,483,196,716,546
9949,Mercey,27399,27,3,13,3,15,6,24,16
9950,Merey,27400,27,48,68,22,114,50,186,116
9951,Le Mesnil-Fuguet,27401,27,25,20,25,70,25,120,45
9952,Le Mesnil-Hardray,27402,27,12,8,4,12,8,24,20
9953,Le Mesnil-Jourdain,27403,27,25,55,30,100,35,165,80
9954,Mesnil-Rousset,27404,27,21,21,0,35,10,45,42
9955,Mesnil-sous-Vienne,27405,27,9,25,13,47,9,69,34
9956,Mesnil-sur-l'Estrée,27406,27,121,198,101,376,157,634,319
9957,Mesnil-Verclives,27407,27,13,68,41,69,54,164,81
9958,Mézières-en-Vexin,27408,27,41,131,51,225,105,381,172
9959,Miserey,27410,27,69,155,51,142,136,329,224
9960,Moisville,27411,27,16,46,20,66,33,119,62
9961,Montaure,27412,27,88,269,72,410,226,708,357
9962,Montfort-sur-Risle,27413,27,168,160,64,236,128,428,328
9963,Montreuil-l'Argillé,27414,27,127,162,77,291,81,449,289
9964,Morainville-Jouveaux,27415,27,55,55,50,165,40,255,110
9965,Buis-sur-Damville,27416,27,83,305,75,295,225,595,388
9966,Morgny,27417,27,64,172,48,232,108,388,236
9967,Morsan,27418,27,32,32,10,15,26,51,64
9968,Mouettes,27419,27,46,216,44,207,167,418,262
9969,Mouflaines,27420,27,16,48,16,72,12,100,64
9970,Mousseaux-Neuville,27421,27,25,185,60,230,135,425,210
9971,Muids,27422,27,125,171,47,343,105,495,296
9972,Muzy,27423,27,60,204,35,325,175,535,264
9973,Nagel-Séez-Mesnil,27424,27,13,58,50,121,34,205,71
9974,Nassandres,27425,27,210,300,165,415,190,770,510
9975,Neaufles-Saint-Martin,27426,27,128,284,84,440,260,784,412
9976,Neaufles-Auvergny,27427,27,48,104,24,148,92,264,152
9977,Le Neubourg,27428,27,677,876,480,1112,732,2324,1553
9978,Neuilly,27429,27,16,36,20,56,24,100,52
9979,La Neuve-Grange,27430,27,35,95,35,80,70,185,130
9980,La Neuve-Lyre,27431,27,87,114,47,175,75,297,201
9981,La Neuville-du-Bosc,27432,27,38,169,29,147,138,314,207
9982,Neuville-sur-Authou,27433,27,8,64,0,76,36,112,72
9983,Noards,27434,27,0,8,16,28,0,44,8
9984,La Noë-Poulain,27435,27,16,88,13,63,56,132,104
9985,Nogent-le-Sec,27436,27,28,104,36,124,100,260,132
9986,Nojeon-en-Vexin,27437,27,19,92,40,115,62,217,111
9987,Nonancourt,27438,27,265,540,305,685,380,1370,805
9988,Normanville,27439,27,178,219,66,412,147,625,397
9989,Notre-Dame-de-l'Isle,27440,27,58,131,44,274,99,417,189
9990,Notre-Dame-d'Épine,27441,27,0,25,4,28,13,45,25
9991,Notre-Dame-du-Hamel,27442,27,30,45,0,93,45,138,75
9992,Le Noyer-en-Ouche,27444,27,24,32,20,88,52,160,56
9993,Noyers,27445,27,12,56,20,60,44,124,68
9994,Ormes,27446,27,33,170,36,171,102,309,203
9995,Orvaux,27447,27,30,147,18,178,110,306,177
9996,Pacy-sur-Eure,27448,27,632,1017,476,1437,712,2625,1649
9997,Parville,27451,27,40,65,0,130,70,200,105
9998,Perriers-la-Campagne,27452,27,40,100,20,155,85,260,140
9999,Perriers-sur-Andelle,27453,27,239,418,186,516,297,999,657
10000,Perruel,27454,27,32,127,43,129,103,275,159
10001,Piencourt,27455,27,10,45,15,40,30,85,55
10002,Pinterville,27456,27,95,160,35,315,125,475,255
10003,Piseux,27457,27,95,200,80,195,155,430,295
10004,Pîtres,27458,27,253,707,207,738,453,1398,960
10005,Les Places,27459,27,12,16,4,25,13,42,28
10006,Plainville,27460,27,25,55,5,55,55,115,80
10007,Le Planquay,27462,27,9,31,9,50,28,87,40
10008,Plasnes,27463,27,59,165,54,214,168,436,224
10009,Le Plessis-Grohan,27464,27,80,256,72,228,216,516,336
10010,Le Plessis-Hébert,27465,27,29,77,9,158,70,237,106
10011,Le Plessis-Sainte-Opportune,27466,27,30,85,25,115,60,200,115
10012,Pont-Audemer,27467,27,1339,2126,1197,2426,1500,5123,3465
10013,Pont-Authou,27468,27,79,150,54,171,100,325,229
10014,Pont-de-l'Arche,27469,27,465,1180,385,1160,890,2435,1645
10015,Pont-Saint-Pierre,27470,27,165,300,140,340,210,690,465
10016,Porte-Joie,27471,27,30,25,0,55,0,55,55
10017,Portes,27472,27,20,80,15,105,55,175,100
10018,Port-Mort,27473,27,115,205,65,375,175,615,320
10019,Poses,27474,27,99,276,67,455,180,702,375
10020,La Poterie-Mathieu,27475,27,20,24,8,68,44,120,44
10021,Les Préaux,27476,27,40,90,20,145,95,260,130
10022,Pressagny-l'Orgueilleux,27477,27,100,130,55,330,85,470,230
10023,Prey,27478,27,134,260,55,255,250,560,394
10024,Puchay,27480,27,58,172,57,144,117,318,230
10025,Pullay,27481,27,48,100,20,144,84,248,148
10026,La Pyle,27482,27,16,48,16,40,32,88,64
10027,Quatremare,27483,27,44,29,0,64,27,91,73
10028,Quillebeuf-sur-Seine,27485,27,74,225,92,272,168,532,299
10029,Quittebeuf,27486,27,59,152,60,211,103,374,211
10030,Radepont,27487,27,25,185,40,250,150,440,210
10031,Renneville,27488,27,12,49,12,69,39,120,61
10032,Reuilly,27489,27,45,181,25,186,125,336,226
10033,Richeville,27490,27,30,80,30,80,60,170,110
10034,Roman,27491,27,34,95,5,95,50,150,129
10035,Romilly-la-Puthenaye,27492,27,44,76,24,96,76,196,120
10036,Romilly-sur-Andelle,27493,27,315,943,238,934,699,1871,1258
10037,La Roquette,27495,27,10,57,6,97,49,152,67
10038,Rosay-sur-Lieure,27496,27,59,141,31,135,118,284,200
10039,Rougemontiers,27497,27,55,323,86,245,250,581,378
10040,Rouge-Perriers,27498,27,20,115,20,65,125,210,135
10041,Routot,27500,27,205,398,165,327,342,834,603
10042,Rouvray,27501,27,13,81,6,64,76,146,94
10043,Rugles,27502,27,468,455,184,638,390,1212,923
10044,Sacquenville,27504,27,57,401,66,308,303,677,458
10045,Saint-Agnan-de-Cernières,27505,27,16,40,4,72,20,96,56
10046,Saint-André-de-l'Eure,27507,27,394,1020,391,1138,779,2308,1414
10047,Saint-Antonin-de-Sommaire,27508,27,25,39,4,51,38,93,64
10048,Saint-Aquilin-de-Pacy,27510,27,46,153,58,146,105,309,199
10049,Saint-Aubin-d'Écrosville,27511,27,68,180,44,256,116,416,248
10050,Saint-Aubin-de-Scellon,27512,27,29,67,31,112,57,200,96
10051,Saint-Aubin-du-Thenney,27514,27,97,67,21,105,34,160,164
10052,Saint-Aubin-le-Vertueux,27516,27,88,161,77,285,107,469,249
10053,Saint-Aubin-sur-Gaillon,27517,27,144,492,156,636,392,1184,636
10054,Saint-Aubin-sur-Quillebeuf,27518,27,64,184,68,176,164,408,248
10055,Saint-Benoît-des-Ombres,27520,27,16,26,0,47,21,68,42
10056,Saint-Christophe-sur-Avre,27521,27,3,34,26,40,33,99,37
10057,Saint-Christophe-sur-Condé,27522,27,40,130,45,140,125,310,170
10058,Saint-Clair-d'Arcey,27523,27,35,60,20,145,70,235,95
10059,Sainte-Colombe-la-Commanderie,27524,27,48,233,44,242,203,489,281
10060,Sainte-Colombe-près-Vernon,27525,27,35,80,45,75,60,180,115
10061,Saint-Cyr-de-Salerne,27527,27,17,29,16,80,20,116,46
10062,Le Vaudreuil,27528,27,336,853,422,1288,556,2266,1189
10063,Saint-Cyr-la-Campagne,27529,27,34,93,4,136,99,239,127
10064,Saint-Denis-d'Augerons,27530,27,12,32,4,32,20,56,44
10065,Saint-Denis-des-Monts,27531,27,20,50,10,90,50,150,70
10066,Saint-Denis-le-Ferment,27533,27,45,120,40,219,75,334,165
10067,Saint-Didier-des-Bois,27534,27,93,220,90,280,165,535,313
10068,Saint-Élier,27535,27,70,90,20,215,50,285,160
10069,Saint-Éloi-de-Fourques,27536,27,25,125,25,205,100,330,150
10070,Saint-Étienne-du-Vauvray,27537,27,74,273,87,246,211,544,347
10071,Saint-Étienne-l'Allier,27538,27,32,179,60,144,144,348,211
10072,Saint-Étienne-sous-Bailleul,27539,27,25,117,15,165,75,255,142
10073,Sainte-Geneviève-lès-Gasny,27540,27,65,195,65,230,130,425,260
10074,Saint-Georges-du-Mesnil,27541,27,0,26,12,45,25,82,26
10075,Saint-Georges-du-Vièvre,27542,27,84,199,78,281,155,514,283
10076,Saint-Georges-Motel,27543,27,64,202,93,267,135,495,266
10077,Saint-Germain-de-Fresney,27544,27,10,65,40,60,30,130,75
10078,Saint-Germain-de-Pasquier,27545,27,0,20,20,70,15,105,20
10079,Saint-Germain-des-Angles,27546,27,0,29,21,78,31,130,29
10080,Saint-Germain-la-Campagne,27547,27,120,245,55,240,210,505,365
10081,Saint-Germain-sur-Avre,27548,27,52,324,124,484,224,832,376
10082,Saint-Germain-Village,27549,27,156,336,136,625,260,1021,492
10083,Saint-Grégoire-du-Vièvre,27550,27,55,75,25,120,50,195,130
10084,Saint-Jean-de-la-Léqueraye,27551,27,0,9,9,15,9,33,9
10085,Saint-Jean-du-Thenney,27552,27,47,53,4,69,40,113,100
10086,Saint-Julien-de-la-Liègue,27553,27,12,92,32,168,84,284,104
10087,Saint-Just,27554,27,136,360,120,476,220,816,496
10088,Saint-Laurent-des-Bois,27555,27,24,80,15,65,70,150,104
10089,Saint-Laurent-du-Tencement,27556,27,8,4,8,24,8,40,12
10090,Saint-Léger-de-Rôtes,27557,27,58,61,26,120,71,217,119
10091,Saint-Léger-du-Gennetey,27558,27,12,52,12,76,40,128,64
10092,Saint-Luc,27560,27,20,50,34,95,49,178,70
10093,Saint-Maclou,27561,27,56,168,32,200,132,364,224
10094,Saint-Marcel,27562,27,676,998,520,1538,713,2771,1674
10095,Saint-Mards-de-Blacarville,27563,27,87,166,56,295,107,458,253
10096,Saint-Mards-de-Fresne,27564,27,48,96,16,100,84,200,144
10097,Le Lesme,27565,27,42,171,74,118,148,340,213
10098,Sainte-Marie-de-Vatimesnil,27567,27,9,49,12,94,40,146,58
10099,Sainte-Marthe,27568,27,40,120,50,174,110,334,160
10100,Saint-Martin-du-Tilleul,27569,27,10,60,15,120,35,170,70
10101,Saint-Martin-la-Campagne,27570,27,0,10,15,50,10,75,10
10102,Saint-Martin-Saint-Firmin,27571,27,24,92,32,68,84,184,116
10103,Saint-Meslin-du-Bosc,27572,27,12,88,16,60,80,156,100
10104,Sainte-Opportune-du-Bosc,27576,27,12,199,37,200,159,396,211
10105,Sainte-Opportune-la-Mare,27577,27,35,101,35,116,94,245,136
10106,Sainte-Marie-d'Attez,27578,27,70,132,37,183,76,296,202
10107,Saint-Ouen-de-Pontcheuil,27579,27,5,20,5,70,5,80,25
10108,Saint-Ouen-de-Thouberville,27580,27,296,660,176,680,480,1336,956
10109,Saint-Ouen-des-Champs,27581,27,25,75,25,125,55,205,100
10110,Saint-Ouen-du-Tilleul,27582,27,188,369,104,544,292,940,557
10111,Saint-Paul-de-Fourques,27584,27,5,110,25,65,80,170,115
10112,Saint-Philbert-sur-Boissey,27586,27,12,52,20,48,52,120,64
10113,Saint-Philbert-sur-Risle,27587,27,100,176,96,236,152,484,276
10114,Saint-Pierre-d'Autils,27588,27,179,229,50,443,125,618,408
10115,Saint-Pierre-de-Bailleul,27589,27,100,225,50,390,175,615,325
10116,Saint-Pierre-de-Cernières,27590,27,13,42,9,78,39,126,55
10117,Saint-Pierre-de-Cormeilles,27591,27,70,155,30,278,70,378,225
10118,Saint-Pierre-de-Salerne,27592,27,16,56,32,100,48,180,72
10119,Saint-Pierre-des-Fleurs,27593,27,120,430,135,510,335,980,550
10120,Saint-Pierre-des-Ifs,27594,27,25,70,20,95,55,170,95
10121,Saint-Pierre-du-Bosguérard,27595,27,65,316,90,300,230,620,381
10122,Saint-Pierre-du-Val,27597,27,54,165,35,190,120,345,219
10123,Saint-Pierre-du-Vauvray,27598,27,170,315,160,390,255,805,485
10124,Saint-Pierre-la-Garenne,27599,27,112,240,100,336,184,620,352
10125,Saint-Quentin-des-Isles,27600,27,20,50,0,135,10,145,70
10126,Saint-Samson-de-la-Roque,27601,27,20,97,31,131,90,252,117
10127,Saint-Sébastien-de-Morsent,27602,27,703,1370,428,1487,885,2800,2073
10128,Saint-Siméon,27603,27,28,92,24,132,52,208,120
10129,Saint-Sulpice-de-Grimbouville,27604,27,12,48,0,64,44,108,60
10130,Saint-Sylvestre-de-Cormeilles,27605,27,32,53,18,68,34,120,85
10131,Saint-Symphorien,27606,27,39,93,67,137,77,281,132
10132,Saint-Thurien,27607,27,16,29,29,93,22,144,45
10133,Saint-Victor-de-Chrétienville,27608,27,29,130,5,184,110,299,159
10134,Saint-Victor-d'Épine,27609,27,26,72,20,102,56,178,98
10135,Saint-Victor-sur-Avre,27610,27,15,10,5,20,0,25,25
10136,Saint-Vigor,27611,27,5,100,15,165,60,240,105
10137,Saint-Vincent-des-Bois,27612,27,25,96,25,100,81,206,121
10138,Saint-Vincent-du-Boulay,27613,27,21,90,60,96,79,235,111
10139,Sancourt,27614,27,15,65,5,35,50,90,80
10140,Sassey,27615,27,25,39,12,38,44,94,64
10141,La Saussaye,27616,27,214,420,122,776,245,1143,634
10142,Saussay-la-Campagne,27617,27,20,155,24,133,130,287,175
10143,Sébécourt,27618,27,45,140,60,120,105,285,185
10144,Selles,27620,27,60,80,40,168,88,296,140
10145,Serez,27621,27,6,19,17,40,22,79,25
10146,Serquigny,27622,27,350,410,220,685,310,1215,760
10147,Surtauville,27623,27,39,121,30,140,121,291,160
10148,Surville,27624,27,57,289,46,261,223,530,346
10149,Suzay,27625,27,30,110,27,73,90,190,140
10150,Theillement,27626,27,33,133,0,106,119,225,166
10151,Le Theil-Nolent,27627,27,32,76,28,72,44,144,108
10152,Thiberville,27629,27,371,423,155,546,296,997,794
10153,Thibouville,27630,27,26,80,25,70,54,149,106
10154,Thierville,27631,27,24,112,44,116,72,232,136
10155,Le Thil,27632,27,32,180,12,136,132,280,212
10156,Les Thilliers-en-Vexin,27633,27,25,125,45,155,120,320,150
10157,Le Thuit,27635,27,4,29,17,64,20,101,33
10158,Le Thuit de l'Oison,27638,27,268,974,180,1227,730,2137,1242
10159,Tilleul-Dame-Agnès,27640,27,3,53,6,64,38,108,56
10160,Le Tilleul-Lambert,27641,27,4,81,12,56,75,143,85
10161,Le Tilleul-Othon,27642,27,58,93,18,122,58,198,151
10162,Tillières-sur-Avre,27643,27,160,254,55,382,238,675,414
10163,Tilly,27644,27,55,140,30,185,115,330,195
10164,Tocqueville,27645,27,4,36,12,41,27,80,40
10165,Le Torpt,27646,27,36,120,24,98,119,241,156
10166,Tosny,27647,27,90,150,45,160,105,310,240
10167,Tostes,27648,27,50,125,15,105,130,250,175
10168,Touffreville,27649,27,64,96,12,96,80,188,160
10169,Tournedos-Bois-Hubert,27650,27,12,125,37,147,100,284,137
10170,Tournedos-sur-Seine,27651,27,12,8,4,48,16,68,20
10171,Tourneville,27652,27,13,88,24,93,77,194,101
10172,Tourville-la-Campagne,27654,27,60,297,44,308,289,641,357
10173,Tourville-sur-Pont-Audemer,27655,27,45,190,65,295,115,475,235
10174,Toutainville,27656,27,107,354,65,476,232,773,461
10175,Touville,27657,27,4,45,17,56,34,107,49
10176,Le Tremblay-Omonville,27658,27,30,62,29,112,47,188,92
10177,La Trinité,27659,27,0,25,0,39,24,63,25
10178,La Trinité-de-Réville,27660,27,27,47,12,78,46,136,74
10179,La Trinité-de-Thouberville,27661,27,72,100,20,148,96,264,172
10180,Triqueville,27662,27,70,86,20,116,55,191,156
10181,Le Troncq,27663,27,15,60,20,55,25,100,75
10182,Le Tronquay,27664,27,64,127,30,148,143,321,191
10183,Trouville-la-Haule,27665,27,40,185,25,328,175,528,225
10184,La Vacherie,27666,27,35,175,30,245,105,380,210
10185,Valailles,27667,27,45,105,20,125,85,230,150
10186,Le Val-David,27668,27,100,175,55,305,100,460,275
10187,Valletot,27669,27,43,101,17,122,61,200,144
10188,Vandrimare,27670,27,66,293,57,288,218,563,359
10189,Vannecrocq,27671,27,26,21,8,46,17,71,47
10190,Vascoeuil,27672,27,44,64,48,124,52,224,108
10191,Vatteville,27673,27,0,45,5,90,30,125,45
10192,Vaux-sur-Eure,27674,27,25,95,30,95,55,180,120
10193,Venables,27676,27,75,185,40,315,165,520,260
10194,Venon,27677,27,50,111,29,57,91,177,161
10195,Les Ventes,27678,27,92,232,92,384,224,700,324
10196,Verneuil-sur-Avre,27679,27,937,1458,719,2121,975,3815,2395
10197,Verneusses,27680,27,29,43,13,67,29,109,72
10198,Vernon,27681,27,2700,6310,2960,6626,4670,14256,9010
10199,Vesly,27682,27,70,210,65,235,120,420,280
10200,Vézillon,27683,27,35,90,25,70,50,145,125
10201,Le Vieil-Évreux,27684,27,65,126,109,257,143,509,191
10202,La Vieille-Lyre,27685,27,115,130,25,245,100,370,245
10203,Vieux-Port,27686,27,5,10,0,20,10,30,15
10204,Villegats,27689,27,25,110,25,113,75,213,135
10205,Villers-en-Vexin,27690,27,12,96,37,73,68,178,108
10206,Villers-sur-le-Roule,27691,27,88,240,52,254,162,468,328
10207,Villettes,27692,27,5,40,20,75,35,130,45
10208,Sylvains-Lès-Moulins,27693,27,127,382,90,448,253,791,509
10209,Villez-sous-Bailleul,27694,27,25,75,15,135,55,205,100
10210,Villez-sur-le-Neubourg,27695,27,17,81,21,73,54,148,98
10211,Villiers-en-Désoeuvre,27696,27,71,225,86,304,172,562,296
10212,Vironvay,27697,27,24,69,13,116,63,192,93
10213,Vitot,27698,27,56,148,36,188,124,348,204
10214,Voiscreville,27699,27,15,35,15,45,25,85,50
10215,Vraiville,27700,27,49,196,48,176,115,339,245
10216,Val-de-Reuil,27701,27,342,4483,1725,3099,2486,7310,4825
10217,Abondant,28001,28,179,597,195,625,507,1327,776
10218,Allaines-Mervilliers,28002,28,45,65,20,125,40,185,110
10219,Allainville,28003,28,15,30,25,60,10,95,45
10220,Allonnes,28004,28,20,100,25,65,85,175,120
10221,Alluyes,28005,28,75,210,80,250,150,480,285
10222,Amilly,28006,28,190,403,110,837,293,1240,593
10223,Anet,28007,28,393,605,214,893,444,1551,998
10224,Ardelles,28008,28,10,57,9,53,51,113,67
10225,Ardelu,28009,28,5,15,25,5,10,40,20
10226,Argenvilliers,28010,28,70,70,35,95,60,190,140
10227,Arrou,28012,28,305,235,210,581,215,1006,540
10228,Aunay-sous-Auneau,28013,28,100,383,160,505,274,939,483
10229,Aunay-sous-Crécy,28014,28,51,132,40,166,109,315,183
10230,Auneau-Bleury-Saint-Symphorien,28015,28,463,1553,556,1543,1263,3362,2016
10231,Les Autels-Villevillon,28016,28,15,55,10,55,30,95,70
10232,Autheuil,28017,28,19,33,9,68,33,110,52
10233,Authon-du-Perche,28018,28,244,235,85,405,179,669,479
10234,Baigneaux,28019,28,15,45,29,63,44,136,60
10235,Bailleau-le-Pin,28021,28,165,454,118,430,357,905,619
10236,Bailleau-l'Évêque,28022,28,115,322,75,430,248,753,437
10237,Bailleau-Armenonville,28023,28,112,452,84,484,304,872,564
10238,Barjouville,28024,28,160,473,118,631,318,1067,633
10239,Barmainville,28025,28,15,45,0,20,35,55,60
10240,Baudreville,28026,28,30,70,30,80,60,170,100
10241,La Bazoche-Gouet,28027,28,281,215,55,391,166,612,496
10242,Bazoches-en-Dunois,28028,28,30,79,22,42,59,123,109
10243,Bazoches-les-Hautes,28029,28,55,111,20,110,45,175,166
10244,Beauche,28030,28,10,35,35,150,35,220,45
10245,Beaumont-les-Autels,28031,28,46,85,29,146,66,241,131
10246,Beauvilliers,28032,28,16,68,52,104,88,244,84
10247,Belhomert-Guéhouville,28033,28,115,210,80,270,145,495,325
10248,Berchères-Saint-Germain,28034,28,76,193,72,258,166,496,269
10249,Berchères-les-Pierres,28035,28,86,259,56,302,207,565,345
10250,Berchères-sur-Vesgre,28036,28,60,216,24,312,188,524,276
10251,Bérou-la-Mulotière,28037,28,30,81,12,98,65,175,111
10252,Béthonvilliers,28038,28,27,33,0,40,27,67,60
10253,Béville-le-Comte,28039,28,134,469,145,505,300,950,603
10254,Billancelles,28040,28,15,80,25,105,90,220,95
10255,Blandainville,28041,28,25,41,5,80,40,125,66
10256,Boisgasson,28044,28,24,28,8,32,4,44,52
10257,Boissy-en-Drouais,28045,28,12,33,25,69,26,120,45
10258,Boissy-lès-Perche,28046,28,60,95,55,205,65,325,155
10259,Boisville-la-Saint-Père,28047,28,65,223,55,194,184,433,288
10260,La Bourdinière-Saint-Loup,28048,28,75,205,45,190,165,400,280
10261,Boncé,28049,28,6,87,21,42,64,127,93
10262,Boncourt,28050,28,20,60,15,105,65,185,80
10263,Bonneval,28051,28,783,1149,359,1469,900,2728,1932
10264,Bouglainval,28052,28,60,160,80,255,190,525,220
10265,Le Boullay-les-Deux-Églises,28053,28,10,65,20,100,70,190,75
10266,Le Boullay-Mivoye,28054,28,60,119,39,110,120,269,179
10267,Le Boullay-Thierry,28055,28,35,160,40,180,130,350,195
10268,Boutigny-Prouais,28056,28,125,468,170,697,331,1198,593
10269,Bouville,28057,28,56,144,64,176,116,356,200
10270,Bréchamps,28058,28,24,80,12,140,64,216,104
10271,Brezolles,28059,28,171,552,207,510,321,1038,723
10272,Briconville,28060,28,4,62,34,30,74,138,66
10273,Brou,28061,28,853,575,270,1076,435,1781,1428
10274,Broué,28062,28,67,285,49,199,217,465,352
10275,Brunelles,28063,28,49,135,42,160,111,313,184
10276,Bû,28064,28,167,513,179,641,407,1227,680
10277,Bullainville,28065,28,14,22,6,29,22,57,36
10278,Bullou,28066,28,4,68,32,100,48,180,72
10279,Cernay,28067,28,8,28,4,36,12,52,36
10280,Challet,28068,28,44,100,76,120,104,300,144
10281,Champhol,28070,28,343,917,316,1197,617,2130,1260
10282,Champrond-en-Gâtine,28071,28,65,208,45,145,146,336,273
10283,Champrond-en-Perchet,28072,28,67,78,0,141,71,212,145
10284,Champseru,28073,28,33,61,12,107,55,174,94
10285,La Chapelle-d'Aunainville,28074,28,40,81,35,80,60,175,121
10286,La Chapelle-du-Noyer,28075,28,152,212,84,424,152,660,364
10287,La Chapelle-Forainvilliers,28076,28,15,53,15,98,20,133,68
10288,La Chapelle-Fortin,28077,28,25,65,0,50,50,100,90
10289,Chapelle-Guillaume,28078,28,15,35,15,70,40,125,50
10290,Chapelle-Royale,28079,28,35,69,32,89,49,170,104
10291,Charbonnières,28080,28,44,52,8,92,52,152,96
10292,Charonville,28081,28,35,110,5,115,60,180,145
10293,Charpont,28082,28,52,140,20,217,112,349,192
10294,Charray,28083,28,16,12,4,44,28,76,28
10295,Chartainvilliers,28084,28,75,220,35,270,150,455,295
10296,Chartres,28085,28,5392,8217,5183,11555,6869,23607,13609
10297,Chassant,28086,28,65,100,10,120,60,190,165
10298,Châtaincourt,28087,28,40,68,12,100,40,152,108
10299,Châteaudun,28088,28,2047,2935,1234,3757,1964,6955,4982
10300,Châteauneuf-en-Thymerais,28089,28,341,654,325,727,489,1541,995
10301,Les Châtelets,28090,28,20,8,4,37,9,50,28
10302,Les Châtelliers-Notre-Dame,28091,28,15,20,30,35,20,85,35
10303,Châtenay,28092,28,24,80,20,72,52,144,104
10304,Châtillon-en-Dunois,28093,28,136,220,92,172,216,480,356
10305,Chaudon,28094,28,171,390,166,553,277,996,561
10306,Chauffours,28095,28,15,80,25,95,65,185,95
10307,La Chaussée-d'Ivry,28096,28,128,264,64,388,200,652,392
10308,Cherisy,28098,28,234,480,106,568,366,1040,714
10309,Chuisnes,28099,28,80,286,127,318,231,676,366
10310,Cintray,28100,28,20,108,21,156,73,250,128
10311,Civry,28101,28,35,110,30,90,80,200,145
10312,Clévilliers,28102,28,38,187,101,168,148,417,225
10313,Cloyes-sur-le-Loir,28103,28,612,503,220,949,428,1597,1115
10314,Coltainville,28104,28,65,295,75,270,223,568,360
10315,Combres,28105,28,117,168,58,135,110,303,285
10316,Conie-Molitard,28106,28,42,91,20,146,61,227,133
10317,Corancez,28107,28,16,76,56,168,88,312,92
10318,Cormainville,28108,28,44,52,3,37,61,101,96
10319,Les Corvées-les-Yys,28109,28,25,85,10,100,70,180,110
10320,Le Coudray,28110,28,227,1190,495,1310,925,2730,1417
10321,Coudray-au-Perche,28111,28,65,90,45,95,60,200,155
10322,Coudreceau,28112,28,48,93,52,132,83,267,141
10323,Coulombs,28113,28,160,367,80,467,323,870,527
10324,Courbehaye,28114,28,12,32,0,52,28,80,44
10325,Courtalain,28115,28,45,125,45,190,80,315,170
10326,Courville-sur-Eure,28116,28,390,610,285,885,420,1590,1000
10327,Crécy-Couvé,28117,28,27,48,6,89,32,127,75
10328,Croisilles,28118,28,31,120,31,133,93,257,151
10329,La Croix-du-Perche,28119,28,20,35,5,60,40,105,55
10330,Crucey-Villages,28120,28,44,87,60,133,93,286,131
10331,Dambron,28121,28,20,20,8,16,20,44,40
10332,Dammarie,28122,28,101,413,126,483,320,929,514
10333,Dampierre-sous-Brou,28123,28,103,81,20,187,70,277,184
10334,Dampierre-sur-Avre,28124,28,66,162,57,321,94,472,228
10335,Dancy,28126,28,45,45,10,50,55,115,90
10336,Dangeau,28127,28,120,205,130,295,185,610,325
10337,Dangers,28128,28,41,112,57,105,66,228,153
10338,Denonville,28129,28,48,196,89,226,182,497,244
10339,Digny,28130,28,72,256,52,324,244,620,328
10340,Donnemain-Saint-Mamès,28132,28,70,180,55,270,110,435,250
10341,Douy,28133,28,90,135,15,205,105,325,225
10342,Dreux,28134,28,2791,9032,4303,8171,5882,18356,11823
10343,Droue-sur-Drouette,28135,28,104,320,116,468,256,840,424
10344,Écluzelles,28136,28,40,40,5,60,35,100,80
10345,Écrosnes,28137,28,90,225,65,290,175,530,315
10346,Épeautrolles,28139,28,5,60,30,85,20,135,65
10347,Épernon,28140,28,562,1267,846,1625,1217,3688,1829
10348,Ermenonville-la-Grande,28141,28,24,88,32,108,60,200,112
10349,Ermenonville-la-Petite,28142,28,16,48,16,48,40,104,64
10350,Escorpain,28143,28,6,73,15,77,48,140,79
10351,Les Étilleux,28144,28,30,60,25,55,50,130,90
10352,Faverolles,28146,28,56,256,92,279,212,583,312
10353,Favières,28147,28,40,184,72,140,144,356,224
10354,Le Favril,28148,28,48,72,40,96,84,220,120
10355,La Ferté-Vidame,28149,28,88,117,55,241,95,391,205
10356,La Ferté-Villeneuil,28150,28,45,90,5,140,75,220,135
10357,Fessanvilliers-Mattanvilliers,28151,28,12,64,20,52,36,108,76
10358,Flacey,28153,28,20,30,20,85,40,145,50
10359,Fontaine-la-Guyon,28154,28,108,500,100,448,388,936,608
10360,Fontaine-les-Ribouts,28155,28,25,50,10,110,15,135,75
10361,Fontaine-Simon,28156,28,72,224,68,348,208,624,296
10362,Fontenay-sur-Conie,28157,28,36,31,0,36,40,76,67
10363,Fontenay-sur-Eure,28158,28,64,214,72,341,161,574,278
10364,La Framboisière,28159,28,56,88,24,96,84,204,144
10365,Francourville,28160,28,55,210,100,285,150,535,265
10366,Frazé,28161,28,100,100,60,192,56,308,200
10367,Fresnay-le-Comte,28162,28,15,110,30,110,85,225,125
10368,Fresnay-le-Gilmert,28163,28,5,65,20,95,30,145,70
10369,Fresnay-l'Évêque,28164,28,80,236,80,216,144,440,316
10370,Frétigny,28165,28,55,114,60,164,66,290,169
10371,Friaize,28166,28,30,40,35,98,30,163,70
10372,Fruncé,28167,28,70,115,25,100,90,215,185
10373,Gallardon,28168,28,264,1001,337,978,826,2141,1265
10374,Garancières-en-Beauce,28169,28,10,65,25,85,55,165,75
10375,Garancières-en-Drouais,28170,28,30,50,25,135,35,195,80
10376,Garnay,28171,28,90,155,65,450,120,635,245
10377,Gas,28172,28,92,208,51,232,159,442,300
10378,Gasville-Oisème,28173,28,96,318,100,450,265,815,414
10379,La Gaudaine,28175,28,29,42,16,42,16,74,71
10380,Le Gault-Saint-Denis,28176,28,85,203,17,139,185,341,288
10381,Gellainville,28177,28,40,237,60,160,198,418,277
10382,Germainville,28178,28,25,80,20,130,25,175,105
10383,Gilles,28180,28,25,110,50,190,100,340,135
10384,Gohory,28182,28,30,100,40,119,70,229,130
10385,Gommerville,28183,28,71,208,29,152,165,346,279
10386,Gouillons,28184,28,16,92,36,84,92,212,108
10387,Goussainville,28185,28,81,385,156,386,284,826,466
10388,Guainville,28187,28,61,180,53,236,139,428,241
10389,Le Gué-de-Longroi,28188,28,36,292,60,288,224,572,328
10390,Guilleville,28189,28,36,48,24,44,32,100,84
10391,Guillonville,28190,28,40,117,20,85,124,229,157
10392,Hanches,28191,28,229,729,242,855,596,1693,958
10393,Happonvilliers,28192,28,52,76,20,92,52,164,128
10394,Havelu,28193,28,4,20,13,45,17,75,24
10395,Houville-la-Branche,28194,28,19,131,13,156,90,259,150
10396,Houx,28195,28,70,198,60,285,157,502,268
10397,Illiers-Combray,28196,28,531,791,270,935,641,1846,1322
10398,Intréville,28197,28,12,24,18,20,38,76,36
10399,Jallans,28198,28,95,166,60,258,182,500,261
10400,Janville,28199,28,264,423,129,507,329,965,687
10401,Jaudrais,28200,28,32,116,24,104,96,224,148
10402,Jouy,28201,28,242,452,135,735,297,1167,694
10403,Lamblore,28202,28,52,76,12,132,68,212,128
10404,Landelles,28203,28,64,160,88,156,152,396,224
10405,Langey,28204,28,65,105,15,100,85,200,170
10406,Lanneray,28205,28,90,145,40,180,110,330,235
10407,Laons,28206,28,40,217,50,285,142,477,257
10408,Léthuin,28207,28,4,68,27,40,55,122,72
10409,Levainville,28208,28,29,112,35,135,75,245,141
10410,Lèves,28209,28,517,1289,504,1788,1050,3342,1806
10411,Levesville-la-Chenard,28210,28,15,75,15,65,60,140,90
10412,Logron,28211,28,70,145,10,205,160,375,215
10413,Loigny-la-Bataille,28212,28,20,45,35,75,35,145,65
10414,Lormaye,28213,28,76,148,80,200,136,416,224
10415,La Loupe,28214,28,721,812,356,884,579,1819,1533
10416,Louville-la-Chenard,28215,28,32,66,9,61,70,140,98
10417,Louvilliers-en-Drouais,28216,28,13,49,6,62,39,107,62
10418,Louvilliers-lès-Perche,28217,28,8,56,24,32,48,104,64
10419,Lucé,28218,28,1964,3964,2152,4924,2950,10026,5928
10420,Luigny,28219,28,72,45,25,153,66,244,117
10421,Luisant,28220,28,1067,1509,542,2343,1167,4052,2576
10422,Lumeau,28221,28,23,36,19,30,29,78,59
10423,Luplanté,28222,28,70,100,45,95,75,215,170
10424,Luray,28223,28,228,428,188,456,296,940,656
10425,Lutz-en-Dunois,28224,28,72,100,32,136,96,264,172
10426,Magny,28225,28,72,208,36,172,176,384,280
10427,Maillebois,28226,28,132,247,61,206,217,484,379
10428,Maintenon,28227,28,515,919,438,1491,783,2712,1434
10429,Mainvilliers,28229,28,1218,2766,1267,3109,2051,6427,3984
10430,Maisons,28230,28,15,100,20,130,95,245,115
10431,La Mancelière,28231,28,20,30,30,76,25,131,50
10432,Manou,28232,28,75,141,61,158,78,297,216
10433,Marboué,28233,28,125,251,74,420,152,646,376
10434,Marchéville,28234,28,55,149,35,142,105,282,204
10435,Marchezais,28235,28,16,75,12,108,62,182,91
10436,Margon,28236,28,230,257,55,592,96,743,487
10437,Marolles-les-Buis,28237,28,60,30,10,70,30,110,90
10438,Marville-Moutiers-Brûlé,28239,28,75,250,83,274,186,543,325
10439,Meaucé,28240,28,60,125,25,240,75,340,185
10440,Le Mée,28241,28,48,68,16,92,48,156,116
10441,Méréglise,28242,28,10,25,0,30,30,60,35
10442,Mérouville,28243,28,40,43,12,33,68,113,83
10443,Meslay-le-Grenet,28245,28,26,70,21,113,61,195,96
10444,Meslay-le-Vidame,28246,28,56,168,28,160,116,304,224
10445,Le Mesnil-Simon,28247,28,44,160,48,160,168,376,204
10446,Le Mesnil-Thomas,28248,28,55,100,15,115,65,195,155
10447,Mévoisins,28249,28,95,135,35,205,130,370,230
10448,Mézières-au-Perche,28250,28,0,36,0,68,28,96,36
10449,Mézières-en-Drouais,28251,28,100,308,60,356,224,640,408
10450,Miermaigne,28252,28,12,30,12,84,21,117,42
10451,Mignières,28253,28,37,296,86,233,225,544,333
10452,Mittainvilliers-Vérigny,28254,28,90,226,51,217,200,468,316
10453,Moinville-la-Jeulin,28255,28,12,66,8,20,52,80,78
10454,Moléans,28256,28,49,125,40,184,80,304,174
10455,Mondonville-Saint-Jean,28257,28,0,27,0,19,34,53,27
10456,Montboissier,28259,28,45,75,20,113,75,208,120
10457,Montharville,28260,28,4,28,4,20,32,56,32
10458,Montigny-le-Chartif,28261,28,116,186,48,144,144,336,302
10459,Montigny-le-Gannelon,28262,28,49,103,31,172,78,281,152
10460,Montigny-sur-Avre,28263,28,55,70,0,70,70,140,125
10461,Montireau,28264,28,30,35,10,20,35,65,65
10462,Montlandon,28265,28,45,45,5,100,35,140,90
10463,Montreuil,28267,28,27,95,28,134,78,240,122
10464,Seynes,30320,30,24,0,0,76,28,104,24
10465,Sommières,30321,30,638,1250,427,1296,892,2615,1888
10466,Soudorgues,30322,30,56,60,12,96,60,168,116
10467,Soustelle,30323,30,15,25,20,40,30,90,40
10468,Souvignargues,30324,30,108,231,36,273,195,504,339
10469,Sumène,30325,30,335,315,60,495,320,875,650
10470,Tavel,30326,30,205,441,155,609,414,1178,646
10471,Tharaux,30327,30,3,20,0,26,6,32,23
10472,Théziers,30328,30,92,300,124,352,244,720,392
10473,Thoiras,30329,30,80,72,4,147,65,216,152
10474,Tornac,30330,30,77,165,67,314,126,507,242
10475,Tresques,30331,30,289,320,156,716,205,1077,609
10476,Trèves,30332,30,20,10,15,65,20,100,30
10477,Uchaud,30333,30,533,1159,406,1203,911,2520,1692
10478,Uzès,30334,30,1646,1633,700,2957,1207,4864,3279
10479,Vabres,30335,30,15,23,6,36,7,49,38
10480,Vallabrègues,30336,30,156,316,128,440,312,880,472
10481,Vallabrix,30337,30,12,90,12,158,95,265,102
10482,Vallérargues,30338,30,25,35,25,40,15,80,60
10483,Valleraugue,30339,30,160,152,88,440,144,672,312
10484,Valliguières,30340,30,49,150,42,167,129,338,199
10485,Vauvert,30341,30,1389,2914,1078,3661,2091,6830,4303
10486,Vénéjan,30342,30,120,280,76,480,252,808,400
10487,Verfeuil,30343,30,80,149,32,192,160,384,229
10488,Vergèze,30344,30,630,1340,375,1555,1080,3010,1970
10489,La Vernarède,30345,30,56,27,15,161,33,209,83
10490,Vers-Pont-du-Gard,30346,30,177,471,200,677,358,1235,648
10491,Vestric-et-Candiac,30347,30,156,368,196,440,256,892,524
10492,Vézénobres,30348,30,284,404,84,644,320,1048,688
10493,Vic-le-Fesq,30349,30,65,120,25,130,110,265,185
10494,Le Vigan,30350,30,580,769,287,1490,602,2379,1349
10495,Villeneuve-lès-Avignon,30351,30,2076,2245,794,4512,1705,7011,4321
10496,Villevieille,30352,30,333,390,72,523,266,861,723
10497,Vissec,30353,30,5,25,0,30,15,45,30
10498,Montagnac,30354,30,32,56,20,84,20,124,88
10499,Saint-Paul-les-Fonts,30355,30,94,277,68,233,265,566,371
10500,Rodilhan,30356,30,405,610,355,980,455,1790,1015
10501,Agassac,31001,31,0,20,8,50,12,70,20
10502,Aignes,31002,31,30,70,25,50,65,140,100
10503,Aigrefeuille,31003,31,20,383,68,412,254,734,403
10504,Ayguesvives,31004,31,162,751,171,918,486,1575,913
10505,Alan,31005,31,32,80,8,128,80,216,112
10506,Albiac,31006,31,36,56,13,32,44,89,92
10507,Ambax,31007,31,6,19,9,12,16,37,25
10508,Anan,31008,31,30,49,4,118,24,146,79
10509,Antichan-de-Frontignes,31009,31,40,12,12,32,4,48,52
10510,Antignac,31010,31,16,12,12,40,8,60,28
10511,Arbas,31011,31,33,41,4,99,34,137,74
10512,Arbon,31012,31,8,12,4,41,8,53,20
10513,Ardiège,31013,31,57,93,12,75,85,172,150
10514,Arguenos,31014,31,17,4,0,24,8,32,21
10515,Argut-Dessous,31015,31,0,0,6,6,6,18,0
10516,Arlos,31017,31,8,8,8,40,12,60,16
10517,Arnaud-Guilhem,31018,31,55,50,5,105,30,140,105
10518,Artigue,31019,31,0,0,0,15,0,15,0
10519,Aspet,31020,31,188,138,75,303,161,539,326
10520,Aspret-Sarrat,31021,31,12,28,20,36,32,88,40
10521,Aucamville,31022,31,756,1839,1378,2213,1815,5406,2595
10522,Aulon,31023,31,91,55,30,100,51,181,146
10523,Auragne,31024,31,36,128,48,128,76,252,164
10524,Aureville,31025,31,72,229,44,248,211,503,301
10525,Auriac-sur-Vendinelle,31026,31,116,223,61,376,154,591,339
10526,Auribail,31027,31,10,45,40,105,15,160,55
10527,Aurignac,31028,31,216,268,92,300,196,588,484
10528,Aurin,31029,31,45,80,40,70,60,170,125
10529,Ausseing,31030,31,8,16,0,25,8,33,24
10530,Ausson,31031,31,99,94,16,247,75,338,193
10531,Aussonne,31032,31,680,1821,681,2082,1570,4333,2501
10532,Auterive,31033,31,1113,2331,985,2648,1897,5530,3444
10533,Auzas,31034,31,8,55,13,66,52,131,63
10534,Auzeville-Tolosane,31035,31,412,971,567,906,497,1970,1383
10535,Auzielle,31036,31,94,274,59,535,211,805,368
10536,Avignonet-Lauragais,31037,31,140,404,124,428,344,896,544
10537,Azas,31038,31,63,154,57,189,101,347,217
10538,Bachas,31039,31,8,12,0,34,4,38,20
10539,Bachos,31040,31,9,10,0,15,0,15,19
10540,Bagiry,31041,31,12,16,8,48,12,68,28
10541,Bagnères-de-Luchon,31042,31,546,300,80,965,308,1353,846
10542,Balesta,31043,31,38,28,9,40,15,64,66
10543,Balma,31044,31,2089,3635,1690,4514,2742,8946,5724
10544,Barbazan,31045,31,58,65,18,136,56,210,123
10545,Baren,31046,31,8,0,0,0,0,0,8
10546,Bax,31047,31,3,17,3,35,18,56,20
10547,Baziège,31048,31,285,863,146,1022,692,1860,1148
10548,Bazus,31049,31,105,115,50,195,100,345,220
10549,Beauchalot,31050,31,44,129,43,236,37,316,173
10550,Beaufort,31051,31,12,140,16,107,93,216,152
10551,Beaumont-sur-Lèze,31052,31,172,380,88,544,320,952,552
10552,Beaupuy,31053,31,151,252,63,454,189,706,403
10553,Beauteville,31054,31,25,50,0,55,50,105,75
10554,Beauville,31055,31,12,56,8,60,20,88,68
10555,Beauzelle,31056,31,612,1447,611,2141,1139,3891,2059
10556,Belberaud,31057,31,85,345,130,470,225,825,430
10557,Belbèze-de-Lauragais,31058,31,25,32,10,40,26,76,57
10558,Belbèze-en-Comminges,31059,31,24,15,9,18,12,39,39
10559,Bélesta-en-Lauragais,31060,31,3,31,6,22,23,51,34
10560,Bellegarde-Sainte-Marie,31061,31,35,40,20,60,10,90,75
10561,Bellesserre,31062,31,13,40,0,20,39,59,53
10562,Benque,31063,31,35,25,10,65,20,95,60
10563,Benque-Dessous-et-Dessus,31064,31,15,0,5,10,0,15,15
10564,Bérat,31065,31,161,940,168,816,781,1765,1101
10565,Bessières,31066,31,350,1059,357,957,829,2143,1409
10566,Bezins-Garraux,31067,31,6,3,3,9,9,21,9
10567,Billière,31068,31,15,0,0,10,5,15,15
10568,Blagnac,31069,31,2372,5228,3497,6886,4904,15287,7600
10569,Blajan,31070,31,120,95,53,134,100,287,215
10570,Bois-de-la-Pierre,31071,31,30,73,21,139,43,203,103
10571,Boissède,31072,31,35,5,0,30,0,30,40
10572,Bondigoux,31073,31,25,147,40,164,85,289,172
10573,Bonrepos-Riquet,31074,31,25,45,40,120,40,200,70
10574,Bonrepos-sur-Aussonnelle,31075,31,76,330,93,272,291,656,406
10575,Bordes-de-Rivière,31076,31,75,118,25,185,83,293,193
10576,Le Born,31077,31,45,115,60,150,125,335,160
10577,Boudrac,31078,31,30,35,5,45,30,80,65
10578,Bouloc,31079,31,371,1247,253,1402,1040,2695,1618
10579,Boulogne-sur-Gesse,31080,31,283,304,105,544,223,872,587
10580,Bourg-d'Oueil,31081,31,6,0,0,0,0,0,6
10581,Bourg-Saint-Bernard,31082,31,100,237,59,319,201,579,337
10582,Boussan,31083,31,32,48,8,112,52,172,80
10583,Boussens,31084,31,132,240,120,380,217,717,372
10584,Boutx,31085,31,28,48,0,100,64,164,76
10585,Bouzin,31086,31,10,25,0,35,10,45,35
10586,Bragayrac,31087,31,48,76,56,96,36,188,124
10587,Brax,31088,31,295,675,260,920,450,1630,970
10588,Bretx,31089,31,16,213,41,159,152,352,229
10589,Brignemont,31090,31,75,110,20,125,80,225,185
10590,Bruguières,31091,31,538,1380,506,1694,1095,3295,1918
10591,Burgalays,31092,31,30,25,10,45,25,80,55
10592,Le Burgaud,31093,31,116,292,79,208,218,505,408
10593,Buzet-sur-Tarn,31094,31,219,874,174,623,748,1545,1093
10594,Cabanac-Cazaux,31095,31,0,25,15,40,40,95,25
10595,Cabanac-Séguenville,31096,31,8,40,8,60,32,100,48
10596,Le Cabanial,31097,31,24,112,24,108,88,220,136
10597,Cadours,31098,31,185,280,90,280,175,545,465
10598,Caignac,31099,31,15,56,30,91,50,171,71
10599,Calmont,31100,31,236,605,196,628,523,1347,841
10600,Cambernard,31101,31,25,100,25,175,130,330,125
10601,Cambiac,31102,31,25,60,0,100,30,130,85
10602,Canens,31103,31,3,9,6,15,12,33,12
10603,Capens,31104,31,40,228,64,184,180,428,268
10604,Caragoudes,31105,31,30,45,15,100,25,140,75
10605,Caraman,31106,31,238,655,185,762,507,1454,893
10606,Carbonne,31107,31,721,1471,468,1470,1142,3080,2192
10607,Cardeilhac,31108,31,40,59,0,96,44,140,99
10608,Cassagnabère-Tournas,31109,31,85,105,30,130,95,255,190
10609,Cassagne,31110,31,90,129,25,256,135,416,219
10610,Castagnac,31111,31,20,80,25,95,75,195,100
10611,Castagnède,31112,31,44,44,12,56,32,100,88
10612,Castanet-Tolosan,31113,31,1473,2881,1411,4250,2522,8183,4354
10613,Castelbiague,31114,31,45,85,0,105,30,135,130
10614,Castelgaillard,31115,31,20,10,0,20,10,30,30
10615,Castelginest,31116,31,1097,2284,1222,2788,2166,6176,3381
10616,Castelmaurou,31117,31,417,983,325,1247,758,2330,1400
10617,Castelnau-d'Estrétefonds,31118,31,333,1695,652,1595,1556,3803,2028
10618,Castelnau-Picampeau,31119,31,20,52,0,64,64,128,72
10619,Le Castéra,31120,31,70,224,41,317,140,498,294
10620,Castéra-Vignoles,31121,31,0,30,5,35,10,50,30
10621,Casties-Labrande,31122,31,10,25,5,75,10,90,35
10622,Castillon-de-Larboust,31123,31,3,3,6,21,0,27,6
10623,Castillon-de-Saint-Martory,31124,31,20,95,35,150,80,265,115
10624,Cathervielle,31125,31,12,4,0,24,0,24,16
10625,Caubiac,31126,31,21,106,40,70,106,216,127
10626,Caubous,31127,31,0,0,0,0,0,0,0
10627,Caujac,31128,31,75,205,110,270,170,550,280
10628,Cazarilh-Laspènes,31129,31,0,10,0,0,10,10,10
10629,Cazaril-Tambourès,31130,31,16,32,0,48,8,56,48
10630,Cazaunous,31131,31,8,13,0,25,18,43,21
10631,Cazaux-Layrisse,31132,31,15,3,0,19,3,22,18
10632,Cazeaux-de-Larboust,31133,31,9,10,0,34,12,46,19
10633,Cazeneuve-Montaut,31134,31,0,15,0,35,20,55,15
10634,Cazères,31135,31,835,1230,445,1365,895,2705,2065
10635,Cépet,31136,31,100,362,108,460,339,907,462
10636,Cessales,31137,31,20,35,10,55,25,90,55
10637,Charlas,31138,31,35,25,10,115,30,155,60
10638,Chaum,31139,31,50,40,10,60,15,85,90
10639,Chein-Dessus,31140,31,75,20,15,60,25,100,95
10640,Ciadoux,31141,31,28,48,18,92,15,125,76
10641,Cier-de-Luchon,31142,31,30,55,5,140,25,170,85
10642,Cier-de-Rivière,31143,31,43,49,25,91,38,154,92
10643,Cierp-Gaud,31144,31,166,125,55,282,106,443,291
10644,Cintegabelle,31145,31,458,694,203,843,589,1635,1152
10645,Cirès,31146,31,8,0,0,4,4,8,8
10646,Clarac,31147,31,40,155,30,260,125,415,195
10647,Clermont-le-Fort,31148,31,55,125,10,195,75,280,180
10648,Colomiers,31149,31,3558,9998,4835,11322,8178,24335,13556
10649,Cornebarrieu,31150,31,599,1604,575,1944,1432,3951,2203
10650,Corronsac,31151,31,43,243,30,256,154,440,286
10651,Coueilles,31152,31,15,16,0,38,12,50,31
10652,Couladère,31153,31,84,88,16,168,72,256,172
10653,Couret,31155,31,40,60,28,64,48,140,100
10654,Cox,31156,31,45,105,15,150,25,190,150
10655,Cugnaux,31157,31,1965,4201,2093,4889,3685,10667,6166
10656,Cuguron,31158,31,45,25,15,75,25,115,70
10657,Le Cuing,31159,31,45,74,33,109,59,201,119
10658,Daux,31160,31,144,608,224,631,589,1444,752
10659,Deyme,31161,31,77,222,73,433,151,657,299
10660,Donneville,31162,31,95,280,50,400,195,645,375
10661,Drémil-Lafage,31163,31,182,633,181,1025,467,1673,815
10662,Drudas,31164,31,15,55,15,70,50,135,70
10663,Eaunes,31165,31,567,1575,643,1700,1285,3628,2142
10664,Empeaux,31166,31,30,80,10,50,65,125,110
10665,Encausse-les-Thermes,31167,31,68,184,68,256,124,448,252
10666,Eoux,31168,31,74,0,0,45,5,50,74
10667,Escalquens,31169,31,609,1494,625,2357,990,3972,2103
10668,Escanecrabe,31170,31,32,62,4,91,40,135,94
10669,Espanès,31171,31,21,57,30,118,46,194,78
10670,Esparron,31172,31,20,0,15,30,0,45,20
10671,Esperce,31173,31,36,56,8,84,56,148,92
10672,Estadens,31174,31,80,85,60,220,95,375,165
10673,Estancarbon,31175,31,105,137,20,185,140,345,242
10674,Esténos,31176,31,15,35,5,105,20,130,50
10675,Eup,31177,31,23,13,6,55,3,64,36
10676,Fabas,31178,31,42,48,0,75,25,100,90
10677,Le Faget,31179,31,55,105,15,100,65,180,160
10678,Falga,31180,31,4,35,38,39,20,97,39
10679,Le Fauga,31181,31,190,605,185,520,450,1155,795
10680,Fenouillet,31182,31,575,1289,456,1657,935,3048,1864
10681,Figarol,31183,31,60,55,10,105,50,165,115
10682,Flourens,31184,31,125,489,139,631,410,1180,614
10683,Folcarde,31185,31,20,24,12,36,32,80,44
10684,Fonbeauzard,31186,31,366,601,395,952,584,1931,967
10685,Fonsorbes,31187,31,799,3473,1103,3660,2511,7274,4272
10686,Fontenilles,31188,31,295,1736,427,1489,1304,3220,2031
10687,Forgues,31189,31,28,60,12,28,72,112,88
10688,Fos,31190,31,48,60,0,84,60,144,108
10689,Fougaron,31191,31,25,20,0,25,35,60,45
10690,Fourquevaux,31192,31,87,179,42,249,109,400,266
10691,Le Fousseret,31193,31,317,493,124,493,403,1020,810
10692,Francarville,31194,31,8,68,4,52,60,116,76
10693,Francazal,31195,31,3,3,0,0,6,6,6
10694,Francon,31196,31,30,65,35,85,35,155,95
10695,Franquevielle,31197,31,90,55,10,120,45,175,145
10696,Le Fréchet,31198,31,24,24,0,48,12,60,48
10697,Fronsac,31199,31,37,32,8,75,17,100,69
10698,Frontignan-de-Comminges,31200,31,16,8,4,32,0,36,24
10699,Frontignan-Savès,31201,31,4,0,13,33,4,50,4
10700,Fronton,31202,31,592,1508,543,1928,1047,3518,2100
10701,Frouzins,31203,31,718,2382,926,2767,1845,5538,3100
10702,Fustignac,31204,31,4,18,0,28,12,40,22
10703,Gagnac-sur-Garonne,31205,31,203,752,321,811,739,1871,955
10704,Gaillac-Toulza,31206,31,105,255,169,360,205,734,360
10705,Galié,31207,31,20,15,5,45,0,50,35
10706,Ganties,31208,31,70,60,20,110,35,165,130
10707,Garac,31209,31,15,51,20,65,15,100,66
10708,Gardouch,31210,31,150,325,95,435,250,780,475
10709,Gargas,31211,31,40,204,52,238,146,436,244
10710,Garidech,31212,31,124,497,109,588,366,1063,621
10711,Garin,31213,31,24,4,4,64,32,100,28
10712,Gauré,31215,31,60,125,20,210,65,295,185
10713,Gémil,31216,31,12,96,20,80,92,192,108
10714,Génos,31217,31,12,3,9,24,12,45,15
10715,Gensac-de-Boulogne,31218,31,20,28,0,56,12,68,48
10716,Gensac-sur-Garonne,31219,31,33,100,34,97,96,227,133
10717,Gibel,31220,31,25,101,4,84,86,174,126
10718,Gouaux-de-Larboust,31221,31,4,12,0,24,12,36,16
10719,Gouaux-de-Luchon,31222,31,25,5,0,5,10,15,30
10720,Goudex,31223,31,12,4,4,24,0,28,16
10721,Gourdan-Polignan,31224,31,255,245,125,395,160,680,500
10722,Goutevernisse,31225,31,9,29,12,55,37,104,38
10723,Gouzens,31226,31,0,17,4,32,16,52,17
10724,Goyrans,31227,31,115,180,65,330,135,530,295
10725,Gragnague,31228,31,94,498,115,648,306,1069,592
10726,Gratens,31229,31,56,164,44,220,160,424,220
10727,Gratentour,31230,31,350,840,240,1310,700,2250,1190
10728,Grazac,31231,31,38,130,21,209,108,338,168
10729,Grenade,31232,31,884,2217,907,2387,1874,5168,3101
10730,Grépiac,31233,31,80,260,65,320,245,630,340
10731,Le Grès,31234,31,40,140,36,88,116,240,180
10732,Guran,31235,31,15,5,0,10,10,20,20
10733,Herran,31236,31,24,8,0,32,4,36,32
10734,His,31237,31,40,75,5,60,65,130,115
10735,Huos,31238,31,105,115,30,150,85,265,220
10736,L'Isle-en-Dodon,31239,31,369,324,91,667,178,936,693
10737,Issus,31240,31,33,156,33,180,127,340,189
10738,Izaut-de-l'Hôtel,31241,31,114,80,15,83,40,138,194
10739,Jurvielle,31242,31,0,12,0,8,4,12,12
10740,Juzes,31243,31,20,15,15,30,10,55,35
10741,Juzet-de-Luchon,31244,31,85,70,10,130,70,210,155
10742,Juzet-d'Izaut,31245,31,64,32,8,76,32,116,96
10743,Labarthe-Inard,31246,31,120,170,80,330,145,555,290
10744,Labarthe-Rivière,31247,31,235,290,80,500,230,810,525
10745,Labarthe-sur-Lèze,31248,31,497,1446,502,1773,944,3219,1943
10746,Labastide-Beauvoir,31249,31,70,300,55,343,275,673,370
10747,Labastide-Clermont,31250,31,90,185,40,205,130,375,275
10748,Labastide-Paumès,31251,31,30,35,5,45,30,80,65
10749,Labastide-Saint-Sernin,31252,31,190,467,163,606,359,1128,657
10750,Labastidette,31253,31,99,717,151,740,622,1513,816
10751,Labège,31254,31,376,1004,972,936,595,2503,1380
10752,Labroquère,31255,31,48,68,24,112,76,212,116
10753,Labruyère-Dorsa,31256,31,4,80,20,72,92,184,84
10754,Lacaugne,31258,31,15,40,40,80,39,159,55
10755,Lacroix-Falgarde,31259,31,191,467,171,700,363,1234,658
10756,Laffite-Toupière,31260,31,10,25,0,55,10,65,35
10757,Lafitte-Vigordane,31261,31,111,349,67,288,256,611,460
10758,Lagarde,31262,31,30,105,40,89,139,268,135
10759,Lagardelle-sur-Lèze,31263,31,200,741,212,886,584,1682,941
10760,Lagrâce-Dieu,31264,31,50,160,25,155,165,345,210
10761,Lagraulet-Saint-Nicolas,31265,31,25,65,10,116,40,166,90
10762,Lahage,31266,31,18,28,3,38,19,60,46
10763,Lahitère,31267,31,8,16,8,16,4,28,24
10764,Lalouret-Laffiteau,31268,31,25,25,0,55,35,90,50
10765,Lamasquère,31269,31,125,388,77,392,371,840,513
10766,Landorthe,31270,31,90,215,52,414,147,613,305
10767,Lanta,31271,31,140,555,129,459,558,1146,695
10768,Lapeyrère,31272,31,0,20,5,20,15,40,20
10769,Lapeyrouse-Fossat,31273,31,255,770,190,1100,470,1760,1025
10770,Larcan,31274,31,5,45,20,70,35,125,50
10771,Laréole,31275,31,30,40,35,40,15,90,70
10772,Larroque,31276,31,62,47,16,110,29,155,109
10773,Lasserre,31277,31,60,296,68,348,252,668,356
10774,Latoue,31278,31,59,70,10,115,60,185,129
10775,Latour,31279,31,20,10,10,35,10,55,30
10776,Latrape,31280,31,22,89,12,142,60,214,111
10777,Launac,31281,31,105,445,105,452,324,881,550
10778,Launaguet,31282,31,597,2131,911,2290,1847,5048,2728
10779,Lautignac,31283,31,30,65,25,90,50,165,95
10780,Lauzerville,31284,31,40,528,88,415,416,919,568
10781,Lavalette,31285,31,72,154,24,282,148,454,226
10782,Lavelanet-de-Comminges,31286,31,80,160,25,220,140,385,240
10783,Lavernose-Lacasse,31287,31,238,841,180,955,631,1766,1079
10784,Layrac-sur-Tarn,31288,31,70,80,10,104,55,169,150
10785,Lécussan,31289,31,48,56,0,96,60,156,104
10786,Lège,31290,31,15,5,0,5,10,15,20
10787,Léguevin,31291,31,500,2445,1146,2719,1872,5737,2945
10788,Lescuns,31292,31,12,4,0,16,8,24,16
10789,Lespinasse,31293,31,204,708,270,755,697,1722,912
10790,Lespiteau,31294,31,12,16,4,41,4,49,28
10791,Lespugue,31295,31,8,16,0,24,20,44,24
10792,Lestelle-de-Saint-Martory,31296,31,55,80,65,175,80,320,135
10793,Lévignac,31297,31,200,568,148,576,480,1204,768
10794,Lez,31298,31,30,20,0,0,20,20,50
10795,Lherm,31299,31,343,945,382,982,808,2172,1288
10796,Lieoux,31300,31,25,15,5,45,25,75,40
10797,Lilhac,31301,31,36,24,0,36,24,60,60
10798,Lodes,31302,31,49,39,8,121,33,162,88
10799,Longages,31303,31,243,821,262,825,689,1776,1064
10800,Loubens-Lauragais,31304,31,29,97,43,130,104,277,126
10801,Loudet,31305,31,52,40,0,88,28,116,92
10802,Lourde,31306,31,22,13,0,41,6,47,35
10803,Lunax,31307,31,12,16,16,16,8,40,28
10804,Luscan,31308,31,10,0,0,20,10,30,10
10805,Lussan-Adeilhac,31309,31,50,30,0,110,45,155,80
10806,Lux,31310,31,30,81,10,60,84,154,111
10807,La Magdelaine-sur-Tarn,31311,31,108,360,80,284,304,668,468
10808,Mailholas,31312,31,0,3,0,21,0,21,3
10809,Malvezie,31313,31,4,36,8,36,32,76,40
10810,Mancioux,31314,31,68,116,44,120,92,256,184
10811,Mane,31315,31,200,150,69,370,170,609,350
10812,Marignac,31316,31,93,72,28,180,51,259,165
10813,Marignac-Lasclares,31317,31,63,89,48,155,74,277,152
10814,Marignac-Laspeyres,31318,31,20,49,4,76,34,114,69
10815,Marliac,31319,31,16,21,12,50,4,66,37
10816,Marquefave,31320,31,86,225,73,330,192,595,311
10817,Marsoulas,31321,31,4,16,8,40,28,76,20
10818,Martisserre,31322,31,10,15,0,40,0,40,25
10819,Martres-de-Rivière,31323,31,52,61,30,169,61,260,113
10820,Martres-Tolosane,31324,31,361,550,155,705,375,1235,911
10821,Mascarville,31325,31,12,29,22,48,24,94,41
10822,Massabrac,31326,31,8,20,0,32,16,48,28
10823,Mauran,31327,31,35,39,30,51,34,115,74
10824,Mauremont,31328,31,12,116,8,116,84,208,128
10825,Maurens,31329,31,21,25,33,58,31,122,46
10826,Mauressac,31330,31,30,161,40,113,112,265,191
10827,Maureville,31331,31,35,85,5,120,65,190,120
10828,Mauvaisin,31332,31,15,45,30,95,40,165,60
10829,Mauvezin,31333,31,8,21,8,21,16,45,29
10830,Mauzac,31334,31,88,378,80,324,345,749,466
10831,Mayrègne,31335,31,0,5,0,15,10,25,5
10832,Mazères-sur-Salat,31336,31,131,102,28,163,78,269,233
10833,Melles,31337,31,0,5,0,75,10,85,5
10834,Menville,31338,31,30,185,75,195,205,475,215
10835,Mérenvielle,31339,31,16,161,20,198,88,306,177
10836,Mervilla,31340,31,20,80,16,76,72,164,100
10837,Merville,31341,31,325,1490,531,1454,1189,3174,1815
10838,Milhas,31342,31,29,26,8,40,49,97,55
10839,Mirambeau,31343,31,8,8,8,20,16,44,16
10840,Miramont-de-Comminges,31344,31,155,235,45,210,160,415,390
10841,Miremont,31345,31,230,668,230,546,571,1347,898
10842,Mirepoix-sur-Tarn,31346,31,51,260,27,231,325,583,311
10843,Molas,31347,31,24,20,4,71,17,92,44
10844,Moncaup,31348,31,16,0,0,16,0,16,16
10845,Mondavezan,31349,31,120,204,68,268,208,544,324
10846,Mondilhan,31350,31,10,5,0,55,10,65,15
10847,Mondonville,31351,31,310,1285,590,1190,1130,2910,1595
10848,Mondouzil,31352,31,25,65,20,100,15,135,90
10849,Monès,31353,31,16,9,0,32,12,44,25
10850,Monestrol,31354,31,8,16,12,16,4,32,24
10851,Mons,31355,31,204,451,111,593,289,993,655
10852,Montaigut-sur-Save,31356,31,168,443,103,577,305,985,611
10853,Montastruc-de-Salies,31357,31,53,35,12,61,51,124,88
10854,Montastruc-la-Conseillère,31358,31,333,922,240,1080,703,2023,1255
10855,Montastruc-Savès,31359,31,16,8,4,8,12,24,24
10856,Montauban-de-Luchon,31360,31,64,79,3,154,70,227,143
10857,Montaut,31361,31,48,144,32,208,100,340,192
10858,Montberaud,31362,31,55,40,15,50,45,110,95
10859,Montbernard,31363,31,40,40,5,85,55,145,80
10860,Montberon,31364,31,213,737,248,935,533,1716,950
10861,Montbrun-Bocage,31365,31,65,110,45,180,70,295,175
10862,Montbrun-Lauragais,31366,31,34,185,25,205,140,370,219
10863,Montclar-de-Comminges,31367,31,24,12,0,32,16,48,36
10864,Montclar-Lauragais,31368,31,24,54,8,78,44,130,78
10865,Mont-de-Galié,31369,31,8,17,0,20,0,20,25
10866,Montégut-Bourjac,31370,31,21,25,8,24,27,59,46
10867,Montégut-Lauragais,31371,31,41,120,12,138,101,251,161
10868,Montespan,31372,31,120,85,10,184,65,259,205
10869,Montesquieu-Guittaut,31373,31,35,30,15,60,25,100,65
10870,Montesquieu-Lauragais,31374,31,48,212,56,404,204,664,260
10871,Montesquieu-Volvestre,31375,31,541,700,178,990,587,1755,1241
10872,Montgaillard-de-Salies,31376,31,16,21,6,24,15,45,37
10873,Montgaillard-Lauragais,31377,31,67,197,47,194,142,383,264
10874,Montgaillard-sur-Save,31378,31,4,22,0,25,17,42,26
10875,Montgazin,31379,31,21,40,20,50,33,103,61
10876,Montgeard,31380,31,40,116,40,180,84,304,156
10877,Montgiscard,31381,31,218,556,123,660,443,1226,774
10878,Montgras,31382,31,16,24,0,20,28,48,40
10879,Montjoire,31383,31,141,350,96,405,284,785,491
10880,Montlaur,31384,31,124,372,60,372,260,692,496
10881,Montmaurin,31385,31,55,50,20,75,30,125,105
10882,Montoulieu-Saint-Bernard,31386,31,30,40,15,80,25,120,70
10883,Montoussin,31387,31,15,30,10,40,25,75,45
10884,Montpitol,31388,31,55,111,25,145,70,240,166
10885,Montrabé,31389,31,361,953,351,1446,807,2604,1314
10886,Montréjeau,31390,31,517,620,246,868,419,1533,1137
10887,Montsaunès,31391,31,80,108,20,157,80,257,188
10888,Mourvilles-Basses,31392,31,0,30,10,15,30,55,30
10889,Mourvilles-Hautes,31393,31,5,40,15,85,25,125,45
10890,Moustajon,31394,31,12,28,12,57,30,99,40
10891,Muret,31395,31,2742,5684,2773,7742,4570,15085,8426
10892,Nailloux,31396,31,169,1040,388,794,877,2059,1209
10893,Nénigan,31397,31,0,4,4,28,4,36,4
10894,Nizan-Gesse,31398,31,12,0,12,15,18,45,12
10895,Noé,31399,31,290,820,185,795,755,1735,1110
10896,Nogaret,31400,31,10,20,0,35,10,45,30
10897,Noueilles,31401,31,12,91,29,132,86,247,103
10898,Odars,31402,31,85,229,45,279,155,479,314
10899,Ondes,31403,31,52,196,76,192,148,416,248
10900,Oô,31404,31,15,25,10,50,10,70,40
10901,Ore,31405,31,25,20,0,50,5,55,45
10902,Palaminy,31406,31,118,156,79,206,125,410,274
10903,Paulhac,31407,31,50,355,54,400,301,755,405
10904,Payssous,31408,31,12,20,0,28,13,41,32
10905,Péchabou,31409,31,175,550,172,702,429,1303,725
10906,Pechbonnieu,31410,31,321,1211,402,1254,880,2536,1532
10907,Pechbusque,31411,31,66,210,57,273,157,487,276
10908,Péguilhan,31412,31,50,30,5,78,30,113,80
10909,Pelleport,31413,31,55,137,35,180,120,335,192
10910,Peyrissas,31414,31,3,9,3,27,15,45,12
10911,Peyrouzet,31415,31,16,32,4,32,20,56,48
10912,Peyssies,31416,31,42,117,58,164,85,307,159
10913,Pibrac,31417,31,594,2156,750,2979,1507,5236,2750
10914,Pin-Balma,31418,31,90,185,100,396,65,561,275
10915,Le Pin-Murelet,31419,31,18,31,6,63,15,84,49
10916,Pinsaguel,31420,31,399,604,299,1053,393,1745,1003
10917,Pins-Justaret,31421,31,350,1151,325,1617,881,2823,1501
10918,Plagne,31422,31,20,20,10,30,20,60,40
10919,Plagnole,31423,31,32,68,32,112,64,208,100
10920,Plaisance-du-Touch,31424,31,1515,4634,1642,5822,3354,10818,6149
10921,Le Plan,31425,31,80,120,44,153,85,282,200
10922,Pointis-de-Rivière,31426,31,108,200,52,188,176,416,308
10923,Pointis-Inard,31427,31,108,187,60,301,142,503,295
10924,Polastron,31428,31,21,9,0,24,6,30,30
10925,Pompertuzat,31429,31,116,572,235,703,463,1401,688
10926,Ponlat-Taillebourg,31430,31,80,160,69,178,155,402,240
10927,Portet-d'Aspet,31431,31,20,0,8,32,4,44,20
10928,Portet-de-Luchon,31432,31,0,12,0,20,12,32,12
10929,Portet-sur-Garonne,31433,31,1254,2480,845,2933,1712,5490,3734
10930,Poubeau,31434,31,5,25,5,35,20,60,30
10931,Poucharramet,31435,31,96,191,60,263,160,483,287
10932,Pouy-de-Touges,31436,31,33,96,17,123,76,216,129
10933,Pouze,31437,31,3,18,0,28,30,58,21
10934,Pradère-les-Bourguets,31438,31,18,121,19,74,113,206,139
10935,Préserville,31439,31,36,227,40,244,162,446,263
10936,Proupiary,31440,31,12,3,6,21,0,27,15
10937,Prunet,31441,31,4,25,16,55,24,95,29
10938,Puydaniel,31442,31,38,110,34,151,92,277,148
10939,Puymaurin,31443,31,42,59,8,104,40,152,101
10940,Puysségur,31444,31,8,33,4,46,25,75,41
10941,Quint-Fonsegrives,31445,31,828,1102,430,1654,968,3052,1930
10942,Ramonville-Saint-Agne,31446,31,2064,3091,1922,3877,2692,8491,5155
10943,Razecueillé,31447,31,20,0,8,4,4,16,20
10944,Rebigue,31448,31,64,124,60,160,96,316,188
10945,Régades,31449,31,10,45,0,35,50,85,55
10946,Renneville,31450,31,60,170,10,160,125,295,230
10947,Revel,31451,31,1920,1961,887,3049,1358,5294,3881
10948,Rieucazé,31452,31,4,20,8,12,16,36,24
10949,Rieumajou,31453,31,5,35,20,45,25,90,40
10950,Rieumes,31454,31,482,890,261,927,736,1924,1372
10951,Rieux-Volvestre,31455,31,260,605,175,945,435,1555,865
10952,Riolas,31456,31,6,3,0,15,6,21,9
10953,Roquefort-sur-Garonne,31457,31,100,196,52,256,176,484,296
10954,Roques,31458,31,400,1157,610,1366,821,2797,1557
10955,Roquesérière,31459,31,96,196,32,212,168,412,292
10956,Roquettes,31460,31,415,951,410,1475,841,2726,1366
10957,Rouède,31461,31,40,65,20,105,45,170,105
10958,Rouffiac-Tolosan,31462,31,141,429,215,825,298,1338,570
10959,Roumens,31463,31,30,70,25,75,50,150,100
10960,Sabonnères,31464,31,30,52,42,119,34,195,82
10961,Saccourvielle,31465,31,0,0,0,10,0,10,0
10962,Saiguède,31466,31,105,210,60,265,155,480,315
10963,Saint-Alban,31467,31,535,1419,629,1919,1276,3824,1954
10964,Saint-André,31468,31,48,36,4,120,16,140,84
10965,Saint-Araille,31469,31,12,26,21,40,20,81,38
10966,Saint-Aventin,31470,31,8,36,8,48,16,72,44
10967,Saint-Béat,31471,31,83,60,12,184,52,248,143
10968,Saint-Bertrand-de-Comminges,31472,31,55,45,10,69,60,139,100
10969,Saint-Cézert,31473,31,36,108,72,92,112,276,144
10970,Saint-Christaud,31474,31,22,58,18,77,48,143,80
10971,Saint-Clar-de-Rivière,31475,31,109,334,88,400,266,754,443
10972,Saint-Élix-le-Château,31476,31,87,200,46,295,162,503,287
10973,Saint-Élix-Séglan,31477,31,12,9,3,12,6,21,21
10974,Saint-Félix-Lauragais,31478,31,217,257,107,471,157,735,474
10975,Saint-Ferréol-de-Comminges,31479,31,12,3,0,12,6,18,15
10976,Sainte-Foy-d'Aigrefeuille,31480,31,78,521,157,710,364,1231,599
10977,Sainte-Foy-de-Peyrolières,31481,31,152,516,144,724,440,1308,668
10978,Saint-Frajou,31482,31,27,29,13,53,52,118,56
10979,Saint-Gaudens,31483,31,2187,2199,1088,3418,1590,6096,4386
10980,Saint-Geniès-Bellevue,31484,31,243,568,211,763,436,1410,811
10981,Saint-Germier,31485,31,13,25,9,38,4,51,38
10982,Saint-Hilaire,31486,31,47,302,63,338,232,633,349
10983,Saint-Ignan,31487,31,43,33,3,80,12,95,76
10984,Saint-Jean,31488,31,1477,2555,927,3289,2135,6351,4032
10985,Saint-Jean-Lherm,31489,31,20,92,12,160,52,224,112
10986,Saint-Jory,31490,31,402,1514,535,1776,1179,3490,1916
10987,Saint-Julia,31491,31,30,80,16,161,68,245,110
10988,Saint-Julien-sur-Garonne,31492,31,29,146,25,127,153,305,175
10989,Saint-Lary-Boujean,31493,31,26,34,4,36,29,69,60
10990,Saint-Laurent,31494,31,34,32,0,44,24,68,66
10991,Saint-Léon,31495,31,56,381,108,336,353,797,437
10992,Sainte-Livrade,31496,31,36,72,16,120,36,172,108
10993,Saint-Loup-Cammas,31497,31,124,565,158,689,396,1243,689
10994,Saint-Loup-en-Comminges,31498,31,12,0,0,12,0,12,12
10995,Saint-Lys,31499,31,832,2437,797,2542,1919,5258,3269
10996,Saint-Mamet,31500,31,95,105,50,225,70,345,200
10997,Saint-Marcel-Paulel,31501,31,55,85,20,155,95,270,140
10998,Saint-Marcet,31502,31,83,65,30,130,50,210,148
10999,Saint-Martory,31503,31,200,176,40,252,184,476,376
11000,Saint-Médard,31504,31,21,35,8,71,38,117,56
11001,Saint-Michel,31505,31,48,40,9,112,41,162,88
11002,Saint-Orens-de-Gameville,31506,31,1607,2450,1006,4244,1917,7167,4057
11003,Saint-Paul-sur-Save,31507,31,68,461,180,328,420,928,529
11004,Saint-Paul-d'Oueil,31508,31,6,6,3,19,6,28,12
11005,Saint-Pé-d'Ardet,31509,31,4,33,8,40,45,93,37
11006,Saint-Pé-Delbosc,31510,31,32,4,8,72,16,96,36
11007,Saint-Pierre,31511,31,44,72,8,104,44,156,116
11008,Saint-Pierre-de-Lages,31512,31,42,277,41,242,157,440,319
11009,Saint-Plancard,31513,31,75,44,8,148,43,199,119
11010,Saint-Rome,31514,31,0,10,5,20,10,35,10
11011,Saint-Rustice,31515,31,50,100,25,190,85,300,150
11012,Saint-Sauveur,31516,31,185,446,140,590,380,1110,631
11013,Saint-Sulpice-sur-Lèze,31517,31,241,546,193,592,501,1286,787
11014,Saint-Thomas,31518,31,44,144,40,180,144,364,188
11015,Saint-Vincent,31519,31,6,47,13,58,36,107,53
11016,Sajas,31520,31,25,13,21,42,16,79,38
11017,Saleich,31521,31,60,105,35,120,40,195,165
11018,Salerm,31522,31,20,0,0,20,4,24,20
11019,Salies-du-Salat,31523,31,343,279,128,581,202,911,622
11020,Salles-et-Pratviel,31524,31,15,20,5,50,35,90,35
11021,Salles-sur-Garonne,31525,31,45,109,69,196,96,361,154
11022,La Salvetat-Saint-Gilles,31526,31,605,2025,707,2336,1747,4790,2630
11023,La Salvetat-Lauragais,31527,31,15,40,15,40,30,85,55
11024,Saman,31528,31,15,25,31,48,21,100,40
11025,Samouillan,31529,31,10,15,25,35,25,85,25
11026,Sana,31530,31,29,40,4,68,25,97,69
11027,Sarrecave,31531,31,16,8,0,36,4,40,24
11028,Sarremezan,31532,31,10,30,10,45,10,65,40
11029,Saubens,31533,31,164,646,133,632,517,1282,810
11030,Saussens,31534,31,16,40,12,92,36,140,56
11031,Sauveterre-de-Comminges,31535,31,131,153,25,197,145,367,284
11032,Saux-et-Pomarède,31536,31,25,70,20,110,65,195,95
11033,Savarthès,31537,31,25,40,10,60,35,105,65
11034,Savères,31538,31,16,48,12,76,52,140,64
11035,Sédeilhac,31539,31,15,5,5,35,5,45,20
11036,Ségreville,31540,31,10,100,25,25,105,155,110
11037,Seilh,31541,31,150,743,474,978,695,2147,893
11038,Seilhan,31542,31,33,35,8,57,29,94,68
11039,Sénarens,31543,31,30,25,0,30,20,50,55
11040,Sengouagnet,31544,31,30,25,5,110,30,145,55
11041,Sepx,31545,31,35,25,20,85,35,140,60
11042,Seyre,31546,31,8,43,4,29,34,67,51
11043,Seysses,31547,31,730,1752,679,2458,1344,4481,2482
11044,Signac,31548,31,13,4,0,12,4,16,17
11045,Sode,31549,31,3,0,0,6,0,6,3
11046,Soueich,31550,31,100,90,20,240,80,340,190
11047,Tarabel,31551,31,26,99,31,146,73,250,125
11048,Terrebasse,31552,31,12,22,6,34,26,66,34
11049,Thil,31553,31,75,378,73,398,253,724,453
11050,Touille,31554,31,70,50,5,80,55,140,120
11051,Toulouse,31555,31,40918,99573,111518,104321,99218,315057,140491
11052,Les Tourreilles,31556,31,85,80,5,165,60,230,165
11053,Tournefeuille,31557,31,2450,7008,2694,8829,5483,17006,9458
11054,Toutens,31558,31,26,96,20,65,82,167,122
11055,Trébons-de-Luchon,31559,31,0,0,0,5,0,5,0
11056,Trébons-sur-la-Grasse,31560,31,12,136,48,180,84,312,148
11057,L'Union,31561,31,2433,2278,900,4145,1724,6769,4711
11058,Urau,31562,31,30,20,15,55,15,85,50
11059,Vacquiers,31563,31,100,380,80,416,356,852,480
11060,Valcabrère,31564,31,35,20,5,50,35,90,55
11061,Valentine,31565,31,198,165,80,285,155,520,363
11062,Vallègue,31566,31,45,169,20,159,125,304,214
11063,Vallesvilles,31567,31,45,107,15,144,109,268,152
11064,Varennes,31568,31,16,63,0,96,57,153,79
11065,Vaudreuille,31569,31,35,100,35,110,90,235,135
11066,Vaux,31570,31,22,55,10,84,49,143,77
11067,Vendine,31571,31,12,85,12,56,96,164,97
11068,Venerque,31572,31,304,640,151,921,485,1557,944
11069,Verfeil,31573,31,315,893,321,1147,725,2193,1208
11070,Vernet,31574,31,253,684,202,800,527,1529,937
11071,Vieille-Toulouse,31575,31,136,312,68,488,136,692,448
11072,Vieillevigne,31576,31,8,100,24,76,84,184,108
11073,Vignaux,31577,31,28,20,0,40,28,68,48
11074,Vigoulet-Auzil,31578,31,168,169,65,390,99,554,337
11075,Villariès,31579,31,52,236,44,264,224,532,288
11076,Villate,31580,31,52,256,76,279,206,561,308
11077,Villaudric,31581,31,147,403,106,428,315,849,550
11078,Villefranche-de-Lauragais,31582,31,660,1080,392,1232,819,2443,1740
11079,Villematier,31583,31,130,230,80,433,164,677,360
11080,Villemur-sur-Tarn,31584,31,870,1300,527,1744,1182,3453,2170
11081,Villeneuve-de-Rivière,31585,31,314,347,125,676,223,1024,661
11082,Villeneuve-Lécussan,31586,31,85,138,25,214,99,338,223
11083,Villeneuve-lès-Bouloc,31587,31,112,456,64,307,436,807,568
11084,Villeneuve-Tolosane,31588,31,1204,2164,837,2925,1727,5489,3368
11085,Villenouvelle,31589,31,148,408,88,360,364,812,556
11086,Binos,31590,31,8,16,0,12,8,20,24
11087,Escoulis,31591,31,40,15,10,20,10,40,55
11088,Larra,31592,31,103,537,93,417,475,985,640
11089,Cazac,31593,31,12,4,4,60,4,68,16
11090,Aignan,32001,32,200,125,40,295,80,415,325
11091,Ansan,32002,32,14,15,5,40,10,55,29
11092,Antras,32003,32,0,5,0,35,0,35,5
11093,Arblade-le-Bas,32004,32,38,55,0,35,35,70,93
11094,Arblade-le-Haut,32005,32,45,48,6,105,39,150,93
11095,Ardizas,32007,32,29,45,6,32,45,83,74
11096,Armentieux,32008,32,15,10,10,35,5,50,25
11097,Armous-et-Cau,32009,32,10,30,10,35,20,65,40
11098,Arrouède,32010,32,16,26,8,29,17,54,42
11099,Aubiet,32012,32,165,230,80,365,245,690,395
11100,Auch,32013,32,3561,4202,2528,7101,3332,12961,7763
11101,Augnax,32014,32,12,32,4,28,24,56,44
11102,Aujan-Mournède,32015,32,18,18,12,19,3,34,36
11103,Auradé,32016,32,65,180,75,268,84,427,245
11104,Aurensan,32017,32,9,23,6,45,19,70,32
11105,Aurimont,32018,32,25,55,0,55,65,120,80
11106,Auterive,32019,32,90,80,40,245,70,355,170
11107,Aux-Aussat,32020,32,72,60,4,84,52,140,132
11108,Avensac,32021,32,5,25,0,15,40,55,30
11109,Avéron-Bergelle,32022,32,60,10,20,50,10,80,70
11110,Avezan,32023,32,9,16,12,27,3,42,25
11111,Ayguetinte,32024,32,50,30,5,55,10,70,80
11112,Ayzieu,32025,32,28,26,20,54,16,90,54
11113,Bajonnette,32026,32,32,16,8,44,8,60,48
11114,Barcelonne-du-Gers,32027,32,276,260,128,500,188,816,536
11115,Barcugnan,32028,32,40,20,10,45,5,60,60
11116,Barran,32029,32,136,115,36,200,92,328,251
11117,Bars,32030,32,14,10,25,74,20,119,24
11118,Bascous,32031,32,32,32,12,56,36,104,64
11119,Bassoues,32032,32,110,43,4,85,41,130,153
11120,Bazian,32033,32,16,36,0,36,28,64,52
11121,Bazugues,32034,32,25,5,0,15,10,25,30
11122,Beaucaire,32035,32,68,60,4,88,56,148,128
11123,Beaumarchés,32036,32,68,155,44,195,114,353,223
11124,Beaumont,32037,32,5,35,5,65,20,90,40
11125,Beaupuy,32038,32,24,40,5,70,40,115,64
11126,Beccas,32039,32,16,21,4,12,32,48,37
11127,Bédéchan,32040,32,20,25,15,45,50,110,45
11128,Bellegarde,32041,32,38,30,0,62,33,95,68
11129,Belloc-Saint-Clamens,32042,32,36,0,3,58,0,61,36
11130,Belmont,32043,32,44,28,8,64,16,88,72
11131,Béraut,32044,32,60,84,36,140,36,212,144
11132,Berdoues,32045,32,60,116,36,204,60,300,176
11133,Bernède,32046,32,50,60,0,55,55,110,110
11134,Berrac,32047,32,5,15,0,45,25,70,20
11135,Betcave-Aguin,32048,32,10,5,20,55,0,75,15
11136,Bétous,32049,32,15,25,15,25,15,55,40
11137,Betplan,32050,32,25,9,6,18,19,43,34
11138,Bézéril,32051,32,8,31,4,41,17,62,39
11139,Bezolles,32052,32,32,32,4,56,16,76,64
11140,Bézues-Bajon,32053,32,45,45,15,60,40,115,90
11141,Biran,32054,32,68,80,12,140,88,240,148
11142,Bivès,32055,32,9,34,0,37,21,58,43
11143,Blanquefort,32056,32,0,12,12,12,0,24,12
11144,Blaziert,32057,32,20,20,0,50,25,75,40
11145,Blousson-Sérian,32058,32,10,5,5,20,10,35,15
11146,Bonas,32059,32,23,9,3,53,13,69,32
11147,Boucagnères,32060,32,20,40,8,28,60,96,60
11148,Boulaur,32061,32,12,40,8,36,36,80,52
11149,Bourrouillan,32062,32,36,16,24,72,0,96,52
11150,Bouzon-Gellenave,32063,32,40,45,5,65,30,100,85
11151,Bretagne-d'Armagnac,32064,32,72,88,32,160,80,272,160
11152,Le Brouilh-Monbert,32065,32,8,33,12,96,37,145,41
11153,Brugnens,32066,32,30,65,15,110,40,165,95
11154,Cabas-Loumassès,32067,32,0,20,0,20,20,40,20
11155,Cadeilhan,32068,32,19,28,6,42,9,57,47
11156,Cadeillan,32069,32,6,7,0,22,9,31,13
11157,Cahuzac-sur-Adour,32070,32,40,65,20,78,30,128,105
11158,Caillavet,32071,32,20,80,5,80,45,130,100
11159,Callian,32072,32,9,3,0,9,9,18,12
11160,Campagne-d'Armagnac,32073,32,50,35,15,60,45,120,85
11161,Cannet,32074,32,0,15,0,35,10,45,15
11162,Cassaigne,32075,32,35,45,10,110,25,145,80
11163,Castelnau-Barbarens,32076,32,48,71,36,233,51,320,119
11164,Castelnau-d'Anglès,32077,32,40,16,0,36,12,48,56
11165,Castelnau-d'Arbieu,32078,32,40,45,15,95,29,139,85
11166,Castelnau d'Auzan Labarrère,32079,32,270,205,70,440,250,760,475
11167,Castelnau-sur-l'Auvignon,32080,32,31,15,10,68,15,93,46
11168,Castelnavet,32081,32,3,13,6,61,19,86,16
11169,Castéra-Lectourois,32082,32,40,68,4,157,44,205,108
11170,Castéra-Verduzan,32083,32,175,200,60,350,130,540,375
11171,Castéron,32084,32,15,15,0,15,15,30,30
11172,Castet-Arrouy,32085,32,0,45,15,85,30,130,45
11173,Castex,32086,32,40,25,5,25,5,35,65
11174,Castex-d'Armagnac,32087,32,8,24,16,40,16,72,32
11175,Castillon-Debats,32088,32,80,60,12,112,48,172,140
11176,Castillon-Massas,32089,32,75,65,10,50,50,110,140
11177,Castillon-Savès,32090,32,13,85,16,97,69,182,98
11178,Castin,32091,32,40,80,32,120,40,192,120
11179,Catonvielle,32092,32,15,31,5,45,15,65,46
11180,Caumont,32093,32,18,14,6,50,7,63,32
11181,Caupenne-d'Armagnac,32094,32,69,74,28,161,43,232,143
11182,Caussens,32095,32,117,90,33,221,85,339,207
11183,Cazaubon,32096,32,290,265,150,662,245,1057,555
11184,Cazaux-d'Anglès,32097,32,10,30,20,65,0,85,40
11185,Cazaux-Savès,32098,32,36,112,20,68,72,160,148
11186,Cazaux-Villecomtal,32099,32,20,5,5,25,5,35,25
11187,Cazeneuve,32100,32,15,25,5,69,15,89,40
11188,Céran,32101,32,16,44,12,52,66,130,60
11189,Cézan,32102,32,12,33,8,107,25,140,45
11190,Chélan,32103,32,35,35,5,95,15,115,70
11191,Clermont-Pouyguillès,32104,32,19,35,10,75,25,110,54
11192,Clermont-Savès,32105,32,20,76,8,88,64,160,96
11193,Cologne,32106,32,75,224,55,223,223,501,299
11194,Condom,32107,32,1550,1195,495,2298,904,3697,2745
11195,Corneillan,32108,32,22,27,0,34,28,62,49
11196,Couloumé-Mondebat,32109,32,43,32,12,48,32,92,75
11197,Courrensan,32110,32,96,63,20,117,55,192,159
11198,Courties,32111,32,8,0,0,29,0,29,8
11199,Crastes,32112,32,44,48,20,58,33,111,92
11200,Cravencères,32113,32,5,5,10,45,15,70,10
11201,Cuélas,32114,32,16,12,8,38,24,70,28
11202,Dému,32115,32,65,45,0,170,55,225,110
11203,Duffort,32116,32,24,36,12,48,16,76,60
11204,Duran,32117,32,110,205,35,325,145,505,315
11205,Durban,32118,32,20,30,5,70,25,100,50
11206,Eauze,32119,32,860,628,281,1380,499,2160,1488
11207,Encausse,32120,32,26,109,48,105,89,242,135
11208,Endoufielle,32121,32,55,125,25,205,105,335,180
11209,Esclassan-Labastide,32122,32,50,85,35,100,80,215,135
11210,Escorneboeuf,32123,32,77,97,12,191,118,321,174
11211,Espaon,32124,32,32,32,9,37,30,76,64
11212,Espas,32125,32,40,20,4,32,28,64,60
11213,Estampes,32126,32,30,20,5,85,15,105,50
11214,Estang,32127,32,175,100,30,220,100,350,275
11215,Estipouy,32128,32,36,31,3,71,16,90,67
11216,Estramiac,32129,32,37,12,0,50,12,62,49
11217,Faget-Abbatial,32130,32,10,25,15,123,45,183,35
11218,Flamarens,32131,32,40,12,8,62,12,82,52
11219,Fleurance,32132,32,1336,1252,471,2007,960,3438,2588
11220,Fourcès,32133,32,55,50,5,115,50,170,105
11221,Frégouville,32134,32,24,108,28,80,108,216,132
11222,Fustérouau,32135,32,13,19,6,45,15,66,32
11223,Galiax,32136,32,35,5,15,75,20,110,40
11224,Garravet,32138,32,29,29,16,32,17,65,58
11225,Gaudonville,32139,32,20,20,10,35,20,65,40
11226,Gaujac,32140,32,20,20,0,16,16,32,40
11227,Gaujan,32141,32,8,8,0,42,25,67,16
11228,Gavarret-sur-Aulouste,32142,32,35,25,10,50,15,75,60
11229,Gazaupouy,32143,32,60,75,20,95,55,170,135
11230,Gazax-et-Baccarisse,32144,32,20,5,15,25,5,45,25
11231,Gée-Rivière,32145,32,5,15,0,15,15,30,20
11232,Gimbrède,32146,32,50,72,12,81,55,148,122
11233,Gimont,32147,32,465,584,211,891,512,1614,1049
11234,Giscaro,32148,32,4,28,0,28,24,52,32
11235,Gondrin,32149,32,196,200,120,456,136,712,396
11236,Goutz,32150,32,19,38,9,42,40,91,57
11237,Goux,32151,32,20,20,0,16,12,28,40
11238,Haget,32152,32,20,52,20,149,76,245,72
11239,Haulies,32153,32,15,55,0,35,40,75,70
11240,Homps,32154,32,20,20,10,40,15,65,40
11241,Le Houga,32155,32,222,238,112,377,184,673,460
11242,Idrac-Respaillès,32156,32,31,43,8,90,12,110,74
11243,L'Isle-Arné,32157,32,20,40,16,32,48,96,60
11244,L'Isle-Bouzon,32158,32,25,52,0,83,45,128,77
11245,L'Isle-de-Noé,32159,32,88,108,48,196,96,340,196
11246,L'Isle-Jourdain,32160,32,984,2138,1006,2385,1748,5139,3122
11247,Izotges,32161,32,15,24,0,39,15,54,39
11248,Jegun,32162,32,115,305,65,465,190,720,420
11249,Jû-Belloc,32163,32,40,60,20,125,65,210,100
11250,Juillac,32164,32,20,30,5,40,30,75,50
11251,Juilles,32165,32,25,45,0,110,30,140,70
11252,Justian,32166,32,18,22,4,24,25,53,40
11253,Laas,32167,32,35,65,25,115,75,215,100
11254,Labarthe,32169,32,25,45,15,50,35,100,70
11255,Labarthète,32170,32,30,20,5,40,35,80,50
11256,Labastide-Savès,32171,32,35,20,5,65,20,90,55
11257,Labéjan,32172,32,40,84,60,116,52,228,124
11258,Labrihe,32173,32,21,46,4,69,24,97,67
11259,Ladevèze-Rivière,32174,32,25,30,5,130,25,160,55
11260,Ladevèze-Ville,32175,32,24,48,16,72,24,112,72
11261,Lagarde,32176,32,25,16,0,30,23,53,41
11262,Lagarde-Hachan,32177,32,10,40,15,50,30,95,50
11263,Lagardère,32178,32,15,40,10,25,15,50,55
11264,Lagraulet-du-Gers,32180,32,66,118,29,166,87,282,184
11265,Laguian-Mazous,32181,32,50,50,5,120,35,160,100
11266,Lahas,32182,32,22,35,12,57,21,90,57
11267,Lahitte,32183,32,16,60,32,96,48,176,76
11268,Lalanne,32184,32,12,36,16,68,8,92,48
11269,Lalanne-Arqué,32185,32,24,40,12,48,20,80,64
11270,Lamaguère,32186,32,4,24,8,36,16,60,28
11271,Lamazère,32187,32,15,35,5,50,15,70,50
11272,Lamothe-Goas,32188,32,10,15,0,15,25,40,25
11273,Lannemaignan,32189,32,10,25,15,30,25,70,35
11274,Lannepax,32190,32,70,70,45,225,100,370,140
11275,Lanne-Soubiran,32191,32,25,35,0,35,35,70,60
11276,Lannux,32192,32,17,50,16,93,38,147,67
11277,Larée,32193,32,37,42,9,93,9,111,79
11278,Larressingle,32194,32,50,45,5,80,35,120,95
11279,Larroque-Engalin,32195,32,20,0,0,20,0,20,20
11280,Larroque-Saint-Sernin,32196,32,25,40,15,70,40,125,65
11281,Larroque-sur-l'Osse,32197,32,44,50,20,114,20,154,94
11282,Lartigue,32198,32,4,40,8,69,33,110,44
11283,Lasserade,32199,32,39,53,3,68,22,93,92
11284,Lasséran,32200,32,35,95,30,119,85,234,130
11285,Lasseube-Propre,32201,32,65,55,15,115,65,195,120
11286,Laujuzan,32202,32,60,60,16,96,24,136,120
11287,Lauraët,32203,32,40,56,32,80,36,148,96
11288,Lavardens,32204,32,75,70,20,159,65,244,145
11289,Laveraët,32205,32,15,25,5,54,20,79,40
11290,Laymont,32206,32,50,43,21,50,25,96,93
11291,Leboulin,32207,32,44,110,32,124,48,204,154
11292,Lectoure,32208,32,638,708,195,1291,547,2033,1346
11293,Lelin-Lapujolle,32209,32,4,58,16,117,40,173,62
11294,Lias,32210,32,32,156,25,162,142,329,188
11295,Lias-d'Armagnac,32211,32,30,40,10,90,25,125,70
11296,Ligardes,32212,32,26,33,8,81,32,121,59
11297,Lombez,32213,32,396,412,200,556,364,1120,808
11298,Loubédat,32214,32,36,16,0,40,12,52,52
11299,Loubersan,32215,32,30,25,15,65,15,95,55
11300,Lourties-Monbrun,32216,32,12,20,8,48,24,80,32
11301,Louslitges,32217,32,9,9,9,24,13,46,18
11302,Loussous-Débat,32218,32,8,13,0,16,4,20,21
11303,Lupiac,32219,32,100,45,20,80,40,140,145
11304,Luppé-Violles,32220,32,35,25,5,65,15,85,60
11305,Lussan,32221,32,23,45,0,80,44,124,68
11306,Magnan,32222,32,65,35,30,85,30,145,100
11307,Magnas,32223,32,8,20,0,16,12,28,28
11308,Maignaut-Tauzia,32224,32,25,60,35,90,50,175,85
11309,Malabat,32225,32,15,30,5,50,25,80,45
11310,Manas-Bastanous,32226,32,20,15,0,34,10,44,35
11311,Manciet,32227,32,170,185,50,255,145,450,355
11312,Manent-Montané,32228,32,12,16,16,16,28,60,28
11313,Mansempuy,32229,32,8,25,4,32,12,48,33
11314,Mansencôme,32230,32,9,3,6,21,0,27,12
11315,Marambat,32231,32,60,96,28,180,72,280,156
11316,Maravat,32232,32,4,12,0,16,16,32,16
11317,Marciac,32233,32,316,156,84,412,192,688,472
11318,Marestaing,32234,32,25,85,20,70,80,170,110
11319,Margouët-Meymes,32235,32,36,40,20,72,20,112,76
11320,Marguestau,32236,32,4,13,0,31,16,47,17
11321,Marsan,32237,32,55,116,12,155,84,251,171
11322,Marseillan,32238,32,12,32,0,48,16,64,44
11323,Marsolan,32239,32,47,90,24,183,78,285,137
11324,Mascaras,32240,32,23,6,0,6,9,15,29
11325,Mas-d'Auvignon,32241,32,45,15,15,75,15,105,60
11326,Masseube,32242,32,300,230,189,494,185,868,530
11327,Mauléon-d'Armagnac,32243,32,35,50,25,130,45,200,85
11328,Maulichères,32244,32,45,40,20,60,15,95,85
11329,Maumusson-Laguian,32245,32,22,20,0,55,15,70,42
11330,Maupas,32246,32,55,30,5,65,10,80,85
11331,Maurens,32247,32,28,73,12,134,35,181,101
11332,Mauroux,32248,32,24,20,10,50,20,80,44
11333,Mauvezin,32249,32,353,420,149,620,331,1100,773
11334,Meilhan,32250,32,20,10,5,30,15,50,30
11335,Mérens,32251,32,0,20,0,30,10,40,20
11336,Miélan,32252,32,309,209,55,455,145,655,518
11337,Miradoux,32253,32,130,100,20,185,60,265,230
11338,Miramont-d'Astarac,32254,32,50,70,45,150,30,225,120
11339,Miramont-Latour,32255,32,12,35,4,37,42,83,47
11340,Mirande,32256,32,718,601,310,1199,441,1950,1319
11341,Mirannes,32257,32,16,17,10,18,6,34,33
11342,Mirepoix,32258,32,30,45,10,65,60,135,75
11343,Monbardon,32260,32,15,30,0,30,25,55,45
11344,Monblanc,32261,32,75,85,15,145,30,190,160
11345,Monbrun,32262,32,24,124,24,120,80,224,148
11346,Moncassin,32263,32,35,25,15,60,15,90,60
11347,Monclar,32264,32,30,45,0,85,40,125,75
11348,Monclar-sur-Losse,32265,32,5,20,10,65,15,90,25
11349,Moncorneil-Grazan,32266,32,28,24,4,64,32,100,52
11350,Monferran-Plavès,32267,32,25,15,5,55,5,65,40
11351,Monferran-Savès,32268,32,92,163,52,218,130,400,255
11352,Monfort,32269,32,65,94,16,140,100,256,159
11353,Mongausy,32270,32,5,10,10,15,30,55,15
11354,Monguilhem,32271,32,60,55,20,85,55,160,115
11355,Monlaur-Bernet,32272,32,55,25,0,50,20,70,80
11356,Monlezun,32273,32,30,45,15,90,15,120,75
11357,Monlezun-d'Armagnac,32274,32,41,16,8,72,16,96,57
11358,Monpardiac,32275,32,6,24,0,12,10,22,30
11359,Montadet,32276,32,12,16,0,28,16,44,28
11360,Montamat,32277,32,17,30,0,44,16,60,47
11361,Montaut,32278,32,21,8,12,32,12,56,29
11362,Montaut-les-Créneaux,32279,32,100,170,15,260,165,440,270
11363,Mont-d'Astarac,32280,32,35,10,0,45,20,65,45
11364,Mont-de-Marrast,32281,32,16,36,0,41,16,57,52
11365,Montégut,32282,32,47,176,21,133,159,313,223
11366,Montégut-Arros,32283,32,35,45,25,130,69,224,80
11367,Montégut-Savès,32284,32,25,25,0,15,15,30,50
11368,Montesquiou,32285,32,134,95,16,202,79,297,229
11369,Montestruc-sur-Gers,32286,32,135,170,40,255,120,415,305
11370,Monties,32287,32,12,12,0,18,9,27,24
11371,Montiron,32288,32,17,17,4,41,28,73,34
11372,Montpézat,32289,32,25,48,17,69,50,136,73
11373,Montréal,32290,32,282,174,64,360,152,576,456
11374,Mormès,32291,32,45,15,10,30,20,60,60
11375,Mouchan,32292,32,30,110,30,204,55,289,140
11376,Mouchès,32293,32,6,18,3,24,6,33,24
11377,Mourède,32294,32,25,0,15,45,5,65,25
11378,Nizas,32295,32,15,45,10,55,25,90,60
11379,Nogaro,32296,32,329,339,191,669,204,1064,668
11380,Noilhan,32297,32,84,80,44,80,88,212,164
11381,Nougaroulet,32298,32,59,73,8,117,62,187,132
11382,Noulens,32299,32,20,20,0,40,20,60,40
11383,Orbessan,32300,32,20,64,26,103,22,151,84
11384,Ordan-Larroque,32301,32,75,215,70,365,145,580,290
11385,Ornézan,32302,32,40,40,20,95,25,140,80
11386,Pallanne,32303,32,20,0,5,25,0,30,20
11387,Panassac,32304,32,50,70,5,100,50,155,120
11388,Panjas,32305,32,68,61,22,159,34,215,129
11389,Pauilhac,32306,32,68,176,32,196,132,360,244
11390,Pavie,32307,32,325,521,203,1040,329,1572,846
11391,Pébées,32308,32,3,23,18,15,29,62,26
11392,Pellefigue,32309,32,15,23,6,27,23,56,38
11393,Perchède,32310,32,12,21,0,33,25,58,33
11394,Pergain-Taillac,32311,32,75,50,25,130,20,175,125
11395,Pessan,32312,32,44,153,24,273,107,404,197
11396,Pessoulens,32313,32,40,30,15,25,35,75,70
11397,Peyrecave,32314,32,15,10,0,35,10,45,25
11398,Peyrusse-Grande,32315,32,48,4,4,79,8,91,52
11399,Peyrusse-Massas,32316,32,24,24,8,36,16,60,48
11400,Peyrusse-Vieille,32317,32,4,20,4,40,16,60,24
11401,Pis,32318,32,32,17,4,21,8,33,49
11402,Plaisance,32319,32,372,264,88,514,152,754,636
11403,Plieux,32320,32,5,20,0,100,10,110,25
11404,Polastron,32321,32,22,64,6,86,38,130,86
11405,Pompiac,32322,32,28,44,8,48,52,108,72
11406,Ponsampère,32323,32,10,40,0,55,29,84,50
11407,Ponsan-Soubiran,32324,32,25,15,5,43,10,58,40
11408,Pouydraguin,32325,32,44,30,3,36,20,59,74
11409,Pouylebon,32326,32,30,10,0,91,15,106,40
11410,Pouy-Loubrin,32327,32,25,15,0,35,15,50,40
11411,Pouy-Roquelaure,32328,32,32,15,0,56,12,68,47
11412,Préchac,32329,32,44,48,4,60,32,96,92
11413,Préchac-sur-Adour,32330,32,33,34,12,78,16,106,67
11414,Preignan,32331,32,120,336,114,399,248,761,456
11415,Préneron,32332,32,30,25,5,40,40,85,55
11416,Projan,32333,32,12,40,16,77,20,113,52
11417,Pujaudran,32334,32,150,390,80,518,275,873,540
11418,Puycasquier,32335,32,100,108,64,144,60,268,208
11419,Puylausic,32336,32,30,20,5,90,25,120,50
11420,Puységur,32337,32,10,5,15,30,5,50,15
11421,Ramouzens,32338,32,12,17,20,65,28,113,29
11422,Razengues,32339,32,5,70,20,35,95,150,75
11423,Réans,32340,32,51,44,12,113,20,145,95
11424,Réjaumont,32341,32,30,54,8,61,45,114,84
11425,Ricourt,32342,32,0,25,30,25,5,60,25
11426,Riguepeu,32343,32,60,40,5,70,35,110,100
11427,Riscle,32344,32,468,256,116,520,204,840,724
11428,La Romieu,32345,32,94,68,32,262,48,342,162
11429,Roquebrune,32346,32,29,29,4,67,37,108,58
11430,Roquefort,32347,32,36,68,12,85,55,152,104
11431,Roquelaure,32348,32,40,135,60,280,70,410,175
11432,Roquelaure-Saint-Aubin,32349,32,5,35,5,50,20,75,40
11433,Roquepine,32350,32,3,9,0,21,3,24,12
11434,Roques,32351,32,13,12,0,49,9,58,25
11435,Rozès,32352,32,25,35,0,45,25,70,60
11436,Sabaillan,32353,32,30,20,5,75,15,95,50
11437,Sabazan,32354,32,12,25,12,57,20,89,37
11438,Sadeillan,32355,32,12,8,0,43,4,47,20
11439,Saint-André,32356,32,24,16,8,52,8,68,40
11440,Sainte-Anne,32357,32,5,35,5,70,0,75,40
11441,Saint-Antoine,32358,32,48,52,8,44,56,108,100
11442,Saint-Antonin,32359,32,24,20,8,80,8,96,44
11443,Saint-Arailles,32360,32,25,20,10,75,20,105,45
11444,Saint-Arroman,32361,32,5,15,25,55,20,100,20
11445,Saint-Aunix-Lengros,32362,32,23,22,3,40,27,70,45
11446,Sainte-Aurence-Cazaux,32363,32,30,25,5,20,20,45,55
11447,Saint-Avit-Frandat,32364,32,12,24,0,28,16,44,36
11448,Saint-Blancard,32365,32,13,61,6,68,47,121,74
11449,Saint-Brès,32366,32,15,15,0,35,10,45,30
11450,Saint-Christaud,32367,32,12,9,3,25,3,31,21
11451,Sainte-Christie,32368,32,60,136,68,184,124,376,196
11452,Sainte-Christie-d'Armagnac,32369,32,68,76,28,144,60,232,144
11453,Saint-Clar,32370,32,155,175,70,335,145,550,330
11454,Saint-Créac,32371,32,25,5,10,31,10,51,30
11455,Saint-Cricq,32372,32,16,88,20,94,78,192,104
11456,Sainte-Dode,32373,32,70,25,10,85,25,120,95
11457,Saint-Élix,32374,32,16,60,16,56,44,116,76
11458,Saint-Élix-Theux,32375,32,20,25,5,40,25,70,45
11459,Sainte-Gemme,32376,32,28,28,4,40,20,64,56
11460,Saint-Georges,32377,32,24,38,16,55,20,91,62
11461,Saint-Germé,32378,32,88,60,24,156,48,228,148
11462,Saint-Germier,32379,32,5,55,20,125,15,160,60
11463,Saint-Griède,32380,32,15,50,0,53,30,83,65
11464,Saint-Jean-le-Comtal,32381,32,53,97,26,151,54,231,150
11465,Saint-Jean-Poutge,32382,32,60,63,35,94,64,193,123
11466,Saint-Justin,32383,32,19,15,3,46,17,66,34
11467,Saint-Lary,32384,32,36,84,16,80,64,160,120
11468,Saint-Léonard,32385,32,16,32,24,60,40,124,48
11469,Saint-Lizier-du-Planté,32386,32,20,40,0,50,25,75,60
11470,Saint-Loube,32387,32,24,16,0,36,12,48,40
11471,Sainte-Marie,32388,32,46,131,4,146,77,227,177
11472,Saint-Martin,32389,32,84,88,24,200,52,276,172
11473,Saint-Martin-d'Armagnac,32390,32,4,57,8,108,32,148,61
11474,Saint-Martin-de-Goyne,32391,32,16,28,4,40,36,80,44
11475,Saint-Martin-Gimois,32392,32,30,12,0,16,16,32,42
11476,Saint-Maur,32393,32,16,32,16,48,24,88,48
11477,Saint-Médard,32394,32,56,44,16,109,62,187,100
11478,Sainte-Mère,32395,32,10,65,5,55,90,150,75
11479,Saint-Mézard,32396,32,65,50,10,57,25,92,115
11480,Saint-Michel,32397,32,65,50,10,115,30,155,115
11481,Saint-Mont,32398,32,36,49,18,113,34,165,85
11482,Saint-Orens,32399,32,0,20,5,25,20,50,20
11483,Saint-Orens-Pouy-Petit,32400,32,28,24,8,84,12,104,52
11484,Saint-Ost,32401,32,12,0,3,44,0,47,12
11485,Saint-Paul-de-Baïse,32402,32,20,0,6,45,0,51,20
11486,Saint-Pierre-d'Aubézies,32403,32,16,8,4,44,4,52,24
11487,Saint-Puy,32404,32,132,120,24,212,84,320,252
11488,Sainte-Radegonde,32405,32,50,45,0,65,30,95,95
11489,Saint-Sauvy,32406,32,44,100,25,105,80,210,144
11490,Saint-Soulan,32407,32,52,32,4,56,32,92,84
11491,Salles-d'Armagnac,32408,32,0,30,9,34,22,65,30
11492,Samaran,32409,32,25,13,0,35,0,35,38
11493,Samatan,32410,32,455,406,133,854,332,1319,861
11494,Sansan,32411,32,20,20,0,40,12,52,40
11495,Saramon,32412,32,141,145,74,217,144,435,286
11496,Sarcos,32413,32,20,18,5,46,1,52,38
11497,Sarragachies,32414,32,72,44,24,72,40,136,116
11498,Sarraguzan,32415,32,15,15,0,29,20,49,30
11499,Sarrant,32416,32,55,70,30,145,70,245,125
11500,La Sauvetat,32417,32,100,65,10,125,40,175,165
11501,Sauveterre,32418,32,29,65,16,66,39,121,94
11502,Sauviac,32419,32,40,12,0,48,8,56,52
11503,Sauvimont,32420,32,0,6,3,27,6,36,6
11504,Savignac-Mona,32421,32,7,32,0,59,22,81,39
11505,Scieurac-et-Flourès,32422,32,10,0,0,25,10,35,10
11506,Séailles,32423,32,15,0,0,25,5,30,15
11507,Ségos,32424,32,44,36,12,132,24,168,80
11508,Ségoufielle,32425,32,56,320,108,248,273,629,376
11509,Seissan,32426,32,204,175,105,352,151,608,379
11510,Sembouès,32427,32,8,4,4,32,4,40,12
11511,Sémézies-Cachan,32428,32,5,40,0,25,20,45,45
11512,Sempesserre,32429,32,62,50,10,128,19,157,112
11513,Sère,32430,32,15,5,0,50,5,55,20
11514,Sérempuy,32431,32,0,10,0,10,15,25,10
11515,Seysses-Savès,32432,32,16,46,14,65,65,144,62
11516,Simorre,32433,32,154,93,18,213,90,321,247
11517,Sion,32434,32,10,15,0,40,30,70,25
11518,Sirac,32435,32,20,35,10,60,35,105,55
11519,Solomiac,32436,32,96,96,15,127,137,279,192
11520,Sorbets,32437,32,40,34,0,72,38,110,74
11521,Tachoires,32438,32,24,16,12,28,16,56,40
11522,Tarsac,32439,32,50,40,15,45,30,90,90
11523,Tasque,32440,32,40,65,15,100,35,150,105
11524,Taybosc,32441,32,4,20,4,24,20,48,24
11525,Terraube,32442,32,32,88,32,148,92,272,120
11526,Termes-d'Armagnac,32443,32,24,36,4,72,28,104,60
11527,Thoux,32444,32,20,70,25,65,50,140,90
11528,Tieste-Uragnoux,32445,32,35,40,15,50,35,100,75
11529,Tillac,32446,32,48,61,12,97,44,153,109
11530,Tirent-Pontéjac,32447,32,9,14,3,28,9,40,23
11531,Touget,32448,32,52,132,24,196,120,340,184
11532,Toujouse,32449,32,15,45,30,100,30,160,60
11533,Tourdun,32450,32,8,16,8,56,12,76,24
11534,Tournan,32451,32,15,41,5,105,15,125,56
11535,Tournecoupe,32452,32,54,43,10,97,22,129,97
11536,Tourrenquets,32453,32,17,20,3,44,9,56,37
11537,Traversères,32454,32,25,25,0,30,10,40,50
11538,Troncens,32455,32,40,40,10,75,10,95,80
11539,Tudelle,32456,32,5,5,10,15,15,40,10
11540,Urdens,32457,32,20,71,8,87,53,148,91
11541,Urgosse,32458,32,69,29,15,85,43,143,98
11542,Valence-sur-Baïse,32459,32,252,212,96,404,164,664,464
11543,Vergoignan,32460,32,55,54,24,69,51,144,109
11544,Verlus,32461,32,3,9,6,39,6,51,12
11545,Vic-Fezensac,32462,32,762,560,300,1236,450,1986,1322
11546,Viella,32463,32,120,96,8,240,64,312,216
11547,Villecomtal-sur-Arros,32464,32,148,180,80,284,124,488,328
11548,Villefranche,32465,32,36,18,0,66,36,102,54
11549,Viozan,32466,32,35,0,13,32,12,57,35
11550,Saint-Caprais,32467,32,16,34,9,35,30,74,50
11551,Aussos,32468,32,16,12,4,16,16,36,28
11552,Abzac,33001,33,252,480,184,572,404,1160,732
11553,Aillas,33002,33,156,176,20,268,176,464,332
11554,Ambarès-et-Lagrave,33003,33,1339,4252,1588,4343,3329,9260,5591
11555,Ambès,33004,33,290,800,505,857,601,1963,1090
11556,Andernos-les-Bains,33005,33,2832,2067,553,4692,1475,6720,4899
11557,Anglade,33006,33,104,280,100,284,180,564,384
11558,Arbanats,33007,33,136,320,112,284,268,664,456
11559,Arbis,33008,33,30,75,15,100,50,165,105
11560,Arcachon,33009,33,3606,1168,522,3689,942,5153,4774
11561,Arcins,33010,33,26,132,41,97,138,276,158
11562,Arès,33011,33,1323,961,383,2245,799,3427,2284
11563,Arsac,33012,33,193,896,240,1151,769,2160,1089
11564,Artigues-près-Bordeaux,33013,33,614,1992,905,2887,1581,5373,2606
11565,Les Artigues-de-Lussac,33014,33,68,276,108,376,268,752,344
11566,Arveyres,33015,33,304,471,94,592,368,1054,775
11567,Asques,33016,33,69,113,25,142,77,244,182
11568,Aubiac,33017,33,32,68,12,120,52,184,100
11569,Val de Virvée,33018,33,339,947,256,916,835,2007,1286
11570,Audenge,33019,33,883,1690,608,2387,1414,4409,2573
11571,Auriolles,33020,33,8,33,0,49,29,78,41
11572,Auros,33021,33,133,252,74,305,153,532,385
11573,Avensan,33022,33,129,812,233,822,751,1806,941
11574,Ayguemorte-les-Graves,33023,33,54,305,75,415,304,794,359
11575,Bagas,33024,33,30,85,30,100,45,175,115
11576,Baigneaux,33025,33,43,92,48,82,87,217,135
11577,Balizac,33026,33,40,135,38,162,70,270,175
11578,Barie,33027,33,45,80,25,80,60,165,125
11579,Baron,33028,33,60,346,70,345,249,664,406
11580,Le Barp,33029,33,367,1518,589,1587,1217,3393,1885
11581,Barsac,33030,33,253,460,171,603,470,1244,713
11582,Bassanne,33031,33,8,8,20,28,24,72,16
11583,Bassens,33032,33,851,1690,751,2098,1360,4209,2541
11584,Baurech,33033,33,80,220,44,280,196,520,300
11585,Bayas,33034,33,64,92,28,180,68,276,156
11586,Bayon-sur-Gironde,33035,33,135,140,70,205,140,415,275
11587,Bazas,33036,33,801,990,344,1527,773,2644,1791
11588,Beautiran,33037,33,220,534,125,743,442,1310,754
11589,Bégadan,33038,33,152,168,96,324,172,592,320
11590,Bègles,33039,33,3134,6105,3479,7759,5459,16697,9239
11591,Béguey,33040,33,176,296,136,292,220,648,472
11592,Belin-Béliet,33042,33,471,1448,462,1328,1221,3011,1919
11593,Bellebat,33043,33,28,88,12,52,60,124,116
11594,Bellefond,33044,33,15,45,30,95,30,155,60
11595,Belvès-de-Castillon,33045,33,35,60,45,120,60,225,95
11596,Bernos-Beaulac,33046,33,185,255,95,420,180,695,440
11597,Berson,33047,33,212,448,112,644,344,1100,660
11598,Berthez,33048,33,16,86,16,61,66,143,102
11599,Beychac-et-Caillau,33049,33,183,559,138,745,461,1344,742
11600,Bieujac,33050,33,49,174,55,180,133,368,223
11601,Biganos,33051,33,1124,2429,1065,3170,2044,6279,3553
11602,Les Billaux,33052,33,105,340,130,384,235,749,445
11603,Birac,33053,33,48,56,8,84,32,124,104
11604,Blaignac,33054,33,28,65,28,120,44,192,93
11605,Blaignan,33055,33,21,39,26,70,60,156,60
11606,Blanquefort,33056,33,1315,3892,1674,5372,2888,9934,5207
11607,Blasimon,33057,33,110,235,60,330,180,570,345
11608,Blaye,33058,33,530,1016,558,1508,828,2894,1546
11609,Blésignac,33059,33,16,100,24,92,88,204,116
11610,Bommes,33060,33,36,134,20,186,125,331,170
11611,Bonnetan,33061,33,93,253,33,272,193,498,346
11612,Bonzac,33062,33,65,220,45,280,155,480,285
11613,Bordeaux,33063,33,23165,51235,57254,58799,50143,166196,74400
11614,Bossugan,33064,33,0,20,12,16,8,36,20
11615,Bouliac,33065,33,340,743,321,1173,584,2078,1083
11616,Bourdelles,33066,33,5,5,0,57,30,87,10
11617,Bourg,33067,33,302,502,165,713,425,1303,804
11618,Bourideys,33068,33,10,15,10,35,5,50,25
11619,Le Bouscat,33069,33,3594,5070,2245,7689,4487,14421,8664
11620,Brach,33070,33,16,171,46,153,170,369,187
11621,Branne,33071,33,110,340,110,340,275,725,450
11622,Brannens,33072,33,8,72,4,68,64,136,80
11623,Braud-et-Saint-Louis,33073,33,211,337,93,415,323,831,548
11624,Brouqueyran,33074,33,15,40,20,95,25,140,55
11625,Bruges,33075,33,1570,4100,2426,5216,3863,11505,5670
11626,Budos,33076,33,90,165,50,265,165,480,255
11627,Cabanac-et-Villagrains,33077,33,114,669,203,661,558,1422,783
11628,Cabara,33078,33,40,137,36,148,116,300,177
11629,Cadarsac,33079,33,28,77,17,79,95,191,105
11630,Cadaujac,33080,33,539,1270,758,1861,1166,3785,1809
11631,Cadillac,33081,33,289,567,238,696,562,1496,856
11632,Cadillac-en-Fronsadais,33082,33,92,346,124,408,295,827,438
11633,Camarsac,33083,33,96,256,64,380,168,612,352
11634,Cambes,33084,33,108,308,116,408,284,808,416
11635,Camblanes-et-Meynac,33085,33,324,695,163,922,561,1646,1019
11636,Camiac-et-Saint-Denis,33086,33,19,113,23,91,84,198,132
11637,Camiran,33087,33,61,66,26,136,67,229,127
11638,Camps-sur-l'Isle,33088,33,118,145,50,175,95,320,263
11639,Campugnan,33089,33,38,87,45,194,43,282,125
11640,Canéjan,33090,33,587,1244,614,1955,797,3366,1831
11641,Cantenac,33091,33,88,350,93,379,329,801,438
11642,Cantois,33092,33,40,70,10,45,75,130,110
11643,Capian,33093,33,64,172,76,216,164,456,236
11644,Caplong,33094,33,16,43,34,50,56,140,59
11645,Captieux,33095,33,291,191,58,454,151,663,482
11646,Carbon-Blanc,33096,33,1018,1728,683,2156,1503,4342,2746
11647,Carcans,33097,33,365,502,161,809,438,1408,867
11648,Cardan,33098,33,16,108,39,176,101,316,124
11649,Carignan-de-Bordeaux,33099,33,444,874,274,1202,748,2224,1318
11650,Cars,33100,33,188,208,88,492,188,768,396
11651,Cartelègue,33101,33,148,320,124,384,236,744,468
11652,Casseuil,33102,33,49,66,31,177,34,242,115
11653,Castelmoron-d'Albret,33103,33,3,13,0,12,15,27,16
11654,Castelnau-de-Médoc,33104,33,402,1075,525,1273,876,2674,1477
11655,Castelviel,33105,33,12,39,12,88,20,120,51
11656,Castets-en-Dorthe,33106,33,196,283,75,321,201,597,479
11657,Castillon-de-Castets,33107,33,29,100,15,100,70,185,129
11658,Castillon-la-Bataille,33108,33,540,670,211,917,476,1604,1210
11659,Castres-Gironde,33109,33,120,587,205,617,513,1335,707
11660,Caudrot,33111,33,120,335,150,315,200,665,455
11661,Caumont,33112,33,40,25,10,45,25,80,65
11662,Cauvignac,33113,33,20,40,5,60,25,90,60
11663,Cavignac,33114,33,240,520,204,444,420,1068,760
11664,Cazalis,33115,33,13,21,20,134,26,180,34
11665,Cazats,33116,33,28,106,29,74,118,221,134
11666,Cazaugitat,33117,33,25,65,20,90,40,150,90
11667,Cénac,33118,33,216,465,88,686,305,1079,681
11668,Cenon,33119,33,2860,6187,3135,6560,4670,14365,9047
11669,Cérons,33120,33,215,585,195,595,465,1255,800
11670,Cessac,33121,33,21,36,8,70,30,108,57
11671,Cestas,33122,33,2243,3359,1073,6739,2701,10513,5602
11672,Cézac,33123,33,247,748,190,717,546,1453,995
11673,Chamadelle,33124,33,64,192,42,250,98,390,256
11674,Cissac-Médoc,33125,33,159,511,211,709,344,1264,670
11675,Civrac-de-Blaye,33126,33,100,208,68,233,156,457,308
11676,Civrac-sur-Dordogne,33127,33,22,45,9,48,59,116,67
11677,Civrac-en-Médoc,33128,33,110,141,29,152,151,332,251
11678,Cleyrac,33129,33,24,29,12,49,12,73,53
11679,Coimères,33130,33,50,285,90,280,255,625,335
11680,Coirac,33131,33,15,50,20,85,40,145,65
11681,Comps,33132,33,40,128,32,188,113,333,168
11682,Coubeyrac,33133,33,10,10,5,55,5,65,20
11683,Couquèques,33134,33,16,76,44,56,56,156,92
11684,Courpiac,33135,33,12,41,0,24,44,68,53
11685,Cours-de-Monségur,33136,33,65,70,10,110,30,150,135
11686,Cours-les-Bains,33137,33,9,45,15,76,31,122,54
11687,Coutras,33138,33,1232,1861,868,2915,1270,5053,3093
11688,Coutures,33139,33,4,28,8,40,24,72,32
11689,Créon,33140,33,517,1114,582,1225,880,2687,1631
11690,Croignon,33141,33,63,158,40,133,155,328,221
11691,Cubnezais,33142,33,121,393,117,392,322,831,514
11692,Cubzac-les-Ponts,33143,33,185,578,241,702,548,1491,763
11693,Cudos,33144,33,100,240,50,289,145,484,340
11694,Cursan,33145,33,25,192,45,186,178,409,217
11695,Cussac-Fort-Médoc,33146,33,152,652,192,532,564,1288,804
11696,Daignac,33147,33,48,112,32,148,120,300,160
11697,Dardenac,33148,33,10,20,5,30,15,50,30
11698,Daubèze,33149,33,6,41,0,54,29,83,47
11699,Dieulivol,33150,33,31,30,25,111,21,157,61
11700,Donnezac,33151,33,109,198,57,290,154,501,307
11701,Donzac,33152,33,20,31,10,50,25,85,51
11702,Doulezon,33153,33,26,55,26,64,52,142,81
11703,Les Églisottes-et-Chalaures,33154,33,412,551,207,668,322,1197,963
11704,Escaudes,33155,33,25,17,4,60,16,80,42
11705,Escoussans,33156,33,52,109,16,60,96,172,161
11706,Espiet,33157,33,41,248,57,233,157,447,289
11707,Les Esseintes,33158,33,15,30,30,95,55,180,45
11708,Étauliers,33159,33,129,343,165,452,287,904,472
11709,Eynesse,33160,33,140,108,24,204,84,312,248
11710,Eyrans,33161,33,93,166,85,228,102,415,259
11711,Eysines,33162,33,2401,5193,2820,6006,4536,13362,7594
11712,Faleyras,33163,33,42,86,8,127,96,231,128
11713,Fargues,33164,33,171,355,113,511,253,877,526
11714,Fargues-Saint-Hilaire,33165,33,263,581,305,906,513,1724,844
11715,Le Fieu,33166,33,32,156,100,124,116,340,188
11716,Floirac,33167,33,1603,4040,2053,5259,3602,10914,5643
11717,Flaujagues,33168,33,92,124,20,250,117,387,216
11718,Floudès,33169,33,3,19,6,35,19,60,22
11719,Fontet,33170,33,161,186,70,205,145,420,347
11720,Fossès-et-Baleyssac,33171,33,12,28,20,98,24,142,40
11721,Fours,33172,33,56,53,20,85,50,155,109
11722,Francs,33173,33,40,40,15,80,30,125,80
11723,Fronsac,33174,33,105,255,90,465,185,740,360
11724,Frontenac,33175,33,80,228,64,212,200,476,308
11725,Gabarnac,33176,33,43,85,8,112,71,191,128
11726,Gaillan-en-Médoc,33177,33,278,446,186,810,351,1347,724
11727,Gajac,33178,33,76,87,30,111,50,191,163
11728,Galgon,33179,33,289,736,286,1046,629,1961,1025
11729,Gans,33180,33,13,39,9,64,34,107,52
11730,Gardegan-et-Tourtirac,33181,33,20,55,40,120,35,195,75
11731,Gauriac,33182,33,78,180,40,316,127,483,258
11732,Gauriaguet,33183,33,80,356,72,302,305,679,436
11733,Générac,33184,33,85,110,55,206,85,346,195
11734,Génissac,33185,33,165,534,214,534,448,1196,699
11735,Gensac,33186,33,174,150,55,334,100,489,324
11736,Gironde-sur-Dropt,33187,33,158,250,135,511,180,826,408
11737,Giscos,33188,33,30,45,0,65,40,105,75
11738,Gornac,33189,33,40,110,30,150,90,270,150
11739,Goualade,33190,33,20,20,0,40,12,52,40
11740,Gours,33191,33,71,157,42,144,87,273,228
11741,Gradignan,33192,33,3234,5143,3348,7165,4259,14772,8377
11742,Grayan-et-l'Hôpital,33193,33,256,213,88,506,175,769,469
11743,Grézillac,33194,33,124,172,12,216,144,372,296
11744,Grignols,33195,33,264,196,68,400,116,584,460
11745,Guillac,33196,33,32,26,0,66,22,88,58
11746,Guillos,33197,33,45,110,35,128,135,298,155
11747,Guîtres,33198,33,187,456,85,559,313,957,643
11748,Gujan-Mestras,33199,33,3451,4070,1533,7682,3488,12703,7521
11749,Le Haillan,33200,33,1016,2445,1334,3455,2174,6963,3461
11750,Haux,33201,33,83,197,51,202,217,470,280
11751,Hostens,33202,33,180,370,50,425,305,780,550
11752,Hourtin,33203,33,624,708,213,1202,579,1994,1332
11753,Hure,33204,33,71,108,26,142,111,279,179
11754,Illats,33205,33,144,354,75,513,280,868,498
11755,Isle-Saint-Georges,33206,33,55,125,70,200,90,360,180
11756,Izon,33207,33,412,1626,392,1574,1353,3319,2038
11757,Jau-Dignac-et-Loirac,33208,33,172,179,49,359,161,569,351
11758,Jugazan,33209,33,25,67,24,77,53,154,92
11759,Juillac,33210,33,12,69,9,87,53,149,81
11760,Labarde,33211,33,38,139,40,214,98,352,177
11761,Labescau,33212,33,12,19,0,26,20,46,31
11762,La Brède,33213,33,439,1054,339,1420,797,2556,1493
11763,Lacanau,33214,33,616,1063,228,1592,974,2794,1679
11764,Ladaux,33215,33,30,55,20,65,35,120,85
11765,Lados,33216,33,27,35,8,49,21,78,62
11766,Lagorce,33218,33,155,411,135,625,315,1075,566
11767,La Lande-de-Fronsac,33219,33,150,640,195,773,535,1503,790
11768,Lamarque,33220,33,148,350,105,330,290,725,498
11769,Lamothe-Landerron,33221,33,196,289,100,314,154,568,485
11770,Lalande-de-Pomerol,33222,33,76,136,48,232,172,452,212
11771,Landerrouat,33223,33,50,30,5,85,40,130,80
11772,Landerrouet-sur-Ségur,33224,33,15,16,13,27,6,46,31
11773,Landiras,33225,33,208,616,172,718,493,1383,824
11774,Langoiran,33226,33,292,565,160,596,555,1311,857
11775,Langon,33227,33,1336,1515,905,2090,1280,4275,2851
11776,Lansac,33228,33,42,165,47,255,149,451,207
11777,Lanton,33229,33,1132,1234,457,2754,1035,4246,2366
11778,Lapouyade,33230,33,51,108,20,134,107,261,159
11779,Laroque,33231,33,12,79,25,87,50,162,91
11780,Lartigue,33232,33,0,5,0,35,0,35,5
11781,Laruscade,33233,33,268,758,222,631,605,1458,1026
11782,Latresne,33234,33,503,871,168,1152,570,1890,1374
11783,Lavazan,33235,33,40,64,8,96,36,140,104
11784,Lège-Cap-Ferret,33236,33,1435,1536,439,3122,1389,4950,2971
11785,Léogeats,33237,33,72,216,80,240,209,529,288
11786,Léognan,33238,33,1123,2379,836,3634,1780,6250,3502
11787,Lerm-et-Musset,33239,33,128,92,32,152,76,260,220
11788,Lesparre-Médoc,33240,33,817,1247,483,1989,858,3330,2064
11789,Lestiac-sur-Garonne,33241,33,55,149,42,104,146,292,204
11790,Les Lèves-et-Thoumeyragues,33242,33,149,85,34,141,71,246,234
11791,Libourne,33243,33,3185,5773,2523,7564,4708,14795,8958
11792,Lignan-de-Bazas,33244,33,38,126,30,111,52,193,164
11793,Lignan-de-Bordeaux,33245,33,65,213,44,304,159,507,278
11794,Ligueux,33246,33,30,20,15,60,30,105,50
11795,Listrac-de-Durèze,33247,33,20,25,25,75,25,125,45
11796,Listrac-Médoc,33248,33,195,743,205,750,672,1627,938
11797,Lormont,33249,33,2231,5457,2799,5746,4181,12726,7688
11798,Loubens,33250,33,23,67,25,95,55,175,90
11799,Louchats,33251,33,76,223,56,188,172,416,299
11800,Loupes,33252,33,39,214,45,238,189,472,253
11801,Loupiac,33253,33,125,264,105,423,186,714,389
11802,Loupiac-de-la-Réole,33254,33,45,110,50,140,120,310,155
11803,Lucmau,33255,33,12,43,12,110,34,156,55
11804,Ludon-Médoc,33256,33,320,1135,432,1488,969,2889,1455
11805,Lugaignac,33257,33,38,122,35,115,102,252,160
11806,Lugasson,33258,33,40,65,20,90,85,195,105
11807,Lugon-et-l'Île-du-Carnay,33259,33,170,295,130,395,175,700,465
11808,Lugos,33260,33,80,256,44,284,212,540,336
11809,Lussac,33261,33,100,306,115,505,247,867,406
11810,Macau,33262,33,319,1051,451,1192,935,2578,1370
11811,Madirac,33263,33,12,54,8,79,46,133,66
11812,Maransin,33264,33,130,300,35,330,255,620,430
11813,Marcenais,33266,33,70,200,30,323,130,483,270
11814,Marcillac,33267,33,210,255,100,395,175,670,465
11815,Margaux,33268,33,185,408,135,476,279,890,593
11816,Margueron,33269,33,38,72,15,118,51,184,110
11817,Marimbault,33270,33,16,62,0,56,53,109,78
11818,Marions,33271,33,28,28,20,76,28,124,56
11819,Marsas,33272,33,116,324,92,364,268,724,440
11820,Martignas-sur-Jalle,33273,33,690,1755,580,2525,1210,4315,2445
11821,Martillac,33274,33,139,707,271,882,651,1804,846
11822,Martres,33275,33,29,35,0,39,25,64,64
11823,Masseilles,33276,33,24,52,4,64,20,88,76
11824,Massugas,33277,33,32,30,13,86,30,129,62
11825,Mauriac,33278,33,35,45,10,95,55,160,80
11826,Mazères,33279,33,60,192,28,264,160,452,252
11827,Mazion,33280,33,60,136,32,196,92,320,196
11828,Mérignac,33281,33,8039,14906,10472,20579,14072,45123,22945
11829,Mérignas,33282,33,55,71,12,109,45,166,126
11830,Mesterrieux,33283,33,8,31,16,89,37,142,39
11831,Mios,33284,33,715,2504,829,2271,2193,5293,3219
11832,Mombrier,33285,33,44,105,24,120,105,249,149
11833,Mongauzy,33287,33,120,152,56,176,116,348,272
11834,Monprimblanc,33288,33,43,66,4,98,48,150,109
11835,Monségur,33289,33,273,246,70,423,163,656,519
11836,Montagne,33290,33,195,392,105,480,361,946,587
11837,Montagoudin,33291,33,24,40,16,64,32,112,64
11838,Montignac,33292,33,12,36,0,68,28,96,48
11839,Montussan,33293,33,229,772,370,997,696,2063,1001
11840,Morizès,33294,33,132,105,30,129,78,237,237
11841,Mouillac,33295,33,0,18,12,41,0,53,18
11842,Mouliets-et-Villemartin,33296,33,211,179,85,444,133,662,390
11843,Moulis-en-Médoc,33297,33,147,468,204,565,403,1172,615
11844,Moulon,33298,33,205,224,73,313,174,560,429
11845,Mourens,33299,33,48,104,24,120,68,212,152
11846,Naujac-sur-Mer,33300,33,114,209,85,334,207,626,323
11847,Naujan-et-Postiac,33301,33,74,127,38,163,90,291,201
11848,Néac,33302,33,75,95,40,110,70,220,170
11849,Nérigean,33303,33,91,149,37,346,125,508,240
11850,Neuffons,33304,33,20,33,9,47,25,81,53
11851,Le Nizan,33305,33,74,113,29,155,59,243,187
11852,Noaillac,33306,33,10,80,50,190,85,325,90
11853,Noaillan,33307,33,176,486,108,544,306,958,662
11854,Omet,33308,33,48,68,20,92,60,172,116
11855,Ordonnac,33309,33,34,148,21,185,72,278,182
11856,Origne,33310,33,9,40,6,49,39,94,49
11857,Paillet,33311,33,64,300,164,404,308,876,364
11858,Parempuyre,33312,33,636,1972,778,2815,1626,5219,2608
11859,Pauillac,33314,33,682,1090,500,1778,737,3015,1772
11860,Les Peintures,33315,33,216,440,112,496,312,920,656
11861,Pellegrue,33316,33,145,210,50,358,216,624,355
11862,Périssac,33317,33,88,296,104,375,228,707,384
11863,Pessac,33318,33,6595,14483,9597,18090,10785,38472,21078
11864,Pessac-sur-Dordogne,33319,33,84,120,40,188,56,284,204
11865,Petit-Palais-et-Cornemps,33320,33,35,200,101,254,158,513,235
11866,Peujard,33321,33,140,652,195,534,570,1299,792
11867,Le Pian-Médoc,33322,33,441,1570,591,2364,1246,4201,2011
11868,Le Pian-sur-Garonne,33323,33,70,220,45,310,175,530,290
11869,Pineuilh,33324,33,831,859,275,1423,693,2391,1690
11870,Plassac,33325,33,108,175,50,355,180,585,283
11871,Pleine-Selve,33326,33,26,53,24,40,36,100,79
11872,Podensac,33327,33,325,720,269,784,650,1703,1045
11873,Pomerol,33328,33,133,104,10,213,134,357,237
11874,Pompéjac,33329,33,22,86,12,56,66,134,108
11875,Pompignac,33330,33,286,656,231,1071,541,1843,942
11876,Pondaurat,33331,33,65,165,15,135,125,275,230
11877,Porchères,33332,33,100,224,44,348,196,588,324
11878,Le Porge,33333,33,327,640,236,888,599,1723,967
11879,Portets,33334,33,256,682,195,752,635,1582,938
11880,Le Pout,33335,33,57,163,27,150,141,318,220
11881,Préchac,33336,33,200,191,35,402,150,587,391
11882,Preignac,33337,33,284,461,163,742,445,1350,745
11883,Prignac-en-Médoc,33338,33,12,47,0,78,33,111,59
11884,Prignac-et-Marcamps,33339,33,180,336,104,520,232,856,516
11885,Pugnac,33341,33,330,544,240,692,439,1371,874
11886,Puisseguin,33342,33,95,170,50,355,180,585,265
11887,Pujols-sur-Ciron,33343,33,60,170,55,350,130,535,230
11888,Pujols,33344,33,96,96,40,242,70,352,192
11889,Le Puy,33345,33,55,90,21,143,54,218,145
11890,Puybarban,33346,33,82,102,13,103,77,193,184
11891,Puynormand,33347,33,45,80,30,110,45,185,125
11892,Queyrac,33348,33,230,235,140,565,200,905,465
11893,Quinsac,33349,33,244,591,84,636,550,1270,835
11894,Rauzan,33350,33,151,277,78,391,177,646,428
11895,Reignac,33351,33,202,360,90,523,221,834,562
11896,La Réole,33352,33,703,913,452,1064,650,2166,1616
11897,Rimons,33353,33,20,45,15,75,25,115,65
11898,Riocaud,33354,33,10,50,15,75,30,120,60
11899,Rions,33355,33,160,405,120,545,345,1010,565
11900,La Rivière,33356,33,52,104,16,163,67,246,156
11901,Roaillan,33357,33,93,464,114,514,363,991,557
11902,Romagne,33358,33,20,150,45,120,130,295,170
11903,Roquebrune,33359,33,46,57,27,86,16,129,103
11904,La Roquille,33360,33,50,125,25,85,75,185,175
11905,Ruch,33361,33,63,131,42,178,124,344,194
11906,Sablons,33362,33,134,300,160,450,270,880,434
11907,Sadirac,33363,33,336,1158,298,1206,901,2405,1494
11908,Saillans,33364,33,8,114,24,146,83,253,122
11909,Saint-Aignan,33365,33,30,42,10,68,36,114,72
11910,Saint-André-de-Cubzac,33366,33,887,2448,1422,2911,2379,6712,3335
11911,Saint-André-du-Bois,33367,33,67,88,28,121,67,216,155
11912,Saint-André-et-Appelles,33369,33,84,156,68,268,148,484,240
11913,Saint-Androny,33370,33,41,87,37,249,86,372,128
11914,Saint-Antoine-du-Queyret,33372,33,9,13,6,14,15,35,22
11915,Saint-Antoine-sur-l'Isle,33373,33,66,147,17,152,115,284,213
11916,Saint-Aubin-de-Blaye,33374,33,75,225,90,280,150,520,300
11917,Saint-Aubin-de-Branne,33375,33,40,80,10,170,50,230,120
11918,Saint-Aubin-de-Médoc,33376,33,618,1897,426,2438,1099,3963,2515
11919,Saint-Avit-de-Soulège,33377,33,4,16,0,44,4,48,20
11920,Saint-Avit-Saint-Nazaire,33378,33,195,340,130,555,225,910,535
11921,Saint-Brice,33379,33,12,57,8,70,58,136,69
11922,Saint-Caprais-de-Blaye,33380,33,56,132,52,180,124,356,188
11923,Saint-Caprais-de-Bordeaux,33381,33,224,794,211,962,601,1774,1018
11924,Saint-Christoly-de-Blaye,33382,33,235,460,135,620,395,1150,695
11925,Saint-Christoly-Médoc,33383,33,56,48,16,84,72,172,104
11926,Saint-Christophe-des-Bardes,33384,33,75,90,35,165,85,285,165
11927,Saint-Christophe-de-Double,33385,33,99,186,34,224,147,405,285
11928,Saint-Cibard,33386,33,29,30,20,64,30,114,59
11929,Saint-Ciers-d'Abzac,33387,33,103,341,115,431,258,804,444
11930,Saint-Ciers-de-Canesse,33388,33,59,208,37,267,160,464,267
11931,Saint-Ciers-sur-Gironde,33389,33,394,683,359,983,482,1824,1077
11932,Sainte-Colombe,33390,33,55,95,20,145,85,250,150
11933,Saint-Côme,33391,33,68,72,32,104,48,184,140
11934,Sainte-Croix-du-Mont,33392,33,106,233,71,240,146,457,339
11935,Saint-Denis-de-Pile,33393,33,564,1400,472,1676,970,3118,1964
11936,Saint-Émilion,33394,33,280,379,174,605,370,1149,659
11937,Saint-Estèphe,33395,33,220,410,85,485,415,985,630
11938,Saint-Étienne-de-Lisse,33396,33,40,45,30,90,40,160,85
11939,Sainte-Eulalie,33397,33,520,1305,250,1635,891,2776,1825
11940,Saint-Exupéry,33398,33,12,25,22,54,21,97,37
11941,Saint-Félix-de-Foncaude,33399,33,60,55,25,115,30,170,115
11942,Saint-Ferme,33400,33,35,90,20,135,60,215,125
11943,Sainte-Florence,33401,33,16,40,12,56,28,96,56
11944,Sainte-Foy-la-Grande,33402,33,546,465,200,553,370,1123,1011
11945,Sainte-Foy-la-Longue,33403,33,5,45,15,50,20,85,50
11946,Sainte-Gemme,33404,33,55,25,0,108,15,123,80
11947,Saint-Genès-de-Blaye,33405,33,48,112,68,176,76,320,160
11948,Saint-Genès-de-Castillon,33406,33,32,87,42,159,36,237,119
11949,Saint-Genès-de-Fronsac,33407,33,70,247,35,201,171,407,317
11950,Saint-Genès-de-Lombaud,33408,33,30,110,40,103,85,228,140
11951,Saint-Genis-du-Bois,33409,33,20,35,0,20,30,50,55
11952,Saint-Germain-de-Grave,33411,33,35,31,16,47,9,72,66
11953,Saint-Germain-d'Esteuil,33412,33,161,271,113,443,137,693,432
11954,Saint-Germain-du-Puch,33413,33,230,547,198,631,443,1272,777
11955,Saint-Germain-de-la-Rivière,33414,33,35,95,30,170,65,265,130
11956,Saint-Gervais,33415,33,123,456,214,572,347,1133,579
11957,Saint-Girons-d'Aiguevives,33416,33,115,233,60,335,213,608,348
11958,Sainte-Hélène,33417,33,216,765,188,866,619,1673,981
11959,Saint-Hilaire-de-la-Noaille,33418,33,44,96,20,128,76,224,140
11960,Saint-Hilaire-du-Bois,33419,33,12,16,6,15,12,33,28
11961,Saint-Hippolyte,33420,33,12,32,4,60,40,104,44
11962,Saint-Jean-de-Blaignac,33421,33,61,97,50,179,56,285,158
11963,Saint-Jean-d'Illac,33422,33,458,2017,679,2304,1797,4780,2475
11964,Saint-Julien-Beychevelle,33423,33,65,190,55,175,145,375,255
11965,Saint-Laurent-Médoc,33424,33,451,1180,426,1427,982,2835,1631
11966,Saint-Laurent-d'Arce,33425,33,116,379,124,404,357,885,495
11967,Saint-Laurent-des-Combes,33426,33,37,31,12,102,47,161,68
11968,Saint-Laurent-du-Bois,33427,33,44,60,20,64,48,132,104
11969,Saint-Laurent-du-Plan,33428,33,30,25,10,38,5,53,55
11970,Saint-Léger-de-Balson,33429,33,45,95,30,75,85,190,140
11971,Saint-Léon,33431,33,25,85,30,115,80,225,110
11972,Saint-Loubert,33432,33,24,68,8,77,36,121,92
11973,Saint-Loubès,33433,33,779,2313,794,2730,1919,5443,3092
11974,Saint-Louis-de-Montferrand,33434,33,161,570,283,720,408,1411,731
11975,Saint-Macaire,33435,33,224,497,202,503,335,1040,721
11976,Saint-Magne,33436,33,115,250,35,335,205,575,365
11977,Saint-Magne-de-Castillon,33437,33,355,435,125,695,300,1120,790
11978,Saint-Maixant,33438,33,207,493,112,502,457,1071,700
11979,Saint-Mariens,33439,33,141,401,120,524,278,922,542
11980,Saint-Martial,33440,33,12,68,32,40,76,148,80
11981,Saint-Martin-Lacaussade,33441,33,125,211,103,377,180,660,336
11982,Saint-Martin-de-Laye,33442,33,85,125,50,175,110,335,210
11983,Saint-Martin-de-Lerm,33443,33,25,20,14,50,24,88,45
11984,Saint-Martin-de-Sescas,33444,33,88,168,24,160,156,340,256
11985,Saint-Martin-du-Bois,33445,33,63,225,94,219,205,518,288
11986,Saint-Martin-du-Puy,33446,33,35,45,10,65,35,110,80
11987,Saint-Médard-de-Guizières,33447,33,307,570,184,828,465,1477,877
11988,Saint-Médard-d'Eyrans,33448,33,216,674,279,936,640,1855,890
11989,Saint-Médard-en-Jalles,33449,33,3553,7351,2655,10150,5682,18487,10904
11990,Saint-Michel-de-Castelnau,33450,33,48,33,12,44,34,90,81
11991,Saint-Michel-de-Fronsac,33451,33,82,107,35,135,89,259,189
11992,Saint-Michel-de-Rieufret,33452,33,76,124,16,192,148,356,200
11993,Saint-Michel-de-Lapujade,33453,33,24,55,16,51,49,116,79
11994,Saint-Morillon,33454,33,118,513,102,500,322,924,631
11995,Saint-Palais,33456,33,56,108,36,168,112,316,164
11996,Saint-Pardon-de-Conques,33457,33,30,142,25,244,83,352,172
11997,Saint-Paul,33458,33,85,190,50,450,125,625,275
11998,Saint-Pey-d'Armens,33459,33,50,22,6,57,38,101,72
11999,Saint-Pey-de-Castets,33460,33,120,140,25,210,130,365,260
12000,Saint-Philippe-d'Aiguille,33461,33,75,80,15,135,60,210,155
12001,Saint-Philippe-du-Seignal,33462,33,85,109,16,136,77,229,194
12002,Saint-Pierre-d'Aurillac,33463,33,189,337,68,440,285,793,526
12003,Saint-Pierre-de-Bat,33464,33,70,65,0,105,60,165,135
12004,Saint-Pierre-de-Mons,33465,33,60,345,80,375,265,720,405
12005,Saint-Quentin-de-Baron,33466,33,72,603,326,547,628,1501,675
12006,Saint-Quentin-de-Caplong,33467,33,44,48,12,96,48,156,92
12007,Sainte-Radegonde,33468,33,78,115,20,173,100,293,193
12008,Saint-Romain-la-Virvée,33470,33,119,179,52,286,137,475,298
12009,Saint-Sauveur,33471,33,128,300,104,479,201,784,428
12010,Saint-Sauveur-de-Puynormand,33472,33,55,91,30,120,60,210,146
12011,Saint-Savin,33473,33,277,933,212,858,701,1771,1210
12012,Saint-Selve,33474,33,101,831,169,785,672,1626,932
12013,Saint-Seurin-de-Bourg,33475,33,45,95,15,128,105,248,140
12014,Saint-Seurin-de-Cadourne,33476,33,85,152,61,177,141,379,237
12015,Saint-Seurin-de-Cursac,33477,33,83,137,99,247,97,443,220
12016,Saint-Seurin-sur-l'Isle,33478,33,509,685,292,1035,462,1789,1194
12017,Saint-Sève,33479,33,52,56,4,76,44,124,108
12018,Saint-Sulpice-de-Faleyrens,33480,33,199,305,77,578,202,857,504
12019,Saint-Sulpice-de-Guilleragues,33481,33,26,26,18,59,36,113,52
12020,Saint-Sulpice-de-Pommiers,33482,33,15,40,35,75,55,165,55
12021,Saint-Sulpice-et-Cameyrac,33483,33,443,1027,404,1674,869,2947,1470
12022,Saint-Symphorien,33484,33,298,415,155,563,309,1027,713
12023,Sainte-Terre,33485,33,300,368,208,636,336,1180,668
12024,Saint-Trojan,33486,33,24,64,52,160,56,268,88
12025,Saint-Vincent-de-Paul,33487,33,40,215,95,395,190,680,255
12026,Saint-Vincent-de-Pertignas,33488,33,43,81,30,139,38,207,124
12027,Saint-Vivien-de-Blaye,33489,33,48,104,24,124,80,228,152
12028,Saint-Vivien-de-Médoc,33490,33,304,352,116,640,276,1032,656
12029,Saint-Vivien-de-Monségur,33491,33,55,45,10,211,35,256,100
12030,Saint-Yzan-de-Soudiac,33492,33,175,741,179,619,506,1304,916
12031,Saint-Yzans-de-Médoc,33493,33,95,30,35,165,50,250,125
12032,Salaunes,33494,33,64,233,60,240,240,540,297
12033,Salleboeuf,33496,33,210,519,188,883,389,1460,729
12034,Salles,33498,33,768,1859,505,2082,1370,3957,2627
12035,Les Salles-de-Castillon,33499,33,75,90,20,120,65,205,165
12036,Samonac,33500,33,85,90,25,170,85,280,175
12037,Saucats,33501,33,177,747,162,845,643,1650,924
12038,Saugon,33502,33,55,130,50,158,60,268,185
12039,Saumos,33503,33,35,138,33,160,137,330,173
12040,Sauternes,33504,33,96,188,36,236,196,468,284
12041,La Sauve,33505,33,145,371,157,367,294,818,516
12042,Sauveterre-de-Guyenne,33506,33,297,357,159,638,307,1104,654
12043,Sauviac,33507,33,32,81,6,83,76,165,113
12044,Savignac,33508,33,85,165,25,190,160,375,250
12045,Savignac-de-l'Isle,33509,33,52,94,30,163,93,286,146
12046,Semens,33510,33,3,43,6,54,47,107,46
12047,Sendets,33511,33,45,75,15,130,65,210,120
12048,Sigalens,33512,33,80,100,15,145,50,210,180
12049,Sillas,33513,33,32,16,8,32,4,44,48
12050,Soulac-sur-Mer,33514,33,549,336,144,968,256,1368,885
12051,Soulignac,33515,33,70,95,30,160,85,275,165
12052,Soussac,33516,33,16,41,29,61,8,98,57
12053,Soussans,33517,33,189,442,116,430,341,887,631
12054,Tabanac,33518,33,93,235,70,440,210,720,328
12055,Le Taillan-Médoc,33519,33,1036,2578,815,3168,2146,6129,3614
12056,Taillecavat,33520,33,32,88,28,100,64,192,120
12057,Talais,33521,33,124,140,42,267,91,400,264
12058,Talence,33522,33,3632,8925,10989,9511,7295,27795,12557
12059,Targon,33523,33,216,475,233,620,331,1184,691
12060,Tarnès,33524,33,36,65,24,78,71,173,101
12061,Tauriac,33525,33,120,324,108,428,300,836,444
12062,Tayac,33526,33,30,25,0,55,20,75,55
12063,Le Teich,33527,33,702,1849,687,2554,1475,4716,2551
12064,Le Temple,33528,33,80,116,43,161,119,323,196
12065,La Teste-de-Buch,33529,33,4412,5287,2021,9579,4197,15797,9699
12066,Teuillac,33530,33,32,268,84,228,271,583,300
12067,Tizac-de-Curton,33531,33,24,78,12,94,69,175,102
12068,Tizac-de-Lapouyade,33532,33,58,112,28,173,75,276,170
12069,Toulenne,33533,33,310,615,214,686,462,1362,925
12070,Le Tourne,33534,33,115,196,51,220,155,426,311
12071,Tresses,33535,33,394,1105,297,1614,927,2838,1499
12072,Le Tuzan,33536,33,15,90,25,85,60,170,105
12073,Uzeste,33537,33,53,64,18,126,65,209,117
12074,Valeyrac,33538,33,65,165,45,150,105,300,230
12075,Vayres,33539,33,320,973,294,1053,868,2215,1293
12076,Vendays-Montalivet,33540,33,550,385,185,970,320,1475,935
12077,Vensac,33541,33,180,176,48,356,164,568,356
12078,Vérac,33542,33,84,250,88,220,246,554,334
12079,Verdelais,33543,33,110,240,85,255,229,569,350
12080,Le Verdon-sur-Mer,33544,33,330,190,115,475,138,728,520
12081,Vertheuil,33545,33,134,309,44,393,288,725,443
12082,Vignonet,33546,33,80,120,40,200,95,335,200
12083,Villandraut,33547,33,185,215,39,343,200,582,400
12084,Villegouge,33548,33,100,345,94,444,290,828,445
12085,Villenave-de-Rions,33549,33,25,85,10,110,90,210,110
12086,Villenave-d'Ornon,33550,33,3747,7167,3692,9670,6236,19598,10914
12087,Villeneuve,33551,33,46,67,27,102,85,214,113
12088,Virelade,33552,33,70,295,55,370,230,655,365
12089,Virsac,33553,33,64,260,88,316,228,632,324
12090,Yvrac,33554,33,265,670,255,943,614,1812,935
12091,Marcheprime,33555,33,311,1286,340,1395,1019,2754,1597
12092,Abeilhan,34001,34,169,434,140,493,359,992,603
12093,Adissan,34002,34,141,301,80,317,239,636,442
12094,Agde,34003,34,4923,4958,2260,9532,3932,15724,9881
12095,Agel,34004,34,52,36,12,80,20,112,88
12096,Agonès,34005,34,21,64,39,77,20,136,85
12097,Aigne,34006,34,48,56,16,112,40,168,104
12098,Aigues-Vives,34007,34,88,88,36,156,76,268,176
12099,Les Aires,34008,34,92,104,56,244,108,408,196
12100,Alignan-du-Vent,34009,34,295,360,125,656,235,1016,655
12101,Aniane,34010,34,428,721,322,760,619,1701,1149
12102,Arboras,34011,34,5,25,5,50,30,85,30
12103,Argelliers,34012,34,65,250,60,383,203,646,315
12104,Aspiran,34013,34,233,393,104,497,271,872,626
12105,Assas,34014,34,161,361,105,623,167,895,522
12106,Assignan,34015,34,48,28,8,48,20,76,76
12107,Aumelas,34016,34,50,130,20,208,100,328,180
12108,Aumes,34017,34,69,128,13,168,85,266,197
12109,Autignac,34018,34,128,240,60,272,184,516,368
12110,Avène,34019,34,65,50,15,150,25,190,115
12111,Azillanet,34020,34,90,70,20,139,64,223,160
12112,Babeau-Bouldoux,34021,34,29,34,21,140,33,194,63
12113,Baillargues,34022,34,764,1758,681,2110,1431,4222,2522
12114,Balaruc-les-Bains,34023,34,1395,1283,477,2454,1016,3947,2678
12115,Balaruc-le-Vieux,34024,34,291,581,184,883,511,1578,872
12116,Bassan,34025,34,263,441,115,672,388,1175,704
12117,Beaufort,34026,34,42,30,8,68,29,105,72
12118,Beaulieu,34027,34,192,434,160,578,300,1038,626
12119,Bédarieux,34028,34,1105,1127,560,2250,766,3576,2232
12120,Bélarga,34029,34,36,123,36,167,112,315,159
12121,Berlou,34030,34,35,50,15,75,40,130,85
12122,Bessan,34031,34,712,1076,350,1606,863,2819,1788
12123,Béziers,34032,34,11854,17605,8504,22510,12870,43884,29459
12124,Boisseron,34033,34,172,514,149,547,384,1080,686
12125,Boisset,34034,34,8,4,0,16,8,24,12
12126,La Boissière,34035,34,92,243,96,342,185,623,335
12127,Le Bosc,34036,34,156,325,112,404,324,840,481
12128,Boujan-sur-Libron,34037,34,395,648,303,1105,640,2048,1043
12129,Le Bousquet-d'Orb,34038,34,296,300,156,528,236,920,596
12130,Bouzigues,34039,34,248,385,140,663,288,1091,633
12131,Brenas,34040,34,6,3,6,23,6,35,9
12132,Brignac,34041,34,68,276,24,208,236,468,344
12133,Brissac,34042,34,65,150,20,230,140,390,215
12134,Buzignargues,34043,34,16,64,32,96,60,188,80
12135,Cabrerolles,34044,34,35,75,20,150,45,215,110
12136,Cabrières,34045,34,80,105,25,165,120,310,185
12137,Cambon-et-Salvergues,34046,34,0,5,0,40,5,45,5
12138,Campagnan,34047,34,108,156,36,216,124,376,264
12139,Campagne,34048,34,20,75,25,115,60,200,95
12140,Camplong,34049,34,75,50,15,100,20,135,125
12141,Candillargues,34050,34,100,477,165,502,353,1020,577
12142,Canet,34051,34,385,987,273,1086,684,2043,1372
12143,Capestang,34052,34,455,743,203,988,598,1789,1198
12144,Carlencas-et-Levas,34053,34,9,22,12,32,22,66,31
12145,Cassagnoles,34054,34,29,4,0,28,8,36,33
12146,Castanet-le-Haut,34055,34,19,26,15,70,26,111,45
12147,Castelnau-de-Guers,34056,34,135,258,59,388,233,680,393
12148,Castelnau-le-Lez,34057,34,2404,4223,2739,5771,3325,11835,6627
12149,Castries,34058,34,742,1537,517,2110,1004,3631,2279
12150,La Caunette,34059,34,35,60,5,125,80,210,95
12151,Causse-de-la-Selle,34060,34,68,70,8,95,60,163,138
12152,Causses-et-Veyran,34061,34,125,105,40,235,95,370,230
12153,Caussiniojouls,34062,34,15,25,25,49,15,89,40
12154,Caux,34063,34,387,542,171,935,304,1410,929
12155,Le Caylar,34064,34,38,69,47,156,49,252,107
12156,Cazedarnes,34065,34,89,130,75,215,90,380,219
12157,Cazevieille,34066,34,5,40,0,80,50,130,45
12158,Cazilhac,34067,34,194,365,55,568,290,913,559
12159,Cazouls-d'Hérault,34068,34,32,132,16,128,92,236,164
12160,Cazouls-lès-Béziers,34069,34,574,1350,410,1473,988,2871,1924
12161,Cébazan,34070,34,50,145,4,239,108,351,195
12162,Ceilhes-et-Rocozels,34071,34,79,67,12,93,47,152,146
12163,Celles,34072,34,0,10,5,15,5,25,10
12164,Cers,34073,34,337,591,143,617,502,1262,928
12165,Cessenon-sur-Orb,34074,34,409,476,180,707,326,1213,885
12166,Cesseras,34075,34,57,70,21,147,39,207,127
12167,Ceyras,34076,34,123,440,85,425,325,835,563
12168,Clapiers,34077,34,605,1360,524,1716,962,3202,1965
12169,Claret,34078,34,194,340,65,501,274,840,534
12170,Clermont-l'Hérault,34079,34,1172,1911,867,2614,1440,4921,3083
12171,Colombières-sur-Orb,34080,34,100,72,40,200,56,296,172
12172,Colombiers,34081,34,379,430,210,920,334,1464,809
12173,Combaillaux,34082,34,140,390,90,585,250,925,530
12174,Combes,34083,34,60,35,20,90,30,140,95
12175,Corneilhan,34084,34,286,310,101,664,196,961,596
12176,Coulobres,34085,34,35,71,35,125,86,246,106
12177,Courniou,34086,34,140,100,45,205,70,320,240
12178,Cournonsec,34087,34,178,946,320,786,779,1885,1124
12179,Cournonterral,34088,34,559,1521,543,1928,1174,3645,2080
12180,Creissan,34089,34,205,306,100,405,303,808,511
12181,Le Crès,34090,34,1290,2102,808,2674,1900,5382,3392
12182,Le Cros,34091,34,10,15,0,24,19,43,25
12183,Cruzy,34092,34,210,211,60,319,228,607,421
12184,Dio-et-Valquières,34093,34,38,30,5,55,25,85,68
12185,Espondeilhan,34094,34,117,217,78,335,209,622,334
12186,Fabrègues,34095,34,855,1430,674,2320,1064,4058,2285
12187,Faugères,34096,34,75,105,43,206,85,334,180
12188,Félines-Minervois,34097,34,60,86,12,149,87,248,146
12189,Ferrals-les-Montagnes,34098,34,30,25,10,75,20,105,55
12190,Ferrières-les-Verreries,34099,34,5,10,0,20,15,35,15
12191,Ferrières-Poussarou,34100,34,12,28,4,32,8,44,40
12192,Florensac,34101,34,803,1137,392,1602,826,2820,1940
12193,Fontanès,34102,34,20,92,24,100,100,224,112
12194,Fontès,34103,34,110,169,54,372,174,600,279
12195,Fos,34104,34,20,15,5,35,10,50,35
12196,Fouzilhon,34105,34,24,46,25,44,47,116,70
12197,Fozières,34106,34,15,25,5,90,25,120,40
12198,Fraisse-sur-Agout,34107,34,70,50,25,135,50,210,120
12199,Frontignan,34108,34,3361,5042,2195,7780,4070,14045,8403
12200,Gabian,34109,34,152,168,64,336,100,500,320
12201,Galargues,34110,34,68,173,100,192,130,422,241
12202,Ganges,34111,34,715,746,291,1252,630,2173,1461
12203,Garrigues,34112,34,12,52,4,57,21,82,64
12204,Gigean,34113,34,491,1781,596,1774,1426,3796,2272
12205,Gignac,34114,34,633,1709,552,1685,1275,3512,2342
12206,Gorniès,34115,34,34,12,0,48,16,64,46
12207,Grabels,34116,34,505,1733,1501,2160,1597,5258,2238
12208,Graissessac,34117,34,191,95,115,175,85,375,286
12209,Guzargues,34118,34,68,156,28,184,92,304,224
12210,Hérépian,34119,34,328,264,112,540,252,904,592
12211,Jacou,34120,34,537,1783,707,2121,1542,4370,2320
12212,Joncels,34121,34,40,57,29,96,34,159,97
12213,Jonquières,34122,34,17,82,26,145,94,265,99
12214,Juvignac,34123,34,1023,2038,1049,2833,1655,5537,3061
12215,Lacoste,34124,34,50,80,20,120,50,190,130
12216,Lagamas,34125,34,5,15,10,50,25,85,20
12217,Lamalou-les-Bains,34126,34,523,354,159,760,306,1225,877
12218,Lansargues,34127,34,302,816,254,923,768,1945,1118
12219,Laroque,34128,34,325,338,111,477,259,847,663
12220,Lattes,34129,34,2192,3311,1570,5484,3232,10286,5503
12221,Laurens,34130,34,270,411,108,435,324,867,681
12222,Lauret,34131,34,25,143,70,198,79,347,168
12223,Lauroux,34132,34,35,23,12,73,18,103,58
12224,Lavalette,34133,34,5,10,0,15,30,45,15
12225,Lavérune,34134,34,370,709,238,1013,478,1729,1079
12226,Lespignan,34135,34,540,680,225,1190,500,1915,1220
12227,Lézignan-la-Cèbe,34136,34,169,415,70,565,251,886,584
12228,Liausson,34137,34,25,20,20,85,0,105,45
12229,Lieuran-Cabrières,34138,34,29,60,12,121,48,181,89
12230,Lieuran-lès-Béziers,34139,34,175,315,90,530,265,885,490
12231,Lignan-sur-Orb,34140,34,413,576,268,1256,370,1894,989
12232,La Livinière,34141,34,110,79,29,230,34,293,189
12233,Lodève,34142,34,1113,1759,659,2255,1270,4184,2872
12234,Loupian,34143,34,286,483,134,710,430,1274,769
12235,Lunas,34144,34,142,103,65,185,93,343,245
12236,Lunel,34145,34,3067,6271,2626,7504,4695,14825,9338
12237,Lunel-Viel,34146,34,373,1010,363,1095,809,2267,1383
12238,Magalas,34147,34,405,865,275,1145,595,2015,1270
12239,Maraussan,34148,34,575,1097,237,1310,779,2326,1672
12240,Margon,34149,34,80,163,8,235,128,371,243
12241,Marseillan,34150,34,1386,1363,650,3098,1041,4789,2749
12242,Marsillargues,34151,34,741,1386,716,2034,1181,3931,2127
12243,Mas-de-Londres,34152,34,29,176,35,144,183,362,205
12244,Les Matelles,34153,34,202,492,165,631,337,1133,694
12245,Mauguio,34154,34,2527,3592,1556,5828,3094,10478,6119
12246,Maureilhan,34155,34,248,447,155,711,372,1238,695
12247,Mérifons,34156,34,3,3,3,18,3,24,6
12248,Mèze,34157,34,1882,2383,954,3882,1856,6692,4265
12249,Minerve,34158,34,23,30,10,35,30,75,53
12250,Mireval,34159,34,380,785,269,1224,587,2080,1165
12251,Mons,34160,34,50,95,35,295,105,435,145
12252,Montady,34161,34,496,912,325,1507,628,2460,1408
12253,Montagnac,34162,34,608,1066,371,1187,734,2292,1674
12254,Montarnaud,34163,34,235,758,204,1074,522,1800,993
12255,Montaud,34164,34,104,246,72,284,238,594,350
12256,Montbazin,34165,34,268,913,248,931,618,1797,1181
12257,Montblanc,34166,34,427,676,259,792,526,1577,1103
12258,Montels,34167,34,25,75,40,70,55,165,100
12259,Montesquieu,34168,34,12,0,4,43,12,59,12
12260,Montferrier-sur-Lez,34169,34,591,699,324,1233,541,2098,1290
12261,Montouliers,34170,34,72,44,8,88,44,140,116
12262,Montoulieu,34171,34,12,24,28,84,20,132,36
12263,Montpellier,34172,34,25689,61419,62980,62285,54548,179813,87108
12264,Montpeyroux,34173,34,188,316,76,436,252,764,504
12265,Moulès-et-Baucels,34174,34,128,215,120,300,140,560,343
12266,Mourèze,34175,34,21,39,6,61,15,82,60
12267,Mudaison,34176,34,248,656,235,805,581,1621,904
12268,Murles,34177,34,12,53,6,104,47,157,65
12269,Murviel-lès-Béziers,34178,34,409,737,281,866,640,1787,1146
12270,Murviel-lès-Montpellier,34179,34,124,582,116,561,459,1136,706
12271,Nébian,34180,34,161,361,68,465,314,847,522
12272,Neffiès,34181,34,173,255,54,361,159,574,428
12273,Nézignan-l'Évêque,34182,34,234,474,136,545,284,965,708
12274,Nissan-lez-Enserune,34183,34,637,901,342,1159,688,2189,1538
12275,Nizas,34184,34,88,140,65,225,125,415,228
12276,Notre-Dame-de-Londres,34185,34,61,98,29,158,82,269,159
12277,Octon,34186,34,87,96,16,136,100,252,183
12278,Olargues,34187,34,92,147,57,202,106,365,239
12279,Olmet-et-Villecun,34188,34,40,17,9,34,19,62,57
12280,Olonzac,34189,34,305,345,155,615,305,1075,650
12281,Oupia,34190,34,35,40,0,116,50,166,75
12282,Pailhès,34191,34,76,103,33,183,81,297,179
12283,Palavas-les-Flots,34192,34,1094,954,585,2410,1073,4068,2048
12284,Pardailhan,34193,34,10,40,15,80,35,130,50
12285,Paulhan,34194,34,543,937,258,1290,721,2269,1480
12286,Pégairolles-de-Buèges,34195,34,16,4,0,16,8,24,20
12287,Pégairolles-de-l'Escalette,34196,34,20,17,0,47,38,85,37
12288,Péret,34197,34,95,280,75,340,205,620,375
12289,Pérols,34198,34,1446,1934,686,3275,1562,5523,3380
12290,Pézenas,34199,34,1496,1610,666,2907,1202,4775,3106
12291,Pézènes-les-Mines,34200,34,20,50,0,105,50,155,70
12292,Pierrerue,34201,34,96,36,12,104,36,152,132
12293,Pignan,34202,34,701,1516,581,2231,1161,3973,2217
12294,Pinet,34203,34,185,376,112,402,353,867,561
12295,Plaissan,34204,34,136,251,105,343,217,665,387
12296,Les Plans,34205,34,50,50,15,135,30,180,100
12297,Poilhes,34206,34,152,93,69,170,80,319,245
12298,Pomérols,34207,34,337,444,188,752,359,1299,781
12299,Popian,34208,34,36,100,20,100,80,200,136
12300,Portiragnes,34209,34,501,677,207,1216,540,1963,1178
12301,Le Pouget,34210,34,227,479,148,609,388,1145,706
12302,Le Poujol-sur-Orb,34211,34,131,222,95,372,156,623,353
12303,Poujols,34212,34,16,21,24,72,0,96,37
12304,Poussan,34213,34,528,1574,587,1894,1307,3788,2102
12305,Pouzolles,34214,34,183,225,75,383,153,611,408
12306,Pouzols,34215,34,87,234,72,291,172,535,321
12307,Le Pradal,34216,34,34,78,12,118,49,179,112
12308,Prades-le-Lez,34217,34,453,1352,394,1484,1157,3035,1805
12309,Prades-sur-Vernazobre,34218,34,56,43,16,137,29,182,99
12310,Prémian,34219,34,95,85,15,190,120,325,180
12311,Le Puech,34220,34,31,37,25,66,39,130,68
12312,Puéchabon,34221,34,38,111,20,136,119,275,149
12313,Puilacher,34222,34,17,156,39,159,111,309,173
12314,Puimisson,34223,34,164,206,70,387,146,603,370
12315,Puissalicon,34224,34,186,296,48,472,253,773,482
12316,Puisserguier,34225,34,450,589,175,1060,484,1719,1039
12317,Quarante,34226,34,223,425,180,571,295,1046,648
12318,Restinclières,34227,34,110,520,135,595,330,1060,630
12319,Rieussec,34228,34,10,20,0,35,15,50,30
12320,Riols,34229,34,110,155,15,340,135,490,265
12321,Les Rives,34230,34,24,30,15,42,16,73,54
12322,Romiguières,34231,34,0,4,8,0,4,12,4
12323,Roquebrun,34232,34,80,88,28,324,56,408,168
12324,Roqueredonde,34233,34,0,36,15,45,50,110,36
12325,Roquessels,34234,34,20,20,12,36,16,64,40
12326,Rosis,34235,34,71,48,12,100,20,132,119
12327,Rouet,34236,34,4,8,0,36,0,36,12
12328,Roujan,34237,34,402,393,178,732,258,1168,795
12329,Saint-André-de-Buèges,34238,34,6,24,6,12,12,30,30
12330,Saint-André-de-Sangonis,34239,34,622,1499,310,1711,1263,3284,2121
12331,Saint-Aunès,34240,34,272,686,266,1124,565,1955,958
12332,Saint-Bauzille-de-la-Sylve,34241,34,160,175,40,285,150,475,335
12333,Saint-Bauzille-de-Montmel,34242,34,124,276,48,332,208,588,400
12334,Saint-Bauzille-de-Putois,34243,34,221,470,157,580,434,1171,691
12335,Saint-Brès,34244,34,328,685,286,916,494,1696,1013
12336,Saint-Chinian,34245,34,355,320,90,606,263,959,675
12337,Saint-Christol,34246,34,240,291,65,465,280,810,531
12338,Saint-Clément-de-Rivière,34247,34,598,894,572,1836,558,2966,1492
12339,Sainte-Croix-de-Quintillargues,34248,34,40,240,75,235,170,480,280
12340,Saint-Drézéry,34249,34,167,616,140,838,456,1434,783
12341,Saint-Étienne-d'Albagnan,34250,34,40,64,20,132,56,208,104
12342,Saint-Étienne-de-Gourgas,34251,34,29,115,18,149,80,247,144
12343,Saint-Étienne-Estréchoux,34252,34,48,36,20,106,25,151,84
12344,Saint-Félix-de-l'Héras,34253,34,15,0,0,10,0,10,15
12345,Saint-Félix-de-Lodez,34254,34,89,294,80,368,263,711,383
12346,Saint-Gély-du-Fesc,34255,34,1111,2441,662,3589,1604,5855,3552
12347,Saint-Geniès-des-Mourgues,34256,34,180,512,120,684,344,1148,692
12348,Saint-Geniès-de-Varensal,34257,34,20,30,10,60,35,105,50
12349,Saint-Geniès-de-Fontedit,34258,34,170,355,125,520,325,970,525
12350,Saint-Georges-d'Orques,34259,34,655,1251,478,1953,867,3298,1906
12351,Saint-Gervais-sur-Mare,34260,34,110,130,45,255,165,465,240
12352,Saint-Guilhem-le-Désert,34261,34,40,50,15,105,55,175,90
12353,Saint-Guiraud,34262,34,40,25,15,95,20,130,65
12354,Saint-Hilaire-de-Beauvoir,34263,34,21,106,48,122,67,237,127
12355,Saint-Jean-de-Buèges,34264,34,30,45,15,60,30,105,75
12356,Saint-Jean-de-Cornies,34265,34,61,201,67,233,123,423,262
12357,Saint-Jean-de-Cuculles,34266,34,25,120,44,214,80,338,145
12358,Saint-Jean-de-Fos,34267,34,225,375,112,491,353,956,600
12359,Saint-Jean-de-la-Blaquière,34268,34,50,150,30,210,170,410,200
12360,Saint-Jean-de-Minervois,34269,34,32,25,4,42,24,70,57
12361,Saint-Jean-de-Védas,34270,34,1090,2038,641,3124,1481,5246,3128
12362,Saint-Julien,34271,34,32,52,0,72,64,136,84
12363,Saint-Just,34272,34,226,798,330,948,667,1945,1024
12364,Saint-Martin-de-l'Arçon,34273,34,16,12,0,71,8,79,28
12365,Saint-Martin-de-Londres,34274,34,213,637,276,807,586,1669,850
12366,Saint-Mathieu-de-Tréviers,34276,34,439,1338,420,1505,873,2798,1777
12367,Saint-Maurice-Navacelles,34277,34,28,16,12,58,13,83,44
12368,Saint-Michel,34278,34,15,0,5,25,0,30,15
12369,Saint-Nazaire-de-Ladarez,34279,34,70,75,15,120,60,195,145
12370,Saint-Nazaire-de-Pézan,34280,34,51,162,42,195,117,354,213
12371,Saint-Pargoire,34281,34,212,645,140,668,508,1316,857
12372,Saint-Paul-et-Valmalle,34282,34,57,295,62,353,253,668,352
12373,Saint-Pierre-de-la-Fage,34283,34,12,13,24,56,8,88,25
12374,Saint-Pons-de-Thomières,34284,34,405,315,105,608,220,933,720
12375,Saint-Pons-de-Mauchiens,34285,34,90,169,59,202,140,401,259
12376,Saint-Privat,34286,34,15,120,60,150,80,290,135
12377,Saint-Saturnin-de-Lucian,34287,34,13,76,15,87,77,179,89
12378,Saint-Sériès,34288,34,56,275,85,257,199,541,331
12379,Saint-Thibéry,34289,34,402,521,190,766,443,1399,923
12380,Saint-Vincent-de-Barbeyrargues,34290,34,85,130,40,268,125,433,215
12381,Saint-Vincent-d'Olargues,34291,34,57,31,22,121,53,196,88
12382,Salasc,34292,34,32,88,24,108,64,196,120
12383,La Salvetat-sur-Agout,34293,34,163,169,61,400,133,594,332
12384,Saturargues,34294,34,80,268,68,272,240,580,348
12385,Saussan,34295,34,91,365,96,579,227,902,456
12386,Saussines,34296,34,109,285,51,279,232,562,394
12387,Sauteyrargues,34297,34,48,96,36,120,64,220,144
12388,Sauvian,34298,34,658,1164,526,1744,867,3137,1822
12389,Sérignan,34299,34,1407,1317,493,2740,966,4199,2724
12390,Servian,34300,34,572,1102,377,1467,808,2652,1674
12391,Sète,34301,34,8648,8630,4292,15230,6608,26130,17278
12392,Siran,34302,34,112,112,72,264,128,464,224
12393,Sorbs,34303,34,10,5,0,25,0,25,15
12394,Soubès,34304,34,90,201,79,291,150,520,291
12395,Le Soulié,34305,34,4,24,8,64,20,92,28
12396,Soumont,34306,34,25,45,25,60,40,125,70
12397,Sussargues,34307,34,259,693,160,944,562,1666,952
12398,Taussac-la-Billière,34308,34,55,115,30,135,125,290,170
12399,Teyran,34309,34,520,1040,375,1875,745,2995,1560
12400,Thézan-lès-Béziers,34310,34,441,700,344,834,540,1718,1141
12401,Tourbes,34311,34,220,296,108,664,212,984,516
12402,La Tour-sur-Orb,34312,34,255,300,70,395,250,715,555
12403,Tressan,34313,34,86,176,20,148,134,302,262
12404,Le Triadou,34314,34,25,95,25,160,60,245,120
12405,Usclas-d'Hérault,34315,34,28,80,28,140,80,248,108
12406,Usclas-du-Bosc,34316,34,5,65,5,65,40,110,70
12407,La Vacquerie-et-Saint-Martin-de-Castries,34317,34,28,40,12,60,36,108,68
12408,Vacquières,34318,34,49,159,8,163,130,301,208
12409,Vailhan,34319,34,65,35,10,25,20,55,100
12410,Vailhauquès,34320,34,128,796,200,878,597,1675,924
12411,Valergues,34321,34,123,558,174,600,476,1250,681
12412,Valflaunès,34322,34,81,150,43,238,155,436,231
12413,Valmascle,34323,34,15,0,0,30,0,30,15
12414,Valras-Plage,34324,34,996,599,283,1790,473,2546,1595
12415,Valros,34325,34,208,396,160,472,324,956,604
12416,Vélieux,34326,34,9,15,19,38,5,62,24
12417,Vendargues,34327,34,549,1552,553,2091,1300,3944,2101
12418,Vendémian,34328,34,180,285,47,321,200,568,465
12419,Vendres,34329,34,240,660,234,835,539,1608,900
12420,Vérargues,34330,34,55,134,35,182,163,380,189
12421,Verreries-de-Moussans,34331,34,19,13,3,27,16,46,32
12422,Vias,34332,34,923,1196,504,1857,891,3252,2119
12423,Vic-la-Gardiole,34333,34,286,709,230,1061,715,2006,995
12424,Vieussan,34334,34,56,16,12,140,28,180,72
12425,Villemagne-l'Argentière,34335,34,88,80,28,188,56,272,168
12426,Villeneuve-lès-Béziers,34336,34,497,952,463,1489,807,2759,1449
12427,Villeneuve-lès-Maguelone,34337,34,849,2409,761,2916,1761,5438,3258
12428,Villeneuvette,34338,34,9,9,3,19,18,40,18
12429,Villespassans,34339,34,51,17,4,53,8,65,68
12430,Villetelle,34340,34,96,420,104,476,344,924,516
12431,Villeveyrac,34341,34,401,1126,295,1004,822,2121,1527
12432,Viols-en-Laval,34342,34,0,35,25,100,35,160,35
12433,Viols-le-Fort,34343,34,58,301,68,386,246,700,359
12434,La Grande-Motte,34344,34,2311,1080,692,3078,1262,5032,3391
12435,Acigné,35001,35,493,1749,601,2118,1311,4030,2242
12436,Amanlis,35002,35,112,496,146,529,349,1024,608
12437,Andouillé-Neuville,35003,35,33,271,81,178,212,471,304
12438,Antrain,35004,35,210,210,90,420,170,680,420
12439,Arbrissel,35005,35,8,84,25,85,49,159,92
12440,Argentré-du-Plessis,35006,35,356,1185,410,1306,890,2606,1541
12441,Aubigné,35007,35,28,178,64,68,149,281,206
12442,Availles-sur-Seiche,35008,35,30,207,50,132,135,317,237
12443,Baguer-Morvan,35009,35,230,424,84,419,323,826,654
12444,Baguer-Pican,35010,35,105,505,136,524,303,963,610
12445,Baillé,35011,35,18,62,21,112,45,178,80
12446,Bain-de-Bretagne,35012,35,833,1956,541,2298,1372,4211,2789
12447,Bains-sur-Oust,35013,35,387,900,240,1155,690,2085,1287
12448,Bais,35014,35,259,645,239,476,497,1212,904
12449,Balazé,35015,35,188,661,268,615,516,1399,849
12450,Baulon,35016,35,124,674,160,549,563,1272,798
12451,La Baussaine,35017,35,60,180,92,152,156,400,240
12452,La Bazouge-du-Désert,35018,35,172,312,92,324,224,640,484
12453,Bazouges-la-Pérouse,35019,35,264,330,100,593,335,1028,594
12454,Beaucé,35021,35,128,304,112,532,196,840,432
12455,Bécherel,35022,35,120,175,95,225,75,395,295
12456,Bédée,35023,35,353,1230,374,1184,950,2508,1583
12457,Betton,35024,35,1082,2615,1161,3566,2010,6737,3697
12458,Billé,35025,35,112,297,116,280,229,625,409
12459,Bléruais,35026,35,10,35,10,40,25,75,45
12460,Boisgervilly,35027,35,160,495,190,380,399,969,655
12461,Boistrudan,35028,35,72,208,64,176,124,364,280
12462,Bonnemain,35029,35,173,427,152,368,318,838,600
12463,La Bosse-de-Bretagne,35030,35,75,201,34,122,164,320,276
12464,La Bouëxière,35031,35,444,1166,477,1138,882,2497,1610
12465,Bourgbarré,35032,35,247,1164,328,1087,920,2335,1411
12466,Bourg-des-Comptes,35033,35,192,997,226,774,851,1851,1189
12467,La Boussac,35034,35,180,292,88,364,212,664,472
12468,Bovel,35035,35,76,196,40,80,196,316,272
12469,Bréal-sous-Montfort,35037,35,435,1585,621,1539,1420,3580,2020
12470,Bréal-sous-Vitré,35038,35,55,180,60,170,180,410,235
12471,Brécé,35039,35,90,740,200,535,530,1265,830
12472,Breteil,35040,35,274,963,283,1221,742,2246,1237
12473,Brie,35041,35,40,270,45,220,230,495,310
12474,Brielles,35042,35,76,224,72,140,204,416,300
12475,Broualan,35044,35,45,110,40,130,55,225,155
12476,Bruc-sur-Aff,35045,35,100,252,44,226,184,454,352
12477,Les Brulais,35046,35,38,147,34,154,115,303,185
12478,Bruz,35047,35,1571,4560,2839,4893,3055,10787,6131
12479,Campel,35048,35,64,128,48,148,108,304,192
12480,Cancale,35049,35,947,873,324,2042,781,3147,1820
12481,Cardroc,35050,35,44,172,32,152,148,332,216
12482,Cesson-Sévigné,35051,35,2136,3809,2846,5207,2723,10776,5945
12483,Champeaux,35052,35,38,117,57,119,102,278,155
12484,Chancé,35053,35,10,100,26,59,74,159,110
12485,Chanteloup,35054,35,120,627,176,436,426,1038,747
12486,Chantepie,35055,35,884,2623,1568,2936,2198,6702,3507
12487,La Chapelle-aux-Filtzméens,35056,35,30,305,70,250,185,505,335
12488,La Chapelle-Bouëxic,35057,35,128,439,144,212,402,758,567
12489,La Chapelle-Chaussée,35058,35,72,455,120,222,345,687,527
12490,La Chapelle-des-Fougeretz,35059,35,314,1401,434,1434,1051,2919,1715
12491,La Chapelle du Lou du Lac,35060,35,39,308,132,202,246,580,347
12492,La Chapelle-Erbrée,35061,35,44,191,81,210,141,432,235
12493,La Chapelle-Janson,35062,35,172,380,152,384,336,872,552
12494,La Chapelle-Saint-Aubert,35063,35,60,112,48,152,64,264,172
12495,La Chapelle-de-Brain,35064,35,115,175,45,280,130,455,290
12496,La Chapelle-Thouarault,35065,35,144,540,160,686,428,1274,684
12497,Chartres-de-Bretagne,35066,35,782,1672,930,2542,1252,4724,2454
12498,Chasné-sur-Illet,35067,35,53,469,151,418,341,910,522
12499,Châteaubourg,35068,35,557,1985,779,1606,1730,4115,2542
12500,Châteaugiron,35069,35,497,2267,663,2140,1696,4499,2764
12501,Châteauneuf-d'Ille-et-Vilaine,35070,35,122,484,125,332,402,859,606
12502,Le Châtellier,35071,35,34,109,41,118,80,239,143
12503,Châtillon-en-Vendelais,35072,35,248,483,168,464,344,976,731
12504,Chauvigné,35075,35,125,265,75,259,155,489,390
12505,Chavagne,35076,35,401,1004,313,1125,776,2214,1405
12506,Chelun,35077,35,12,116,24,96,92,212,128
12507,Cherrueix,35078,35,240,264,48,380,180,608,504
12508,Chevaigné,35079,35,124,599,214,657,391,1262,723
12509,Cintré,35080,35,100,717,153,665,509,1327,817
12510,Clayes,35081,35,20,247,51,219,191,461,267
12511,Coësmes,35082,35,128,481,120,356,328,804,609
12512,Coglès,35083,35,66,162,46,185,140,371,228
12513,Comblessac,35084,35,85,205,45,195,170,410,290
12514,Combourg,35085,35,859,1458,430,1857,901,3188,2317
12515,Combourtillé,35086,35,55,164,79,156,76,311,219
12516,Cornillé,35087,35,55,320,165,155,275,595,375
12517,Corps-Nuds,35088,35,255,900,298,920,722,1940,1155
12518,La Couyère,35089,35,40,136,28,160,124,312,176
12519,Crevin,35090,35,91,866,257,783,599,1639,957
12520,Le Crouais,35091,35,21,159,58,178,108,344,180
12521,Cuguen,35092,35,110,200,63,225,154,442,310
12522,Dinard,35093,35,2581,1587,693,3492,1098,5283,4168
12523,Dingé,35094,35,224,445,184,468,344,996,669
12524,Dol-de-Bretagne,35095,35,790,1173,631,1644,882,3157,1963
12525,Domagné,35096,35,194,632,291,670,405,1366,826
12526,Domalain,35097,35,154,612,208,481,394,1083,766
12527,La Dominelais,35098,35,130,415,158,328,310,796,545
12528,Domloup,35099,35,142,897,317,903,697,1917,1039
12529,Dompierre-du-Chemin,35100,35,41,156,46,150,129,325,197
12530,Dourdain,35101,35,47,383,94,248,290,632,430
12531,Drouges,35102,35,75,180,50,90,145,285,255
12532,Eancé,35103,35,22,101,42,108,76,226,123
12533,Epiniac,35104,35,145,370,140,447,315,902,515
12534,Erbrée,35105,35,134,487,166,449,351,966,621
12535,Ercé-en-Lamée,35106,35,185,415,130,475,280,885,600
12536,Ercé-près-Liffré,35107,35,134,561,162,430,372,964,695
12537,Essé,35108,35,80,390,100,306,250,656,470
12538,Étrelles,35109,35,170,695,295,790,470,1555,865
12539,Feins,35110,35,92,268,92,216,260,568,360
12540,Le Ferré,35111,35,85,170,70,240,105,415,255
12541,Fleurigné,35112,35,66,262,73,315,225,613,328
12542,La Fontenelle,35113,35,70,145,45,195,85,325,215
12543,Forges-la-Forêt,35114,35,45,61,15,67,48,130,106
12544,Fougères,35115,35,3297,4148,2420,6238,3251,11909,7445
12545,La Fresnais,35116,35,297,630,190,794,411,1395,927
12546,Gaël,35117,35,204,432,148,444,384,976,636
12547,Gahard,35118,35,72,434,55,432,350,837,506
12548,Gennes-sur-Seiche,35119,35,84,270,95,220,195,510,354
12549,Gévezé,35120,35,334,1578,624,1327,1282,3233,1912
12550,Gosné,35121,35,184,624,160,470,485,1115,808
12551,La Gouesnière,35122,35,143,551,187,443,345,975,694
12552,Goven,35123,35,295,1256,407,1170,1175,2752,1551
12553,Grand-Fougeray,35124,35,284,652,168,716,496,1380,936
12554,La Guerche-de-Bretagne,35125,35,848,1005,388,1152,698,2238,1853
12555,Guichen,35126,35,655,2329,615,2592,1742,4949,2984
12556,Guignen,35127,35,238,1189,306,938,993,2237,1427
12557,Guipel,35128,35,168,506,148,469,377,994,674
12558,Hédé-Bazouges,35130,35,172,643,244,460,494,1198,815
12559,L'Hermitage,35131,35,554,1037,387,1307,769,2463,1591
12560,Hirel,35132,35,141,355,89,408,274,771,496
12561,Iffendic,35133,35,375,1385,325,1280,1030,2635,1760
12562,Les Iffs,35134,35,24,80,12,80,68,160,104
12563,Irodouër,35135,35,192,745,100,561,543,1204,937
12564,Janzé,35136,35,985,2327,832,2305,1540,4677,3312
12565,Javené,35137,35,220,592,148,613,436,1197,812
12566,Laignelet,35138,35,104,336,84,320,232,636,440
12567,Laillé,35139,35,381,1518,350,1620,1085,3055,1899
12568,Lalleu,35140,35,52,176,68,164,136,368,228
12569,Landavran,35141,35,16,237,72,123,189,384,253
12570,Landéan,35142,35,128,332,80,456,268,804,460
12571,Landujan,35143,35,124,268,100,280,212,592,392
12572,Langan,35144,35,53,266,62,256,204,522,319
12573,Langon,35145,35,292,328,104,473,240,817,620
12574,Langouet,35146,35,39,156,58,136,149,343,195
12575,Lanhélin,35147,35,132,328,68,212,244,524,460
12576,Lanrigan,35148,35,32,56,12,20,44,76,88
12577,Lassy,35149,35,87,535,90,480,385,955,622
12578,Lécousse,35150,35,421,738,199,1242,443,1884,1159
12579,Lieuron,35151,35,50,176,49,303,145,497,226
12580,Liffré,35152,35,649,2043,659,2321,1384,4364,2692
12581,Lillemer,35153,35,5,100,40,95,80,215,105
12582,Livré-sur-Changeon,35154,35,190,535,95,340,430,865,725
12583,Lohéac,35155,35,65,165,75,210,140,425,230
12584,Longaulnay,35156,35,36,185,53,201,162,416,221
12585,Le Loroux,35157,35,95,206,50,135,170,355,301
12586,Lourmais,35159,35,36,104,24,80,72,176,140
12587,Loutehel,35160,35,39,60,60,55,40,155,99
12588,Louvigné-de-Bais,35161,35,138,505,196,488,415,1099,643
12589,Louvigné-du-Désert,35162,35,648,724,244,1199,467,1910,1372
12590,Luitré,35163,35,230,340,100,405,220,725,570
12591,Marcillé-Raoul,35164,35,48,225,65,195,179,439,273
12592,Marcillé-Robert,35165,35,124,253,92,212,192,496,377
12593,Marpiré,35166,35,35,356,165,265,250,680,391
12594,Martigné-Ferchaud,35167,35,523,520,224,870,375,1469,1043
12595,Maure-de-Bretagne,35168,35,401,982,290,899,636,1825,1383
12596,Maxent,35169,35,108,423,128,384,356,868,531
12597,Mecé,35170,35,81,165,89,129,79,297,246
12598,Médréac,35171,35,237,498,149,447,360,956,735
12599,Meillac,35172,35,140,443,186,543,384,1113,583
12600,Melesse,35173,35,466,1595,571,1855,1213,3639,2061
12601,Mellé,35174,35,69,230,60,195,130,385,299
12602,Mernel,35175,35,125,285,108,332,205,645,410
12603,Guipry-Messac,35176,35,814,1850,544,2103,1475,4122,2664
12604,La Mézière,35177,35,219,1437,495,1438,1011,2944,1656
12605,Mézières-sur-Couesnon,35178,35,85,558,103,368,481,952,643
12606,Miniac-Morvan,35179,35,354,1044,321,1219,786,2326,1398
12607,Miniac-sous-Bécherel,35180,35,56,244,48,188,204,440,300
12608,Le Minihic-sur-Rance,35181,35,205,314,55,480,244,779,519
12609,Mondevert,35183,35,40,265,95,225,195,515,305
12610,Montauban-de-Bretagne,35184,35,590,1272,533,1444,986,2963,1862
12611,Montautour,35185,35,20,80,10,65,85,160,100
12612,Mont-Dol,35186,35,170,248,66,405,152,623,418
12613,Monterfil,35187,35,105,415,75,340,345,760,520
12614,Montfort-sur-Meu,35188,35,746,1623,661,1989,1172,3822,2369
12615,Montgermont,35189,35,363,792,428,1080,559,2067,1155
12616,Monthault,35190,35,25,60,15,119,35,169,85
12617,Montours,35191,35,100,312,120,288,240,648,412
12618,Montreuil-des-Landes,35192,35,15,85,25,85,50,160,100
12619,Montreuil-le-Gast,35193,35,120,540,164,636,436,1236,660
12620,Montreuil-sous-Pérouse,35194,35,125,265,35,415,175,625,390
12621,Montreuil-sur-Ille,35195,35,178,648,189,560,565,1314,826
12622,Mordelles,35196,35,952,1754,710,2405,1280,4395,2706
12623,Mouazé,35197,35,48,378,131,384,315,830,426
12624,Moulins,35198,35,73,215,75,200,145,420,288
12625,Moussé,35199,35,12,116,20,60,112,192,128
12626,Moutiers,35200,35,40,320,110,280,195,585,360
12627,Muel,35201,35,88,264,64,216,240,520,352
12628,La Noë-Blanche,35202,35,91,263,76,287,217,580,354
12629,La Nouaye,35203,35,8,138,44,76,108,228,146
12630,Nouvoitou,35204,35,214,792,268,927,611,1806,1006
12631,Noyal-sous-Bazouges,35205,35,60,88,52,108,76,236,148
12632,Noyal-Châtillon-sur-Seiche,35206,35,570,1583,907,2466,1138,4511,2153
12633,Noyal-sur-Vilaine,35207,35,549,1450,718,1824,1000,3542,1999
12634,Orgères,35208,35,298,1111,396,1371,788,2555,1409
12635,Ossé,35209,35,50,405,75,355,305,735,455
12636,Pacé,35210,35,909,3233,1416,3265,2102,6783,4142
12637,Paimpont,35211,35,202,427,67,520,321,908,629
12638,Pancé,35212,35,90,303,88,310,270,668,393
12639,Parcé,35214,35,96,152,76,200,100,376,248
12640,Parigné,35215,35,188,408,108,316,284,708,596
12641,Parthenay-de-Bretagne,35216,35,67,537,178,397,390,965,604
12642,Le Pertre,35217,35,205,362,135,338,318,791,567
12643,Le Petit-Fougeray,35218,35,45,315,55,235,225,515,360
12644,Pipriac,35219,35,328,983,376,991,761,2128,1311
12645,Piré-sur-Seiche,35220,35,114,814,175,660,633,1468,928
12646,Pléchâtel,35221,35,232,740,256,708,604,1568,972
12647,Pleine-Fougères,35222,35,354,425,128,623,325,1076,779
12648,Plélan-le-Grand,35223,35,531,948,353,1101,695,2149,1479
12649,Plerguer,35224,35,278,686,232,752,503,1487,964
12650,Plesder,35225,35,60,210,125,190,185,500,270
12651,Pleugueneuc,35226,35,246,508,148,348,480,976,754
12652,Pleumeleuc,35227,35,182,984,319,939,702,1960,1166
12653,Pleurtuit,35228,35,889,1516,662,2002,1147,3811,2405
12654,Pocé-les-Bois,35229,35,56,392,152,356,276,784,448
12655,Poilley,35230,35,64,92,32,112,80,224,156
12656,Poligné,35231,35,29,356,107,413,212,732,385
12657,Princé,35232,35,65,95,50,70,95,215,160
12658,Québriac,35233,35,144,472,128,469,361,958,616
12659,Quédillac,35234,35,119,299,80,378,222,680,418
12660,Rannée,35235,35,134,300,99,369,163,631,434
12661,Redon,35236,35,1363,1876,736,2967,1291,4994,3239
12662,Renac,35237,35,124,237,95,230,212,537,361
12663,Rennes,35238,35,20180,45788,50334,48848,37812,136994,65968
12664,Retiers,35239,35,620,1095,351,1161,801,2313,1715
12665,Le Rheu,35240,35,726,2215,843,2306,1750,4899,2941
12666,La Richardais,35241,35,328,489,158,909,397,1464,817
12667,Rimou,35242,35,75,70,60,89,50,199,145
12668,Romagné,35243,35,183,752,189,583,551,1323,935
12669,Romazy,35244,35,41,76,25,88,41,154,117
12670,Romillé,35245,35,315,1169,371,1028,893,2292,1484
12671,Roz-Landrieux,35246,35,96,361,148,420,300,868,457
12672,Roz-sur-Couesnon,35247,35,152,212,96,376,156,628,364
12673,Sains,35248,35,78,110,30,190,99,319,188
12674,Sainte-Anne-sur-Vilaine,35249,35,188,288,64,224,228,516,476
12675,Saint-Armel,35250,35,128,493,214,546,468,1228,621
12676,Saint-Aubin-d'Aubigné,35251,35,320,1018,423,822,836,2081,1338
12677,Saint-Aubin-des-Landes,35252,35,74,230,98,305,161,564,304
12678,Saint-Aubin-du-Cormier,35253,35,260,991,396,807,712,1915,1251
12679,Saint-Aubin-du-Pavail,35254,35,20,242,74,296,146,516,262
12680,Saint-Benoît-des-Ondes,35255,35,130,238,70,390,166,626,368
12681,Saint-Briac-sur-Mer,35256,35,562,340,148,734,213,1095,902
12682,Saint-Brice-en-Coglès,35257,35,464,731,246,841,465,1552,1195
12683,Saint-Brieuc-des-Iffs,35258,35,30,130,14,128,60,202,160
12684,Saint-Broladre,35259,35,199,295,79,335,175,589,494
12685,Saint-Christophe-des-Bois,35260,35,92,156,68,156,108,332,248
12686,Saint-Christophe-de-Valains,35261,35,25,45,30,55,55,140,70
12687,Sainte-Colombe,35262,35,48,92,16,72,84,172,140
12688,Saint-Coulomb,35263,35,400,588,122,1067,374,1563,988
12689,Saint-Didier,35264,35,124,683,181,375,546,1102,807
12690,Saint-Domineuc,35265,35,240,716,224,620,620,1464,956
12691,Saint-Erblon,35266,35,304,797,310,810,510,1630,1101
12692,Saint-Étienne-en-Coglès,35267,35,145,454,185,576,374,1135,599
12693,Saint-Ganton,35268,35,85,94,12,124,59,195,179
12694,Saint-Georges-de-Chesné,35269,35,50,235,60,155,185,400,285
12695,Saint-Georges-de-Gréhaigne,35270,35,52,88,16,124,88,228,140
12696,Saint-Georges-de-Reintembault,35271,35,234,352,70,388,279,737,586
12697,Saint-Germain-du-Pinel,35272,35,87,290,95,127,251,473,377
12698,Saint-Germain-en-Coglès,35273,35,277,511,187,595,370,1152,788
12699,Saint-Germain-sur-Ille,35274,35,46,250,92,250,196,538,296
12700,Saint-Gilles,35275,35,341,1038,397,1449,806,2652,1379
12701,Saint-Gondran,35276,35,32,150,24,172,137,333,182
12702,Saint-Gonlay,35277,35,34,95,15,95,85,195,129
12703,Saint-Grégoire,35278,35,830,2396,1094,3166,1609,5869,3226
12704,Saint-Guinoux,35279,35,60,339,102,270,273,645,399
12705,Saint-Hilaire-des-Landes,35280,35,149,270,85,255,260,600,419
12706,Saint-Jacques-de-la-Lande,35281,35,911,2961,2199,2797,2828,7824,3872
12707,Saint-Jean-sur-Couesnon,35282,35,165,335,85,300,240,625,500
12708,Saint-Jean-sur-Vilaine,35283,35,37,349,65,341,288,694,386
12709,Saint-Jouan-des-Guérets,35284,35,331,559,227,993,437,1657,890
12710,Saint-Just,35285,35,145,295,55,365,205,625,440
12711,Saint-Léger-des-Prés,35286,35,20,70,25,65,70,160,90
12712,Saint-Lunaire,35287,35,501,413,129,957,236,1322,914
12713,Saint-Malo,35288,35,8667,8367,4211,16198,6241,26650,17034
12714,Saint-Malo-de-Phily,35289,35,68,348,104,236,308,648,416
12715,Saint-Malon-sur-Mel,35290,35,30,150,70,205,115,390,180
12716,Saint-Marcan,35291,35,80,100,20,184,73,277,180
12717,Saint-Marc-le-Blanc,35292,35,197,398,96,354,269,719,595
12718,Saint-Marc-sur-Couesnon,35293,35,60,134,47,181,80,308,194
12719,Sainte-Marie,35294,35,250,695,175,655,460,1290,945
12720,Saint-Maugan,35295,35,36,168,36,116,138,290,204
12721,Saint-Médard-sur-Ille,35296,35,60,414,140,328,364,832,474
12722,Saint-Méen-le-Grand,35297,35,609,1073,393,1258,755,2406,1682
12723,Saint-Méloir-des-Ondes,35299,35,459,910,434,1409,641,2484,1369
12724,Saint-M'Hervé,35300,35,168,364,144,360,328,832,532
12725,Saint-M'Hervon,35301,35,24,189,40,124,153,317,213
12726,Saint-Onen-la-Chapelle,35302,35,116,359,100,329,266,695,475
12727,Saint-Ouen-la-Rouërie,35303,35,117,190,64,256,116,436,307
12728,Saint-Ouen-des-Alleux,35304,35,110,390,85,355,335,775,500
12729,Saint-Péran,35305,35,30,134,29,90,119,238,164
12730,Saint-Père,35306,35,196,587,188,803,400,1391,783
12731,Saint-Pern,35307,35,64,280,68,252,204,524,344
12732,Saint-Pierre-de-Plesguen,35308,35,292,772,200,800,686,1686,1064
12733,Saint-Rémy-du-Plain,35309,35,55,255,55,240,225,520,310
12734,Saint-Sauveur-des-Landes,35310,35,104,405,125,300,350,775,509
12735,Saint-Séglin,35311,35,84,128,40,128,124,292,212
12736,Saint-Senoux,35312,35,144,566,116,480,495,1091,710
12737,Saint-Suliac,35314,35,170,195,30,451,75,556,365
12738,Saint-Sulpice-la-Forêt,35315,35,45,391,152,458,289,899,436
12739,Saint-Sulpice-des-Landes,35316,35,64,232,84,204,176,464,296
12740,Saint-Symphorien,35317,35,42,211,71,100,180,351,253
12741,Saint-Thual,35318,35,45,280,35,185,260,480,325
12742,Saint-Thurial,35319,35,155,655,165,623,484,1272,810
12743,Saint-Uniac,35320,35,40,158,38,187,77,302,198
12744,Saulnières,35321,35,60,216,52,228,164,444,276
12745,Le Sel-de-Bretagne,35322,35,72,349,67,180,279,526,421
12746,La Selle-en-Coglès,35323,35,88,160,60,168,144,372,248
12747,La Selle-en-Luitré,35324,35,34,178,79,177,134,390,212
12748,La Selle-Guerchaise,35325,35,10,45,0,55,40,95,55
12749,Sens-de-Bretagne,35326,35,203,775,193,585,669,1447,978
12750,Servon-sur-Vilaine,35327,35,227,973,389,1288,692,2369,1200
12751,Sixt-sur-Aff,35328,35,272,532,204,616,444,1264,804
12752,Sougéal,35329,35,104,168,52,228,104,384,272
12753,Taillis,35330,35,55,320,105,270,225,600,375
12754,Talensac,35331,35,143,697,173,950,469,1592,840
12755,Teillay,35332,35,148,319,48,288,268,604,467
12756,Le Theil-de-Bretagne,35333,35,172,532,144,444,398,986,704
12757,Thorigné-Fouillard,35334,35,553,2220,713,2613,1585,4911,2773
12758,Thourie,35335,35,57,251,58,196,166,420,308
12759,Le Tiercent,35336,35,9,24,12,79,15,106,33
12760,Tinténiac,35337,35,431,932,340,877,684,1901,1363
12761,Torcé,35338,35,82,337,138,357,203,698,419
12762,Trans-la-Forêt,35339,35,77,102,44,212,66,322,179
12763,Treffendel,35340,35,95,385,105,400,275,780,480
12764,Tremblay,35341,35,216,356,52,444,276,772,572
12765,Trémeheuc,35342,35,40,100,9,99,104,212,140
12766,Tresboeuf,35343,35,124,397,128,340,252,720,521
12767,Tressé,35344,35,12,96,46,124,60,230,108
12768,Trévérien,35345,35,95,305,45,200,240,485,400
12769,Trimer,35346,35,0,78,17,21,81,119,78
12770,Val-d'Izé,35347,35,270,738,222,739,500,1461,1008
12771,Vendel,35348,35,77,110,12,64,89,165,187
12772,Vergéal,35350,35,21,254,92,144,224,460,275
12773,Le Verger,35351,35,52,464,99,410,361,870,516
12774,Vern-sur-Seiche,35352,35,595,2008,711,3029,1358,5098,2603
12775,Vezin-le-Coquet,35353,35,612,1062,490,1322,740,2552,1674
12776,Vieux-Viel,35354,35,80,80,16,100,48,164,160
12777,Vieux-Vy-sur-Couesnon,35355,35,140,303,116,277,277,670,443
12778,Vignoc,35356,35,52,641,149,513,414,1076,693
12779,Villamée,35357,35,30,80,30,125,54,209,110
12780,La Ville-ès-Nonais,35358,35,108,332,100,328,252,680,440
12781,Visseiche,35359,35,86,235,64,192,165,421,321
12782,Vitré,35360,35,2254,4124,1786,5326,3325,10437,6378
12783,Le Vivier-sur-Mer,35361,35,147,202,64,398,151,613,349
12784,Le Tronchet,35362,35,80,292,100,324,240,664,372
12785,Pont-Péan,35363,35,251,1158,380,1294,836,2510,1409
12786,Aigurande,36001,36,412,216,85,557,151,793,628
12787,Aize,36002,36,35,20,10,45,10,65,55
12788,Ambrault,36003,36,115,250,75,300,170,545,365
12789,Anjouin,36004,36,45,85,15,115,80,210,130
12790,Ardentes,36005,36,465,894,332,1377,746,2455,1359
12791,Argenton-sur-Creuse,36006,36,984,903,442,1649,765,2856,1887
12792,Argy,36007,36,69,110,27,226,103,356,179
12793,Arpheuilles,36008,36,55,45,10,105,10,125,100
12794,Arthon,36009,36,74,348,125,450,218,793,422
12795,Azay-le-Ferron,36010,36,170,160,52,283,111,446,330
12796,Bagneux,36011,36,18,40,9,63,19,91,58
12797,Baraize,36012,36,72,40,28,144,40,212,112
12798,Baudres,36013,36,140,85,40,135,40,215,225
12799,Bazaiges,36014,36,32,36,8,108,40,156,68
12800,Beaulieu,36015,36,36,0,6,18,12,36,36
12801,Bélâbre,36016,36,211,170,45,451,100,596,381
12802,La Berthenoux,36017,36,98,75,35,155,55,245,173
12803,Le Blanc,36018,36,1401,1219,607,2168,840,3615,2620
12804,Bommiers,36019,36,35,75,25,85,75,185,110
12805,Bonneuil,36020,36,26,10,0,42,0,42,36
12806,Les Bordes,36021,36,74,225,49,254,207,510,299
12807,Bouesse,36022,36,70,100,25,83,99,207,170
12808,Bouges-le-Château,36023,36,35,45,20,135,40,195,80
12809,Bretagne,36024,36,15,55,10,25,45,80,70
12810,Briantes,36025,36,108,140,44,224,96,364,248
12811,Brion,36026,36,88,116,48,136,124,308,204
12812,Brives,36027,36,20,75,30,75,55,160,95
12813,La Buxerette,36028,36,16,8,8,60,4,72,24
12814,Buxeuil,36029,36,33,42,9,76,38,123,75
12815,Buxières-d'Aillac,36030,36,25,65,10,70,80,160,90
12816,Buzançais,36031,36,853,838,354,1447,713,2514,1691
12817,Ceaulmont,36032,36,130,175,40,235,160,435,305
12818,Celon,36033,36,45,100,25,159,85,269,145
12819,Chabris,36034,36,545,489,218,910,389,1517,1034
12820,Chaillac,36035,36,256,196,50,373,140,563,452
12821,Chalais,36036,36,25,30,10,65,25,100,55
12822,La Champenoise,36037,36,71,30,25,85,70,180,101
12823,Champillet,36038,36,25,65,25,40,35,100,90
12824,La Chapelle-Orthemale,36040,36,10,35,25,25,30,80,45
12825,La Chapelle-Saint-Laurian,36041,36,34,17,21,37,8,66,51
12826,Chasseneuil,36042,36,69,108,54,196,98,348,177
12827,Chassignolles,36043,36,85,156,15,215,110,340,241
12828,Châteauroux,36044,36,6658,9746,4963,14442,7247,26652,16404
12829,Châtillon-sur-Indre,36045,36,531,360,194,1074,270,1538,891
12830,La Châtre,36046,36,915,695,334,1394,549,2277,1610
12831,La Châtre-Langlin,36047,36,148,76,12,236,68,316,224
12832,Chavin,36048,36,45,50,12,83,45,140,95
12833,Chazelet,36049,36,34,12,3,38,9,50,46
12834,Chezelles,36050,36,37,99,33,178,75,286,136
12835,Chitray,36051,36,42,40,17,13,36,66,82
12836,Chouday,36052,36,3,35,23,30,33,86,38
12837,Ciron,36053,36,103,118,69,135,91,295,221
12838,Cléré-du-Bois,36054,36,64,45,20,109,25,154,109
12839,Clion,36055,36,260,146,71,326,111,508,406
12840,Cluis,36056,36,175,160,60,360,190,610,335
12841,Coings,36057,36,81,185,54,273,153,480,266
12842,Concremiers,36058,36,85,125,80,275,55,410,210
12843,Condé,36059,36,40,64,16,84,40,140,104
12844,Crevant,36060,36,180,115,45,290,110,445,295
12845,Crozon-sur-Vauvre,36061,36,80,40,20,155,60,235,120
12846,Cuzion,36062,36,86,45,12,211,50,273,131
12847,Déols,36063,36,1185,1515,591,2875,1194,4660,2700
12848,Diors,36064,36,39,186,83,238,118,439,225
12849,Diou,36065,36,33,37,12,83,30,125,70
12850,Douadic,36066,36,75,71,45,190,55,290,146
12851,Dunet,36067,36,44,0,0,44,8,52,44
12852,Dun-le-Poëlier,36068,36,100,80,21,150,58,229,180
12853,Écueillé,36069,36,244,213,80,512,147,739,457
12854,Éguzon-Chantôme,36070,36,405,215,30,485,155,670,620
12855,Étrechet,36071,36,148,188,53,296,154,503,336
12856,Faverolles,36072,36,93,36,16,97,42,155,129
12857,Feusines,36073,36,49,37,9,63,20,92,86
12858,Fléré-la-Rivière,36074,36,124,135,35,189,85,309,259
12859,Fontenay,36075,36,19,27,3,19,23,45,46
12860,Fontgombault,36076,36,33,24,9,60,14,83,57
12861,Fontguenand,36077,36,39,33,3,73,34,110,72
12862,Fougerolles,36078,36,30,58,18,120,71,209,88
12863,Francillon,36079,36,12,24,8,20,16,44,36
12864,Frédille,36080,36,24,8,0,20,12,32,32
12865,Gargilesse-Dampierre,36081,36,108,40,0,124,28,152,148
12866,Gehée,36082,36,90,20,15,90,40,145,110
12867,Giroux,36083,36,25,25,10,35,30,75,50
12868,Gournay,36084,36,53,82,22,67,47,136,135
12869,Guilly,36085,36,19,47,19,67,51,137,66
12870,Heugnes,36086,36,64,56,24,184,56,264,120
12871,Ingrandes,36087,36,60,56,40,112,56,208,116
12872,Issoudun,36088,36,2219,2447,1224,3889,1771,6884,4666
12873,Jeu-les-Bois,36089,36,32,96,32,128,84,244,128
12874,Jeu-Maloches,36090,36,35,20,0,60,15,75,55
12875,Lacs,36091,36,24,151,38,264,112,414,175
12876,Langé,36092,36,78,70,10,100,55,165,148
12877,Levroux,36093,36,549,529,220,1044,398,1662,1078
12878,Lignac,36094,36,131,129,27,161,73,261,260
12879,Lignerolles,36095,36,55,15,10,45,0,55,70
12880,Lingé,36096,36,25,45,10,120,35,165,70
12881,Liniez,36097,36,65,55,15,95,95,205,120
12882,Lizeray,36098,36,10,10,10,45,5,60,20
12883,Lourdoueix-Saint-Michel,36099,36,115,30,10,148,30,188,145
12884,Lourouer-Saint-Laurent,36100,36,35,60,5,95,75,175,95
12885,Luant,36101,36,97,335,130,532,256,918,432
12886,Luçay-le-Libre,36102,36,15,10,0,55,25,80,25
12887,Luçay-le-Mâle,36103,36,321,220,55,607,180,842,541
12888,Lurais,36104,36,33,38,4,102,39,145,71
12889,Lureuil,36105,36,25,40,15,100,20,135,65
12890,Luzeret,36106,36,12,40,8,53,21,82,52
12891,Lye,36107,36,190,128,55,236,116,407,318
12892,Lys-Saint-Georges,36108,36,43,38,15,95,49,159,81
12893,Le Magny,36109,36,163,228,70,369,181,620,391
12894,Maillet,36110,36,28,68,12,96,60,168,96
12895,Malicornay,36111,36,44,44,8,36,64,108,88
12896,Mâron,36112,36,84,180,88,252,148,488,264
12897,Martizay,36113,36,189,162,49,381,126,556,351
12898,Mauvières,36114,36,77,55,20,111,45,176,132
12899,Menetou-sur-Nahon,36115,36,40,20,5,45,5,55,60
12900,Ménétréols-sous-Vatan,36116,36,20,25,0,35,40,75,45
12901,Le Menoux,36117,36,82,90,12,126,77,215,172
12902,Méobecq,36118,36,39,68,29,116,48,193,107
12903,Mérigny,36119,36,136,45,12,149,35,196,181
12904,Mers-sur-Indre,36120,36,55,150,40,275,115,430,205
12905,Meunet-Planches,36121,36,30,40,15,55,40,110,70
12906,Meunet-sur-Vatan,36122,36,16,64,16,72,44,132,80
12907,Mézières-en-Brenne,36123,36,209,175,73,315,132,520,384
12908,Migné,36124,36,25,80,20,90,60,170,105
12909,Migny,36125,36,8,30,12,38,8,58,38
12910,Montchevrier,36126,36,155,70,15,160,60,235,225
12911,Montgivray,36127,36,315,292,95,681,206,982,607
12912,Montierchaume,36128,36,195,362,107,582,281,970,557
12913,Montipouret,36129,36,82,128,20,155,124,299,210
12914,Montlevicq,36130,36,18,16,0,50,4,54,34
12915,Mosnay,36131,36,92,124,36,128,100,264,216
12916,La Motte-Feuilly,36132,36,0,13,6,12,3,21,13
12917,Mouhers,36133,36,30,40,10,105,40,155,70
12918,Mouhet,36134,36,140,88,36,180,64,280,228
12919,Moulins-sur-Céphons,36135,36,100,61,10,85,45,140,161
12920,Murs,36136,36,15,18,6,50,15,71,33
12921,Néons-sur-Creuse,36137,36,84,76,36,160,40,236,160
12922,Néret,36138,36,30,26,35,75,25,135,56
12923,Neuillay-les-Bois,36139,36,99,159,29,212,117,358,258
12924,Neuvy-Pailloux,36140,36,150,270,100,395,280,775,420
12925,Neuvy-Saint-Sépulchre,36141,36,359,355,120,554,270,944,714
12926,Niherne,36142,36,209,335,132,559,229,920,544
12927,Nohant-Vic,36143,36,70,95,25,190,65,280,165
12928,Nuret-le-Ferron,36144,36,24,80,24,92,80,196,104
12929,Obterre,36145,36,41,21,5,104,20,129,62
12930,Orsennes,36146,36,200,135,50,250,105,405,335
12931,Orville,36147,36,24,25,5,60,30,95,49
12932,Oulches,36148,36,44,77,21,168,53,242,121
12933,Palluau-sur-Indre,36149,36,132,156,20,284,168,472,288
12934,Parnac,36150,36,165,60,25,200,40,265,225
12935,Paudy,36152,36,72,132,44,104,132,280,204
12936,Paulnay,36153,36,45,51,15,165,57,237,96
12937,Le Pêchereau,36154,36,303,398,66,730,290,1086,701
12938,Pellevoisin,36155,36,170,125,35,260,95,390,295
12939,Pérassay,36156,36,85,25,20,145,40,205,110
12940,La Pérouille,36157,36,44,124,40,120,112,272,168
12941,Badecon-le-Pin,36158,36,123,118,36,228,91,355,241
12942,Le Poinçonnet,36159,36,639,1372,317,2498,1000,3815,2011
12943,Pommiers,36160,36,84,48,28,96,36,160,132
12944,Le Pont-Chrétien-Chabenet,36161,36,172,224,76,296,168,540,396
12945,Poulaines,36162,36,180,156,80,336,148,564,336
12946,Pouligny-Notre-Dame,36163,36,96,119,55,193,89,337,215
12947,Pouligny-Saint-Martin,36164,36,60,55,5,75,45,125,115
12948,Pouligny-Saint-Pierre,36165,36,159,270,110,398,175,683,429
12949,Préaux,36166,36,55,20,5,55,15,75,75
12950,Preuilly-la-Ville,36167,36,40,35,5,65,20,90,75
12951,Prissac,36168,36,139,97,38,240,71,349,236
12952,Pruniers,36169,36,61,147,30,172,116,318,208
12953,Reboursin,36170,36,15,15,20,55,0,75,30
12954,Reuilly,36171,36,353,472,130,641,449,1220,825
12955,Rivarennes,36172,36,95,115,45,220,95,360,210
12956,Rosnay,36173,36,74,98,32,178,68,278,172
12957,Roussines,36174,36,65,57,16,135,46,197,122
12958,Rouvres-les-Bois,36175,36,81,43,15,105,20,140,124
12959,Ruffec,36176,36,80,120,50,225,100,375,200
12960,Sacierges-Saint-Martin,36177,36,70,40,20,144,30,194,110
12961,Saint-Aigny,36178,36,45,50,35,135,40,210,95
12962,Saint-Aoustrille,36179,36,4,48,24,68,60,152,52
12963,Saint-Août,36180,36,145,160,50,295,200,545,305
12964,Saint-Aubin,36181,36,5,50,15,70,55,140,55
12965,Saint-Benoît-du-Sault,36182,36,155,125,45,240,50,335,280
12966,Saint-Chartier,36184,36,50,107,25,239,95,359,157
12967,Saint-Christophe-en-Bazelle,36185,36,76,80,24,136,72,232,156
12968,Saint-Christophe-en-Boucherie,36186,36,51,41,16,73,20,109,92
12969,Saint-Civran,36187,36,42,20,0,68,5,73,62
12970,Saint-Cyran-du-Jambot,36188,36,45,40,20,40,30,90,85
12971,Saint-Denis-de-Jouhet,36189,36,195,179,50,343,208,601,374
12972,Sainte-Fauste,36190,36,35,92,10,90,78,178,127
12973,Saint-Florentin,36191,36,68,138,16,174,122,312,206
12974,Saint-Gaultier,36192,36,307,304,122,560,211,893,611
12975,Sainte-Gemme,36193,36,48,52,20,76,56,152,100
12976,Saint-Genou,36194,36,174,205,90,352,160,602,379
12977,Saint-Georges-sur-Arnon,36195,36,26,121,68,176,113,357,147
12978,Saint-Gilles,36196,36,15,20,0,55,10,65,35
12979,Saint-Hilaire-sur-Benaize,36197,36,57,37,42,119,52,213,94
12980,Saint-Lactencin,36198,36,55,110,30,120,105,255,165
12981,Sainte-Lizaigne,36199,36,116,248,96,500,232,828,364
12982,Saint-Marcel,36200,36,370,260,75,580,230,885,630
12983,Saint-Maur,36202,36,343,672,194,1090,638,1922,1015
12984,Saint-Médard,36203,36,4,4,0,8,16,24,8
12985,Saint-Michel-en-Brenne,36204,36,47,48,21,109,41,171,95
12986,Saint-Pierre-de-Jards,36205,36,55,26,0,25,18,43,81
12987,Saint-Pierre-de-Lamps,36206,36,12,8,8,8,8,24,20
12988,Saint-Plantaire,36207,36,148,84,24,264,36,324,232
12989,Sainte-Sévère-sur-Indre,36208,36,146,110,50,325,85,460,256
12990,Saint-Valentin,36209,36,55,55,15,130,20,165,110
12991,Sarzay,36210,36,45,69,9,104,57,170,114
12992,Sassierges-Saint-Germain,36211,36,50,135,35,165,130,330,185
12993,Saulnay,36212,36,40,31,5,67,35,107,71
12994,Sauzelles,36213,36,65,35,5,70,50,125,100
12995,Sazeray,36214,36,57,58,21,94,32,147,115
12996,Ségry,36215,36,40,144,20,168,144,332,184
12997,Selles-sur-Nahon,36216,36,8,8,0,24,12,36,16
12998,Sembleçay,36217,36,25,10,10,30,15,55,35
12999,Sougé,36218,36,40,45,5,40,35,80,85
13000,Tendu,36219,36,90,165,65,145,180,390,255
13001,Thenay,36220,36,156,165,86,314,72,472,321
13002,Thevet-Saint-Julien,36221,36,65,65,25,146,86,257,130
13003,Thizay,36222,36,50,45,30,77,50,157,95
13004,Tilly,36223,36,30,13,3,51,19,73,43
13005,Tournon-Saint-Martin,36224,36,240,207,80,450,126,656,447
13006,Le Tranger,36225,36,28,29,6,65,9,80,57
13007,Tranzault,36226,36,92,69,12,76,58,146,161
13008,Urciers,36227,36,64,40,4,84,44,132,104
13009,Valençay,36228,36,461,366,116,981,280,1377,827
13010,Val-Fouzon,36229,36,215,228,40,339,152,531,443
13011,Vatan,36230,36,400,392,164,648,320,1132,792
13012,Velles,36231,36,112,197,90,398,127,615,309
13013,Vendoeuvres,36232,36,229,210,91,363,209,663,439
13014,La Vernelle,36233,36,100,170,80,255,110,445,270
13015,Verneuil-sur-Igneraie,36234,36,60,65,20,160,25,205,125
13016,Veuil,36235,36,50,65,10,170,65,245,115
13017,Vicq-Exemplet,36236,36,51,43,22,135,30,187,94
13018,Vicq-sur-Nahon,36237,36,166,141,40,290,100,430,307
13019,Vigoulant,36238,36,21,16,0,62,10,72,37
13020,Vigoux,36239,36,68,96,36,148,96,280,164
13021,Vijon,36240,36,45,55,10,164,45,219,100
13022,Villedieu-sur-Indre,36241,36,346,660,288,835,559,1682,1006
13023,Villegongis,36242,36,10,41,0,50,31,81,51
13024,Villegouin,36243,36,70,67,12,122,51,185,137
13025,Villentrois,36244,36,128,116,28,220,116,364,244
13026,Villiers,36246,36,20,44,28,76,40,144,64
13027,Vineuil,36247,36,130,345,80,430,235,745,475
13028,Vouillon,36248,36,9,40,19,77,53,149,49
13029,Abilly,37001,37,184,181,78,361,138,577,365
13030,Ambillou,37002,37,148,576,164,466,443,1073,724
13031,Amboise,37003,37,2054,3126,1392,3826,2255,7473,5180
13032,Anché,37004,37,83,74,18,96,82,196,157
13033,Antogny-le-Tillac,37005,37,80,124,28,168,116,312,204
13034,Artannes-sur-Indre,37006,37,165,606,295,1021,405,1721,771
13035,Assay,37007,37,22,28,3,55,25,83,50
13036,Athée-sur-Cher,37008,37,290,800,185,745,590,1520,1090
13037,Autrèche,37009,37,24,98,25,112,73,210,122
13038,Auzouer-en-Touraine,37010,37,190,580,165,635,435,1235,770
13039,Avoine,37011,37,245,410,155,620,320,1095,655
13040,Avon-les-Roches,37012,37,85,130,35,145,145,325,215
13041,Avrillé-les-Ponceaux,37013,37,70,120,25,180,80,285,190
13042,Azay-le-Rideau,37014,37,470,810,330,1080,655,2065,1280
13043,Azay-sur-Cher,37015,37,253,818,190,1141,648,1979,1071
13044,Azay-sur-Indre,37016,37,60,100,15,125,75,215,160
13045,Ballan-Miré,37018,37,924,1743,730,2869,1283,4882,2667
13046,Barrou,37019,37,95,81,40,193,70,303,176
13047,Beaulieu-lès-Loches,37020,37,296,384,156,584,364,1104,680
13048,Beaumont-la-Ronce,37021,37,112,350,60,354,290,704,462
13049,Beaumont-en-Véron,37022,37,350,520,245,1095,425,1765,870
13050,Beaumont-Village,37023,37,64,72,24,84,40,148,136
13051,Benais,37024,37,100,190,105,423,126,654,290
13052,Berthenay,37025,37,33,225,42,219,157,418,258
13053,Betz-le-Château,37026,37,151,70,31,190,55,276,221
13054,Bléré,37027,37,807,1126,429,1523,961,2913,1933
13055,Bossay-sur-Claise,37028,37,176,148,40,292,120,452,324
13056,Bossée,37029,37,30,88,5,142,80,227,118
13057,Le Boulay,37030,37,60,212,76,236,176,488,272
13058,Bourgueil,37031,37,592,847,362,1285,534,2181,1439
13059,Bournan,37032,37,20,80,25,110,35,170,100
13060,Boussay,37033,37,60,48,20,92,36,148,108
13061,Braslou,37034,37,40,44,28,114,37,179,84
13062,Braye-sous-Faye,37035,37,60,68,28,124,56,208,128
13063,Braye-sur-Maulne,37036,37,41,55,5,80,15,100,96
13064,Brèches,37037,37,28,80,40,104,48,192,108
13065,Bréhémont,37038,37,115,165,65,285,150,500,280
13066,Bridoré,37039,37,95,105,20,205,65,290,200
13067,Brizay,37040,37,15,80,20,144,40,204,95
13068,Bueil-en-Touraine,37041,37,25,75,25,85,95,205,100
13069,Candes-Saint-Martin,37042,37,25,39,6,77,31,114,64
13070,Cangey,37043,37,120,264,55,449,180,684,384
13071,La Celle-Guenand,37044,37,40,40,20,158,35,213,80
13072,La Celle-Saint-Avant,37045,37,126,236,102,380,160,642,362
13073,Céré-la-Ronde,37046,37,85,110,40,140,85,265,195
13074,Cerelles,37047,37,110,375,80,406,246,732,485
13075,Chambon,37048,37,57,49,23,109,42,174,106
13076,Chambourg-sur-Indre,37049,37,168,296,104,484,272,860,464
13077,Chambray-lès-Tours,37050,37,1415,2433,1488,3426,1900,6814,3848
13078,Champigny-sur-Veude,37051,37,164,204,48,332,132,512,368
13079,Chançay,37052,37,105,335,55,420,235,710,440
13080,Chanceaux-près-Loches,37053,37,25,40,0,50,35,85,65
13081,Chanceaux-sur-Choisille,37054,37,202,913,306,1281,710,2297,1115
13082,Channay-sur-Lathan,37055,37,90,275,50,205,205,460,365
13083,La Chapelle-aux-Naux,37056,37,55,121,39,173,96,308,176
13084,La Chapelle-Blanche-Saint-Martin,37057,37,100,200,55,190,145,390,300
13085,La Chapelle-sur-Loire,37058,37,228,373,120,495,239,854,601
13086,Charentilly,37059,37,85,353,60,420,278,758,438
13087,Chargé,37060,37,145,365,55,410,310,775,510
13088,Charnizay,37061,37,105,100,45,185,50,280,205
13089,Château-la-Vallière,37062,37,268,368,152,478,291,921,636
13090,Château-Renault,37063,37,816,1060,523,1571,875,2969,1876
13091,Chaumussay,37064,37,45,55,0,100,40,140,100
13092,Chaveignes,37065,37,155,90,20,200,90,310,245
13093,Chédigny,37066,37,92,128,64,164,112,340,220
13094,Cheillé,37067,37,208,464,140,573,366,1079,672
13095,Chemillé-sur-Dême,37068,37,93,174,44,139,176,359,267
13096,Chemillé-sur-Indrois,37069,37,27,23,15,68,28,111,50
13097,Chenonceaux,37070,37,50,65,5,160,60,225,115
13098,Chezelles,37071,37,8,16,8,59,13,80,24
13099,Chinon,37072,37,1154,1556,651,2812,1240,4703,2710
13100,Chisseaux,37073,37,152,164,28,176,128,332,316
13101,Chouzé-sur-Loire,37074,37,368,472,212,700,304,1216,840
13102,Cigogné,37075,37,28,118,68,100,64,232,146
13103,Cinais,37076,37,40,90,35,195,75,305,130
13104,Cinq-Mars-la-Pile,37077,37,382,973,252,937,794,1983,1355
13105,Ciran,37078,37,20,116,20,130,115,265,136
13106,Civray-de-Touraine,37079,37,190,490,132,634,311,1077,680
13107,Civray-sur-Esves,37080,37,25,40,10,105,15,130,65
13108,Cléré-les-Pins,37081,37,80,424,145,425,367,937,504
13109,Continvoir,37082,37,105,60,10,175,55,240,165
13110,Cormery,37083,37,200,468,204,456,350,1010,668
13111,Couesmes,37084,37,50,133,65,204,85,354,183
13112,Courçay,37085,37,65,180,70,390,130,590,245
13113,Courcelles-de-Touraine,37086,37,50,141,50,135,95,280,191
13114,Courcoué,37087,37,48,84,16,56,72,144,132
13115,Couziers,37088,37,12,32,8,60,12,80,44
13116,Cravant-les-Côteaux,37089,37,104,118,36,288,106,430,222
13117,Crissay-sur-Manse,37090,37,15,10,10,40,20,70,25
13118,La Croix-en-Touraine,37091,37,276,484,148,784,464,1396,760
13119,Crotelles,37092,37,69,188,59,144,146,349,257
13120,Crouzilles,37093,37,100,120,36,153,85,274,220
13121,Cussay,37094,37,55,110,50,260,95,405,165
13122,Dame-Marie-les-Bois,37095,37,30,120,20,98,100,218,150
13123,Dierre,37096,37,44,172,64,188,104,356,216
13124,Dolus-le-Sec,37097,37,46,200,59,178,129,366,246
13125,Draché,37098,37,62,214,45,232,126,403,276
13126,Druye,37099,37,96,252,60,191,238,489,348
13127,Épeigné-les-Bois,37100,37,54,100,64,128,72,264,154
13128,Épeigné-sur-Dême,37101,37,4,64,16,44,52,112,68
13129,Les Essards,37102,37,24,47,0,33,46,79,71
13130,Esves-le-Moutier,37103,37,40,36,8,40,32,80,76
13131,Esvres,37104,37,535,1410,445,1684,1144,3273,1945
13132,Faye-la-Vineuse,37105,37,72,51,0,101,25,126,123
13133,La Ferrière,37106,37,20,80,20,108,72,200,100
13134,Ferrière-Larçon,37107,37,40,48,12,108,21,141,88
13135,Ferrière-sur-Beaulieu,37108,37,130,200,55,265,105,425,330
13136,Fondettes,37109,37,1247,2611,768,3812,1711,6291,3858
13137,Francueil,37110,37,227,317,61,444,245,750,544
13138,Genillé,37111,37,270,355,50,621,240,911,625
13139,Gizeux,37112,37,109,75,21,114,58,193,184
13140,Le Grand-Pressigny,37113,37,194,155,105,330,150,585,349
13141,La Guerche,37114,37,55,30,10,75,20,105,85
13142,Descartes,37115,37,777,625,290,1382,474,2146,1402
13143,Les Hermites,37116,37,104,128,40,144,120,304,232
13144,Hommes,37117,37,98,259,83,210,228,521,357
13145,Huismes,37118,37,168,416,112,552,300,964,584
13146,L'Île-Bouchard,37119,37,336,272,114,542,206,862,608
13147,Ingrandes-de-Touraine,37120,37,110,150,45,165,95,305,260
13148,Jaulnay,37121,37,25,80,20,105,35,160,105
13149,Joué-lès-Tours,37122,37,5021,8877,4836,11438,6552,22826,13898
13150,Langeais,37123,37,478,1021,468,1281,878,2627,1499
13151,Larçay,37124,37,202,587,156,928,500,1584,789
13152,Lémeré,37125,37,38,144,37,167,86,290,182
13153,Lerné,37126,37,50,45,65,100,65,230,95
13154,Le Liège,37127,37,40,90,30,95,70,195,130
13155,Lignières-de-Touraine,37128,37,154,304,85,357,279,721,458
13156,Ligré,37129,37,156,232,108,408,192,708,388
13157,Ligueil,37130,37,454,395,140,675,330,1145,849
13158,Limeray,37131,37,178,328,98,350,236,684,506
13159,Loches,37132,37,1301,1160,585,2050,850,3485,2461
13160,Loché-sur-Indrois,37133,37,64,100,64,224,76,364,164
13161,Louans,37134,37,90,175,85,180,115,380,265
13162,Louestault,37135,37,12,91,44,61,60,165,103
13163,Le Louroux,37136,37,44,151,28,146,136,310,195
13164,Lublé,37137,37,28,28,12,44,32,88,56
13165,Lussault-sur-Loire,37138,37,88,160,69,303,129,501,248
13166,Luynes,37139,37,493,1281,412,1696,912,3020,1774
13167,Luzé,37140,37,45,50,5,95,50,150,95
13168,Luzillé,37141,37,106,215,107,286,192,585,321
13169,Maillé,37142,37,38,92,51,257,83,391,130
13170,Manthelan,37143,37,240,342,95,415,255,765,582
13171,Marçay,37144,37,60,113,92,132,80,304,173
13172,Marcé-sur-Esves,37145,37,55,55,10,70,45,125,110
13173,Marcilly-sur-Maulne,37146,37,40,70,15,64,58,137,110
13174,Marcilly-sur-Vienne,37147,37,92,136,20,232,60,312,228
13175,Marigny-Marmande,37148,37,79,105,37,183,107,327,184
13176,Marray,37149,37,28,137,68,112,96,276,165
13177,Mazières-de-Touraine,37150,37,95,315,110,410,340,860,410
13178,La Membrolle-sur-Choisille,37151,37,410,643,180,1013,548,1741,1053
13179,Mettray,37152,37,205,535,174,791,340,1305,740
13180,Monnaie,37153,37,288,1205,361,1274,977,2612,1493
13181,Montbazon,37154,37,484,1102,360,1435,769,2564,1586
13182,Monthodon,37155,37,52,142,61,199,104,364,194
13183,Montlouis-sur-Loire,37156,37,1241,2775,821,3527,1946,6294,4016
13184,Montrésor,37157,37,75,45,25,148,40,213,120
13185,Montreuil-en-Touraine,37158,37,37,236,44,253,163,460,273
13186,Monts,37159,37,799,2101,600,2598,1496,4694,2900
13187,Morand,37160,37,24,104,28,100,92,220,128
13188,Mosnes,37161,37,85,163,84,241,155,480,248
13189,Mouzay,37162,37,45,105,45,190,80,315,150
13190,Nazelles-Négron,37163,37,649,810,252,1296,568,2116,1459
13191,Neuil,37165,37,28,112,56,140,92,288,140
13192,Neuillé-le-Lierre,37166,37,80,269,84,180,208,472,349
13193,Neuillé-Pont-Pierre,37167,37,222,489,157,535,414,1106,711
13194,Neuilly-le-Brignon,37168,37,34,70,15,95,79,189,104
13195,Neuville-sur-Brenne,37169,37,112,232,108,268,148,524,344
13196,Neuvy-le-Roi,37170,37,145,300,60,380,180,620,445
13197,Noizay,37171,37,160,255,55,469,205,729,415
13198,Notre-Dame-d'Oé,37172,37,353,964,382,1508,666,2556,1317
13199,Nouans-les-Fontaines,37173,37,140,125,65,312,140,517,265
13200,Nouâtre,37174,37,175,180,55,273,139,467,355
13201,Nouzilly,37175,37,96,376,128,348,320,796,472
13202,Noyant-de-Touraine,37176,37,75,340,115,390,225,730,415
13203,Orbigny,37177,37,144,176,60,240,140,440,320
13204,Panzoult,37178,37,93,80,34,195,67,296,173
13205,Parçay-Meslay,37179,37,241,572,160,890,416,1466,813
13206,Parçay-sur-Vienne,37180,37,96,184,52,204,128,384,280
13207,Paulmy,37181,37,25,49,20,67,39,126,74
13208,Pernay,37182,37,112,373,108,374,259,741,485
13209,Perrusson,37183,37,192,292,67,585,206,858,484
13210,Le Petit-Pressigny,37184,37,89,75,12,95,31,138,164
13211,Pocé-sur-Cisse,37185,37,154,405,165,658,240,1063,559
13212,Pont-de-Ruan,37186,37,91,328,127,218,269,614,419
13213,Ports,37187,37,93,64,19,73,60,152,157
13214,Pouzay,37188,37,100,224,64,280,176,520,324
13215,Preuilly-sur-Claise,37189,37,239,115,40,390,105,535,354
13216,Pussigny,37190,37,35,35,10,60,30,100,70
13217,Razines,37191,37,21,48,6,79,43,128,69
13218,Reignac-sur-Indre,37192,37,158,293,95,379,172,646,451
13219,Restigné,37193,37,203,303,60,439,244,743,506
13220,Reugny,37194,37,155,448,99,526,295,920,603
13221,La Riche,37195,37,1062,2429,1905,2755,2084,6744,3491
13222,Richelieu,37196,37,380,265,104,665,172,941,645
13223,Rigny-Ussé,37197,37,113,119,30,98,99,227,232
13224,Rillé,37198,37,55,70,20,115,40,175,125
13225,Rilly-sur-Vienne,37199,37,65,94,24,136,93,253,159
13226,Rivarennes,37200,37,145,285,50,300,225,575,430
13227,Rivière,37201,37,68,172,64,328,120,512,240
13228,La Roche-Clermault,37202,37,85,110,25,205,85,315,195
13229,Rochecorbon,37203,37,453,800,187,1025,546,1758,1253
13230,Rouziers-de-Touraine,37204,37,92,349,88,348,338,774,441
13231,Saché,37205,37,118,396,100,410,276,786,514
13232,Saint-Antoine-du-Rocher,37206,37,120,475,145,523,415,1083,595
13233,Saint-Aubin-le-Dépeint,37207,37,35,90,20,105,50,175,125
13234,Saint-Avertin,37208,37,2163,3386,1164,5500,2440,9104,5549
13235,Saint-Bauld,37209,37,16,52,27,42,33,102,68
13236,Saint-Benoît-la-Forêt,37210,37,50,160,40,205,150,395,210
13237,Saint-Branchs,37211,37,232,694,235,895,523,1653,926
13238,Sainte-Catherine-de-Fierbois,37212,37,104,188,64,232,144,440,292
13239,Saint-Christophe-sur-le-Nais,37213,37,114,287,75,268,236,579,401
13240,Saint-Cyr-sur-Loire,37214,37,2783,3077,1614,5711,2382,9707,5860
13241,Saint-Épain,37216,37,195,385,100,525,325,950,580
13242,Saint-Étienne-de-Chigny,37217,37,69,445,166,497,288,951,514
13243,Saint-Flovier,37218,37,140,95,35,225,65,325,235
13244,Saint-Genouph,37219,37,72,272,69,361,230,660,344
13245,Saint-Germain-sur-Vienne,37220,37,74,65,35,170,30,235,139
13246,Saint-Hippolyte,37221,37,105,135,40,275,90,405,240
13247,Saint-Jean-Saint-Germain,37222,37,108,136,30,244,90,364,244
13248,Saint-Laurent-de-Lin,37223,37,35,75,40,120,65,225,110
13249,Saint-Laurent-en-Gâtines,37224,37,90,276,44,220,242,506,366
13250,Saint-Martin-le-Beau,37225,37,375,744,230,1108,602,1940,1119
13251,Sainte-Maure-de-Touraine,37226,37,704,963,312,1297,772,2381,1667
13252,Saint-Michel-sur-Loire,37227,37,85,160,50,208,165,423,245
13253,Saint-Nicolas-de-Bourgueil,37228,37,220,225,80,415,160,655,445
13254,Saint-Nicolas-des-Motets,37229,37,20,80,10,105,45,160,100
13255,Saint-Ouen-les-Vignes,37230,37,130,290,50,380,185,615,420
13256,Saint-Paterne-Racan,37231,37,296,392,108,536,308,952,688
13257,Saint-Patrice,37232,37,68,140,52,244,156,452,208
13258,Saint-Pierre-des-Corps,37233,37,2178,3773,1745,4651,2804,9200,5951
13259,Saint-Quentin-sur-Indrois,37234,37,75,125,35,130,120,285,200
13260,Saint-Règle,37236,37,35,155,50,200,120,370,190
13261,Saint-Roch,37237,37,55,350,75,540,250,865,405
13262,Saint-Senoch,37238,37,76,138,30,169,78,277,214
13263,Saunay,37240,37,95,172,45,150,159,354,267
13264,Savigné-sur-Lathan,37241,37,240,380,105,425,220,750,620
13265,Savigny-en-Véron,37242,37,186,404,165,439,213,817,590
13266,Savonnières,37243,37,273,803,216,1192,598,2006,1076
13267,Sazilly,37244,37,30,25,25,120,25,170,55
13268,Semblançay,37245,37,139,530,233,730,405,1368,669
13269,Sennevières,37246,37,25,30,35,60,45,140,55
13270,Sepmes,37247,37,108,169,44,238,125,407,277
13271,Seuilly,37248,37,60,95,0,160,45,205,155
13272,Sonzay,37249,37,128,400,92,484,276,852,528
13273,Sorigny,37250,37,238,647,171,734,551,1456,885
13274,Souvigné,37251,37,45,240,53,209,210,472,285
13275,Souvigny-de-Touraine,37252,37,39,103,37,83,85,205,142
13276,Sublaines,37253,37,8,48,24,68,36,128,56
13277,Tauxigny,37254,37,130,373,113,383,269,765,503
13278,Tavant,37255,37,20,38,20,117,20,157,58
13279,Theneuil,37256,37,65,60,35,110,25,170,125
13280,Thilouze,37257,37,132,448,128,440,460,1028,580
13281,Thizay,37258,37,28,76,16,112,68,196,104
13282,Tournon-Saint-Pierre,37259,37,83,76,9,150,75,234,159
13283,La Tour-Saint-Gelin,37260,37,135,100,15,220,55,290,235
13284,Tours,37261,37,17259,30054,26246,33488,23916,83650,47313
13285,Trogues,37262,37,25,70,30,140,55,225,95
13286,Truyes,37263,37,199,600,171,794,448,1413,799
13287,Vallères,37264,37,76,344,57,376,252,685,420
13288,Varennes,37265,37,16,80,8,88,48,144,96
13289,Veigné,37266,37,805,1469,426,2121,1088,3635,2274
13290,Véretz,37267,37,281,1271,325,1315,1068,2708,1552
13291,Verneuil-le-Château,37268,37,35,45,5,35,25,65,80
13292,Verneuil-sur-Indre,37269,37,100,110,30,190,65,285,210
13293,Vernou-sur-Brenne,37270,37,376,658,190,833,447,1470,1034
13294,Villaines-les-Rochers,37271,37,135,234,75,325,196,596,369
13295,Villandry,37272,37,70,328,90,337,260,687,398
13296,La Ville-aux-Dames,37273,37,668,1241,529,1778,877,3184,1909
13297,Villebourg,37274,37,36,84,36,76,68,180,120
13298,Villedômain,37275,37,30,25,0,55,5,60,55
13299,Villedômer,37276,37,145,320,106,382,277,765,465
13300,Villeloin-Coulangé,37277,37,116,124,64,184,76,324,240
13301,Villeperdue,37278,37,47,266,141,211,231,583,313
13302,Villiers-au-Bouin,37279,37,56,199,74,234,119,427,255
13303,Vou,37280,37,40,60,25,85,20,130,100
13304,Vouvray,37281,37,359,740,228,1001,641,1870,1099
13305,Yzeures-sur-Creuse,37282,37,312,264,112,560,204,876,576
13306,Les Abrets en Dauphiné,38001,38,635,1702,626,1696,1352,3674,2337
13307,Les Adrets,38002,38,80,239,86,303,216,605,319
13308,Agnin,38003,38,91,294,100,316,219,635,385
13309,L'Albenc,38004,38,84,347,120,374,215,709,431
13310,Allemond,38005,38,136,224,120,292,208,620,360
13311,Allevard,38006,38,505,1103,363,1298,824,2485,1608
13312,Ambel,38008,38,3,0,0,10,0,10,3
13313,Anjou,38009,38,115,225,110,320,170,600,340
13314,Annoisin-Chatelans,38010,38,80,175,60,220,145,425,255
13315,Anthon,38011,38,108,264,108,356,188,652,372
13316,Aoste,38012,38,260,819,283,707,660,1650,1079
13317,Apprieu,38013,38,179,929,299,1082,725,2106,1108
13318,Arandon,38014,38,46,161,24,195,130,349,207
13319,Artas,38015,38,164,484,180,540,396,1116,648
13320,Arzay,38016,38,21,62,0,71,48,119,83
13321,Assieu,38017,38,130,421,85,367,308,760,551
13322,Auberives-en-Royans,38018,38,50,115,30,120,70,220,165
13323,Auberives-sur-Varèze,38019,38,170,480,120,384,305,809,650
13324,Auris,38020,38,32,40,0,56,60,116,72
13325,Les Avenières Veyrins-Thuellin,38022,38,890,1944,829,2443,1388,4660,2834
13326,Avignonet,38023,38,15,35,35,95,10,140,50
13327,Balbins,38025,38,55,98,24,126,73,223,153
13328,La Balme-les-Grottes,38026,38,70,296,45,238,297,580,366
13329,Barraux,38027,38,130,570,75,655,425,1155,700
13330,La Bâtie-Montgascon,38029,38,163,523,101,641,342,1084,686
13331,Beaucroissant,38030,38,140,470,128,509,320,957,610
13332,Beaufin,38031,38,5,5,5,10,5,20,10
13333,Beaufort,38032,38,40,136,37,164,125,326,176
13334,Beaulieu,38033,38,65,120,95,215,115,425,185
13335,Beaurepaire,38034,38,589,1166,513,1355,870,2738,1755
13336,Beauvoir-de-Marc,38035,38,120,297,77,377,231,685,417
13337,Beauvoir-en-Royans,38036,38,12,16,4,16,28,48,28
13338,Bellegarde-Poussieu,38037,38,80,240,105,375,190,670,320
13339,Belmont,38038,38,42,189,28,131,120,279,231
13340,Bernin,38039,38,345,915,184,1164,495,1843,1260
13341,Besse,38040,38,60,0,0,50,10,60,60
13342,Bessins,38041,38,6,33,3,25,25,53,39
13343,Bévenais,38042,38,80,283,100,403,153,656,363
13344,Bilieu,38043,38,88,405,114,500,359,973,493
13345,Biol,38044,38,149,335,125,433,330,888,484
13346,Biviers,38045,38,505,510,115,860,335,1310,1015
13347,Bizonnes,38046,38,47,308,39,218,267,524,355
13348,Blandin,38047,38,8,39,12,50,18,80,47
13349,Bonnefamille,38048,38,60,270,155,415,175,745,330
13350,Bossieu,38049,38,78,53,8,72,42,122,131
13351,Le Bouchage,38050,38,52,168,60,201,119,380,220
13352,Bougé-Chambalud,38051,38,180,395,135,390,295,820,575
13353,Le Bourg-d'Oisans,38052,38,371,789,286,968,651,1905,1160
13354,Bourgoin-Jallieu,38053,38,3370,6795,3881,7262,5232,16375,10165
13355,Bouvesse-Quirieu,38054,38,162,401,114,456,324,894,563
13356,Brangues,38055,38,92,149,38,166,114,318,241
13357,Bressieux,38056,38,20,10,5,35,10,50,30
13358,Bresson,38057,38,100,165,40,280,120,440,265
13359,Brézins,38058,38,126,650,120,535,484,1139,776
13360,Brié-et-Angonnes,38059,38,466,566,176,801,365,1342,1032
13361,Brion,38060,38,32,40,4,24,40,68,72
13362,La Buisse,38061,38,215,900,285,1045,645,1975,1115
13363,La Buissière,38062,38,50,160,55,290,115,460,210
13364,Burcin,38063,38,33,106,15,160,53,228,139
13365,Cessieu,38064,38,308,733,241,912,528,1681,1041
13366,Châbons,38065,38,168,665,200,568,452,1220,833
13367,Chalon,38066,38,21,37,20,46,17,83,58
13368,Chamagnieu,38067,38,89,415,93,469,420,982,504
13369,Champagnier,38068,38,185,300,90,435,220,745,485
13370,Champier,38069,38,149,377,148,362,264,774,526
13371,Le Champ-près-Froges,38070,38,165,259,96,344,251,691,424
13372,Champ-sur-Drac,38071,38,515,735,250,1050,490,1790,1250
13373,Chanas,38072,38,282,673,196,691,515,1402,955
13374,Chantelouve,38073,38,20,10,5,30,15,50,30
13375,Chantesse,38074,38,30,90,20,110,75,205,120
13376,Chapareillan,38075,38,265,888,146,895,633,1674,1153
13377,La Chapelle-de-la-Tour,38076,38,200,470,123,629,330,1082,670
13378,La Chapelle-de-Surieu,38077,38,68,232,52,192,168,412,300
13379,La Chapelle-du-Bard,38078,38,26,154,38,178,94,310,180
13380,Charancieu,38080,38,80,208,52,216,164,432,288
13381,Charantonnay,38081,38,185,506,135,664,362,1161,691
13382,Charavines,38082,38,216,452,153,637,348,1138,668
13383,Charette,38083,38,40,162,30,153,98,281,202
13384,Charnècles,38084,38,132,384,132,608,236,976,516
13385,Charvieu-Chavagneux,38085,38,771,2531,930,2423,1896,5249,3302
13386,Chasselay,38086,38,48,101,36,112,66,214,149
13387,Chasse-sur-Rhône,38087,38,676,1688,560,1539,1186,3285,2364
13388,Chassignieu,38089,38,8,44,17,77,37,131,52
13389,Château-Bernard,38090,38,15,46,15,103,69,187,61
13390,Châteauvilain,38091,38,38,178,81,247,104,432,216
13391,Châtelus,38092,38,0,20,10,40,20,70,20
13392,Châtenay,38093,38,70,140,25,140,85,250,210
13393,Châtonnay,38094,38,225,535,214,650,414,1278,760
13394,Chatte,38095,38,382,543,177,820,387,1384,925
13395,Chavanoz,38097,38,398,1260,488,1311,930,2729,1658
13396,Chélieu,38098,38,30,195,40,245,150,435,225
13397,Chevrières,38099,38,42,184,44,261,118,423,226
13398,Le Cheylas,38100,38,180,674,272,981,495,1748,854
13399,Cheyssieu,38101,38,75,285,46,328,206,580,360
13400,Chèzeneuve,38102,38,25,159,34,149,139,322,184
13401,Chichilianne,38103,38,26,43,15,94,58,167,69
13402,Chimilin,38104,38,155,384,170,467,307,944,539
13403,Chirens,38105,38,215,600,220,845,470,1535,815
13404,Cholonge,38106,38,25,130,20,70,105,195,155
13405,Chonas-l'Amballan,38107,38,122,432,104,574,342,1020,554
13406,Choranche,38108,38,20,15,20,55,5,80,35
13407,Chozeau,38109,38,75,300,35,320,250,605,375
13408,Chuzelles,38110,38,255,475,155,785,355,1295,730
13409,Claix,38111,38,898,2009,592,2943,1265,4800,2907
13410,Clavans-en-Haut-Oisans,38112,38,37,15,0,25,17,42,52
13411,Clelles,38113,38,100,130,32,157,125,314,230
13412,Clonas-sur-Varèze,38114,38,125,376,115,628,233,976,501
13413,Saint-Martin-de-la-Cluze,38115,38,61,193,16,187,176,379,254
13414,Cognet,38116,38,5,10,0,25,5,30,15
13415,Cognin-les-Gorges,38117,38,50,145,70,250,125,445,195
13416,Colombe,38118,38,94,342,107,542,274,923,436
13417,La Combe-de-Lancey,38120,38,55,203,40,204,199,443,258
13418,Commelle,38121,38,100,265,50,259,230,539,365
13419,Corbelin,38124,38,213,528,164,776,438,1378,741
13420,Cordéac,38125,38,41,36,15,56,40,111,77
13421,Corenc,38126,38,512,974,352,1340,659,2351,1486
13422,Cornillon-en-Trièves,38127,38,20,48,16,68,28,112,68
13423,Corps,38128,38,65,85,45,155,55,255,150
13424,Corrençon-en-Vercors,38129,38,55,95,10,134,65,209,150
13425,La Côte-Saint-André,38130,38,586,1031,505,1370,845,2720,1617
13426,Les Côtes-d'Arey,38131,38,260,556,132,576,440,1148,816
13427,Les Côtes-de-Corps,38132,38,20,5,0,30,0,30,25
13428,Coublevie,38133,38,624,1146,304,1517,867,2688,1770
13429,Cour-et-Buis,38134,38,92,212,68,284,176,528,304
13430,Courtenay,38135,38,88,380,76,376,328,780,468
13431,Crachier,38136,38,48,144,36,128,120,284,192
13432,Cras,38137,38,51,137,7,110,96,213,188
13433,Crémieu,38138,38,340,870,400,1020,580,2000,1210
13434,Creys-Mépieu,38139,38,145,448,158,424,366,948,593
13435,Crolles,38140,38,655,2360,731,2928,1572,5231,3015
13436,Culin,38141,38,35,255,55,179,184,418,290
13437,Diémoz,38144,38,256,622,239,905,459,1603,878
13438,Dizimieu,38146,38,75,225,64,258,191,513,300
13439,Doissin,38147,38,76,272,48,268,219,535,348
13440,Dolomieu,38148,38,322,816,258,954,624,1836,1138
13441,Domarin,38149,38,191,389,124,507,251,882,580
13442,Domène,38150,38,908,1566,857,2069,1249,4175,2474
13443,Échirolles,38151,38,4302,9694,4199,10453,6504,21156,13996
13444,Eclose-Badinières,38152,38,117,386,159,391,261,811,503
13445,Engins,38153,38,85,125,35,185,55,275,210
13446,Entraigues,38154,38,90,35,5,75,30,110,125
13447,Entre-deux-Guiers,38155,38,234,458,105,584,274,963,692
13448,Les Éparres,38156,38,130,233,148,292,182,622,363
13449,Estrablin,38157,38,349,788,234,1286,534,2054,1137
13450,Eybens,38158,38,1073,2543,1232,3335,1737,6304,3616
13451,Eydoche,38159,38,30,185,44,149,96,289,215
13452,Eyzin-Pinet,38160,38,180,588,156,739,429,1324,768
13453,Faramans,38161,38,132,274,53,295,189,537,406
13454,Faverges-de-la-Tour,38162,38,108,326,92,480,244,816,434
13455,La Ferrière,38163,38,15,75,5,85,65,155,90
13456,La Flachère,38166,38,42,122,30,158,91,279,164
13457,Flachères,38167,38,36,148,32,148,132,312,184
13458,Fontaine,38169,38,3110,5180,2871,6322,4580,13773,8290
13459,Fontanil-Cornillon,38170,38,360,590,325,960,410,1695,950
13460,La Forteresse,38171,38,40,88,24,72,96,192,128
13461,Four,38172,38,82,338,167,464,273,904,420
13462,Le Freney-d'Oisans,38173,38,12,68,16,92,68,176,80
13463,La Frette,38174,38,100,295,74,333,223,630,395
13464,Froges,38175,38,324,872,289,1172,617,2078,1196
13465,Frontonas,38176,38,174,553,105,699,428,1232,727
13466,La Garde,38177,38,20,10,10,45,10,65,30
13467,Gières,38179,38,679,1569,1090,1659,1185,3934,2248
13468,Gillonnay,38180,38,98,255,78,431,135,644,353
13469,Goncelin,38181,38,232,488,336,732,448,1516,720
13470,Le Grand-Lemps,38182,38,268,881,266,862,604,1732,1149
13471,Granieu,38183,38,32,156,44,144,96,284,188
13472,Grenay,38184,38,64,460,212,470,314,996,524
13473,Grenoble,38185,38,18190,34977,36287,36225,32123,104635,53167
13474,Gresse-en-Vercors,38186,38,36,80,26,173,49,248,116
13475,Le Gua,38187,38,198,450,133,636,306,1075,648
13476,Herbeys,38188,38,240,315,100,484,224,808,555
13477,Heyrieux,38189,38,426,1226,382,1567,867,2816,1652
13478,Hières-sur-Amby,38190,38,112,368,204,324,240,768,480
13479,Huez,38191,38,65,327,147,421,318,886,392
13480,Hurtières,38192,38,20,35,10,65,25,100,55
13481,L'Isle-d'Abeau,38193,38,406,5878,2053,3721,3745,9519,6284
13482,Izeaux,38194,38,196,591,172,673,451,1296,787
13483,Izeron,38195,38,64,156,40,256,164,460,220
13484,Janneyrias,38197,38,118,434,190,492,363,1045,552
13485,Jarcieu,38198,38,155,240,80,325,205,610,395
13486,Jardin,38199,38,230,529,170,856,338,1364,759
13487,Jarrie,38200,38,360,907,285,1568,626,2479,1267
13488,Laffrey,38203,38,20,115,40,135,68,243,135
13489,Lalley,38204,38,45,35,30,90,10,130,80
13490,Lans-en-Vercors,38205,38,164,794,150,852,707,1709,958
13491,Laval,38206,38,77,254,69,311,204,584,331
13492,Lavaldens,38207,38,20,32,8,76,28,112,52
13493,Lavars,38208,38,44,36,8,44,28,80,80
13494,Lentiol,38209,38,20,65,15,95,50,160,85
13495,Leyrieu,38210,38,68,228,44,232,216,492,296
13496,Lieudieu,38211,38,12,78,25,124,52,201,90
13497,Livet-et-Gavet,38212,38,110,392,137,303,242,682,502
13498,Longechenal,38213,38,54,175,45,160,145,350,229
13499,Lumbin,38214,38,120,620,175,713,505,1393,740
13500,Luzinay,38215,38,182,596,195,798,366,1359,778
13501,Malleval-en-Vercors,38216,38,4,4,8,8,12,28,8
13502,Marcieu,38217,38,6,9,3,21,15,39,15
13503,Marcilloles,38218,38,99,320,60,335,220,615,419
13504,Marcollin,38219,38,80,175,50,215,110,375,255
13505,Marnans,38221,38,5,35,10,75,10,95,40
13506,Massieu,38222,38,53,179,42,283,122,447,232
13507,Maubec,38223,38,110,461,133,567,321,1021,571
13508,Mayres-Savel,38224,38,8,28,16,57,20,93,36
13509,Autrans-Méaudre en Vercors,38225,38,319,708,205,1017,561,1783,1027
13510,Mens,38226,38,253,283,67,427,193,687,536
13511,Merlas,38228,38,60,115,26,116,108,250,175
13512,Meylan,38229,38,2797,3747,1534,6136,2656,10326,6544
13513,Meyrié,38230,38,110,273,50,389,196,635,383
13514,Meyrieu-les-Étangs,38231,38,110,280,54,287,175,516,390
13515,Meyssiez,38232,38,35,157,20,214,126,360,192
13516,Miribel-Lanchâtre,38235,38,0,130,20,128,115,263,130
13517,Miribel-les-Échelles,38236,38,210,359,113,579,293,985,569
13518,Mizoën,38237,38,10,40,35,60,65,160,50
13519,Moidieu-Détourbe,38238,38,166,452,106,584,412,1102,618
13520,Moirans,38239,38,750,2138,796,2544,1588,4928,2888
13521,Moissieu-sur-Dolon,38240,38,85,155,70,245,125,440,240
13522,Monestier-d'Ambel,38241,38,10,5,0,5,5,10,15
13523,Monestier-de-Clermont,38242,38,64,443,104,380,354,838,507
13524,Le Monestier-du-Percy,38243,38,56,56,0,33,71,104,112
13525,Monsteroux-Milieu,38244,38,48,236,60,236,196,492,284
13526,Montagne,38245,38,36,76,12,112,48,172,112
13527,Montagnieu,38246,38,52,305,64,260,295,619,357
13528,Montalieu-Vercieu,38247,38,316,1052,284,852,720,1856,1368
13529,Montaud,38248,38,30,165,20,215,100,335,195
13530,Montbonnot-Saint-Martin,38249,38,571,1044,547,1715,804,3066,1615
13531,Montcarra,38250,38,34,137,38,163,90,291,171
13532,Montchaboud,38252,38,48,80,52,128,52,232,128
13533,Mont-de-Lans,38253,38,65,216,243,345,266,854,281
13534,Monteynard,38254,38,28,144,16,164,140,320,172
13535,Montfalcon,38255,38,22,22,3,24,17,44,44
13536,Montferrat,38256,38,175,415,279,518,345,1142,590
13537,Montrevel,38257,38,18,112,33,149,95,277,130
13538,Mont-Saint-Martin,38258,38,12,4,4,24,12,40,16
13539,Montseveroux,38259,38,96,233,92,320,176,588,329
13540,Moras,38260,38,36,144,20,172,116,308,180
13541,Morestel,38261,38,485,1267,266,1235,729,2230,1752
13542,Morette,38263,38,42,111,33,118,72,223,153
13543,La Morte,38264,38,25,5,15,80,15,110,30
13544,La Motte-d'Aveillans,38265,38,200,491,136,553,378,1067,691
13545,La Motte-Saint-Martin,38266,38,30,102,4,133,123,260,132
13546,Mottier,38267,38,84,185,70,213,140,423,269
13547,Le Moutaret,38268,38,47,67,8,33,70,111,114
13548,La Mure,38269,38,891,1038,445,1593,798,2836,1929
13549,La Murette,38270,38,178,546,121,699,330,1150,724
13550,Murianette,38271,38,125,238,75,319,119,513,363
13551,Murinais,38272,38,42,110,16,105,83,204,152
13552,Nantes-en-Ratier,38273,38,73,94,25,149,71,245,167
13553,Nantoin,38274,38,60,116,40,136,84,260,176
13554,Serre-Nerpol,38275,38,20,60,15,100,55,170,80
13555,Nivolas-Vermelle,38276,38,320,639,244,783,399,1426,959
13556,Notre-Dame-de-Commiers,38277,38,24,127,28,125,117,270,151
13557,Notre-Dame-de-l'Osier,38278,38,31,94,22,133,75,230,125
13558,Notre-Dame-de-Mésage,38279,38,92,304,88,458,188,734,396
13559,Notre-Dame-de-Vaulx,38280,38,50,130,40,175,120,335,180
13560,Noyarey,38281,38,232,556,212,772,380,1364,788
13561,Optevoz,38282,38,57,239,50,196,215,461,296
13562,Oris-en-Rattier,38283,38,35,15,20,40,15,75,50
13563,Ornacieux,38284,38,16,128,40,116,100,256,144
13564,Ornon,38285,38,15,30,3,45,33,81,45
13565,Oulles,38286,38,0,0,0,7,0,7,0
13566,Oyeu,38287,38,60,244,120,308,180,608,304
13567,Oytier-Saint-Oblas,38288,38,118,458,81,473,413,967,576
13568,Oz,38289,38,35,75,25,65,55,145,110
13569,Pact,38290,38,70,167,67,280,177,524,237
13570,Pajay,38291,38,155,341,120,247,190,557,496
13571,Paladru,38292,38,164,261,92,391,192,675,425
13572,Panissage,38293,38,36,112,28,148,116,292,148
13573,Panossas,38294,38,32,240,32,182,198,412,272
13574,Parmilieu,38295,38,64,167,44,224,140,408,231
13575,Le Passage,38296,38,103,175,72,277,93,442,278
13576,Passins,38297,38,152,300,137,372,147,656,452
13577,Le Péage-de-Roussillon,38298,38,955,1670,770,1770,1140,3680,2625
13578,Pellafol,38299,38,35,25,10,55,25,90,60
13579,Penol,38300,38,45,100,30,90,80,200,145
13580,Percy,38301,38,25,26,4,61,17,82,51
13581,Le Périer,38302,38,22,25,9,50,19,78,47
13582,La Pierre,38303,38,58,165,40,153,135,328,223
13583,Pierre-Châtel,38304,38,185,387,120,480,303,903,572
13584,Le Pin,38305,38,184,308,130,398,262,790,492
13585,Pinsot,38306,38,25,25,5,70,45,120,50
13586,Pisieu,38307,38,92,140,28,204,64,296,232
13587,Plan,38308,38,19,61,15,57,56,128,80
13588,Poisat,38309,38,394,467,195,719,339,1253,861
13589,Poliénas,38310,38,138,296,75,398,167,640,434
13590,Pommier-de-Beaurepaire,38311,38,55,185,60,280,110,450,240
13591,Pommiers-la-Placette,38312,38,77,129,56,175,77,308,206
13592,Ponsonnas,38313,38,56,39,12,104,26,142,95
13593,Pontcharra,38314,38,871,2073,725,2119,1431,4275,2944
13594,Le Pont-de-Beauvoisin,38315,38,347,917,409,1019,623,2051,1264
13595,Pont-de-Chéruy,38316,38,575,1449,807,1200,1053,3060,2024
13596,Le Pont-de-Claix,38317,38,1213,2943,1403,3036,2064,6503,4156
13597,Pont-Évêque,38318,38,701,1377,561,1502,982,3045,2078
13598,Pont-en-Royans,38319,38,200,140,55,290,110,455,340
13599,Porcieu-Amblagnieu,38320,38,174,482,135,553,417,1105,656
13600,Prébois,38321,38,9,39,4,78,16,98,48
13601,Presles,38322,38,15,25,5,30,15,50,40
13602,Pressins,38323,38,84,336,48,360,280,688,420
13603,Primarette,38324,38,38,192,57,236,165,458,230
13604,Proveysieux,38325,38,48,109,37,186,71,294,157
13605,Prunières,38326,38,55,100,25,145,60,230,155
13606,Quaix-en-Chartreuse,38328,38,64,291,31,295,168,494,355
13607,Quet-en-Beaumont,38329,38,12,13,8,21,8,37,25
13608,Quincieu,38330,38,12,12,24,28,20,72,24
13609,Réaumont,38331,38,65,315,45,375,195,615,380
13610,Renage,38332,38,398,964,361,1098,690,2149,1362
13611,Rencurel,38333,38,28,49,20,100,51,171,77
13612,Revel,38334,38,70,371,130,506,257,893,441
13613,Revel-Tourdan,38335,38,147,249,43,322,184,549,396
13614,Reventin-Vaugris,38336,38,235,455,140,675,295,1110,690
13615,Rives,38337,38,725,1541,674,1755,1134,3563,2266
13616,La Rivière,38338,38,60,280,28,156,255,439,340
13617,Roche,38339,38,127,570,122,670,339,1131,697
13618,Les Roches-de-Condrieu,38340,38,256,516,211,579,428,1218,772
13619,Rochetoirin,38341,38,48,263,91,522,127,740,311
13620,Roissard,38342,38,15,75,30,85,70,185,90
13621,Romagnieu,38343,38,123,385,124,584,273,981,508
13622,Roussillon,38344,38,1236,2264,687,2300,1575,4562,3500
13623,Rovon,38345,38,8,160,60,284,84,428,168
13624,Royas,38346,38,28,124,40,80,112,232,152
13625,Roybon,38347,38,152,209,106,424,129,659,361
13626,Ruy-Montceau,38348,38,532,1112,287,1570,783,2640,1644
13627,Sablons,38349,38,239,502,322,621,387,1330,741
13628,Sainte-Agnès,38350,38,35,145,35,198,140,373,180
13629,Saint-Agnin-sur-Bion,38351,38,84,263,56,291,230,577,347
13630,Saint-Alban-de-Roche,38352,38,229,485,145,690,375,1210,714
13631,Saint-Alban-du-Rhône,38353,38,100,240,45,345,135,525,340
13632,Saint-Albin-de-Vaulserre,38354,38,47,83,31,116,81,228,130
13633,Saint-Andéol,38355,38,17,19,9,43,12,64,36
13634,Saint-André-en-Royans,38356,38,50,60,35,110,70,215,110
13635,Saint-André-le-Gaz,38357,38,265,830,195,813,568,1576,1095
13636,Sainte-Anne-sur-Gervonde,38358,38,51,214,34,165,136,335,265
13637,Saint Antoine l'Abbaye,38359,38,208,281,51,403,196,650,489
13638,Saint-Appolinard,38360,38,51,96,26,97,82,205,147
13639,Saint-Arey,38361,38,15,30,0,20,20,40,45
13640,Saint-Aupre,38362,38,114,315,60,395,205,660,429
13641,Saint-Barthélemy,38363,38,85,233,106,341,160,607,318
13642,Saint-Barthélemy-de-Séchilienne,38364,38,55,127,5,113,130,248,182
13643,Saint-Baudille-de-la-Tour,38365,38,48,240,40,244,212,496,288
13644,Saint-Baudille-et-Pipet,38366,38,50,65,10,85,55,150,115
13645,Saint-Bernard,38367,38,45,195,45,210,125,380,240
13646,Saint-Blaise-du-Buis,38368,38,87,294,31,364,182,577,381
13647,Sainte-Blandine,38369,38,138,266,44,279,217,540,404
13648,Saint-Bonnet-de-Chavagne,38370,38,80,185,40,190,140,370,265
13649,Saint-Bueil,38372,38,65,173,45,243,125,413,238
13650,Saint-Cassien,38373,38,175,255,115,400,190,705,430
13651,Saint-Chef,38374,38,209,964,234,1203,789,2226,1173
13652,Saint-Christophe-en-Oisans,38375,38,30,0,5,55,5,65,30
13653,Saint-Christophe-sur-Guiers,38376,38,76,264,72,220,256,548,340
13654,Saint-Clair-de-la-Tour,38377,38,402,927,316,944,692,1952,1329
13655,Saint-Clair-du-Rhône,38378,38,541,1043,345,1248,699,2292,1584
13656,Saint-Clair-sur-Galaure,38379,38,30,70,22,80,42,144,100
13657,Saint-Didier-de-Bizonnes,38380,38,30,115,25,85,65,175,145
13658,Saint-Didier-de-la-Tour,38381,38,158,563,143,599,428,1170,721
13659,Saint-Égrève,38382,38,1973,3836,1429,4816,2968,9213,5809
13660,Saint-Étienne-de-Crossey,38383,38,241,626,140,1096,395,1631,867
13661,Saint-Étienne-de-Saint-Geoirs,38384,38,286,847,382,882,640,1904,1133
13662,Saint-Geoire-en-Valdaine,38386,38,228,592,248,680,420,1348,820
13663,Saint-Geoirs,38387,38,65,148,35,155,113,303,213
13664,Saint-Georges-de-Commiers,38388,38,168,534,159,866,398,1423,702
13665,Saint-Georges-d'Espéranche,38389,38,350,850,368,1080,625,2073,1200
13666,Saint-Gervais,38390,38,28,188,32,140,160,332,216
13667,Saint-Guillaume,38391,38,65,45,15,105,20,140,110
13668,Saint-Hilaire-de-Brens,38392,38,56,133,34,158,156,348,189
13669,Saint-Hilaire-de-la-Côte,38393,38,160,360,120,476,292,888,520
13670,Saint-Hilaire-du-Rosier,38394,38,264,508,160,560,424,1144,772
13671,Saint-Hilaire,38395,38,64,445,65,344,400,809,509
13672,Saint-Honoré,38396,38,60,236,88,273,107,468,296
13673,Saint-Ismier,38397,38,1044,1515,488,2432,989,3909,2559
13674,Saint-Jean-d'Avelanne,38398,38,99,292,70,255,163,488,391
13675,Saint-Jean-de-Bournay,38399,38,658,981,404,1438,856,2698,1639
13676,Saint-Jean-de-Moirans,38400,38,203,946,331,1057,731,2119,1149
13677,Saint-Jean-de-Soudain,38401,38,154,442,138,349,374,861,596
13678,Saint-Jean-de-Vaulx,38402,38,30,115,34,237,129,400,145
13679,Saint-Jean-d'Hérans,38403,38,40,56,19,98,48,165,96
13680,Saint-Jean-le-Vieux,38404,38,8,62,37,85,43,165,70
13681,Saint-Joseph-de-Rivière,38405,38,99,325,100,385,284,769,424
13682,Saint-Julien-de-l'Herms,38406,38,12,31,8,44,16,68,43
13683,Saint-Julien-de-Raz,38407,38,53,97,17,150,70,237,150
13684,Saint-Just-Chaleyssin,38408,38,220,684,179,787,517,1483,904
13685,Saint-Just-de-Claix,38409,38,125,325,130,380,220,730,450
13686,Saint-Lattier,38410,38,160,352,92,468,248,808,512
13687,Saint-Laurent-du-Pont,38412,38,501,1025,401,1303,864,2568,1526
13688,Saint-Laurent-en-Beaumont,38413,38,80,130,30,130,100,260,210
13689,Sainte-Luce,38414,38,0,12,0,13,12,25,12
13690,Saint-Marcel-Bel-Accueil,38415,38,135,335,80,540,270,890,470
13691,Saint-Marcellin,38416,38,1252,1821,909,2462,1407,4778,3073
13692,Sainte-Marie-d'Alloix,38417,38,25,132,20,174,82,276,157
13693,Sainte-Marie-du-Mont,38418,38,25,70,0,70,60,130,95
13694,Saint-Martin-de-Clelles,38419,38,6,24,16,80,19,115,30
13695,Saint-Martin-de-Vaulserre,38420,38,30,65,15,85,55,155,95
13696,Saint-Martin-d'Hères,38421,38,3314,8953,7178,8513,6873,22564,12267
13697,Saint-Martin-d'Uriage,38422,38,455,1443,484,2103,935,3522,1898
13698,Saint-Martin-le-Vinoux,38423,38,536,1376,774,1609,1014,3397,1912
13699,Saint-Maurice-en-Trièves,38424,38,35,30,5,50,20,75,65
13700,Saint-Maurice-l'Exil,38425,38,567,1668,780,1717,1174,3671,2235
13701,Saint-Maximin,38426,38,84,152,44,276,68,388,236
13702,Saint-Michel-de-Saint-Geoirs,38427,38,35,90,15,95,90,200,125
13703,Saint-Michel-en-Beaumont,38428,38,3,3,3,3,9,15,6
13704,Saint-Michel-les-Portes,38429,38,27,70,16,73,52,141,97
13705,Saint-Mury-Monteymond,38430,38,11,91,31,92,83,206,102
13706,Saint-Nazaire-les-Eymes,38431,38,386,723,191,1100,473,1764,1109
13707,Saint-Nicolas-de-Macherin,38432,38,61,229,47,312,193,552,290
13708,Saint-Nizier-du-Moucherotte,38433,38,76,344,72,348,300,720,420
13709,Saint-Ondras,38434,38,22,154,33,212,126,371,176
13710,Saint-Pancrasse,38435,38,31,127,19,124,79,222,158
13711,Saint-Paul-de-Varces,38436,38,245,570,190,765,430,1385,815
13712,Saint-Paul-d'Izeaux,38437,38,36,71,28,74,39,141,107
13713,Saint-Paul-lès-Monestier,38438,38,16,60,8,102,42,152,76
13714,Crêts en Belledonne,38439,38,333,1022,237,904,799,1940,1355
13715,Saint-Pierre-de-Bressieux,38440,38,144,188,36,268,140,444,332
13716,Saint-Pierre-de-Chartreuse,38442,38,113,230,63,364,210,637,343
13717,Saint-Pierre-de-Chérennes,38443,38,25,115,20,215,80,315,140
13718,Saint-Pierre-de-Méaroz,38444,38,20,35,20,25,20,65,55
13719,Saint-Pierre-de-Mésage,38445,38,112,192,40,256,136,432,304
13720,Saint-Pierre-d'Entremont,38446,38,88,94,40,156,92,288,182
13721,Saint-Prim,38448,38,65,365,78,435,340,853,430
13722,Saint-Quentin-Fallavier,38449,38,549,1628,451,1467,1135,3053,2177
13723,Saint-Quentin-sur-Isère,38450,38,80,356,117,502,291,910,436
13724,Saint-Romain-de-Jalionas,38451,38,267,835,288,1168,635,2091,1102
13725,Saint-Romain-de-Surieu,38452,38,40,85,25,80,90,195,125
13726,Saint-Romans,38453,38,180,448,112,656,364,1132,628
13727,Saint-Sauveur,38454,38,169,508,110,569,310,989,677
13728,Saint-Savin,38455,38,407,1034,338,1318,721,2377,1441
13729,Saint-Sébastien,38456,38,20,75,0,75,75,150,95
13730,Saint-Siméon-de-Bressieux,38457,38,360,651,196,1019,551,1766,1011
13731,Saint-Sorlin-de-Morestel,38458,38,65,159,50,214,118,382,224
13732,Saint-Sorlin-de-Vienne,38459,38,70,218,34,318,182,534,288
13733,Saint-Sulpice-des-Rivoires,38460,38,45,70,40,210,60,310,115
13734,Saint-Théoffrey,38462,38,39,134,21,139,130,290,173
13735,Saint-Vérand,38463,38,179,422,115,622,306,1043,601
13736,Saint-Victor-de-Cessieu,38464,38,205,675,195,660,455,1310,880
13737,Saint-Victor-de-Morestel,38465,38,108,328,84,380,220,684,436
13738,Saint-Vincent-de-Mercuze,38466,38,163,349,67,441,273,781,512
13739,Salagnon,38467,38,129,372,90,438,273,801,501
13740,Salaise-sur-Sanne,38468,38,660,1210,352,1377,850,2579,1870
13741,La Salette-Fallavaux,38469,38,0,16,0,10,25,35,16
13742,La Salle-en-Beaumont,38470,38,70,65,5,135,50,190,135
13743,Le Sappey-en-Chartreuse,38471,38,115,340,95,369,225,689,455
13744,Sarcenas,38472,38,35,45,0,70,40,110,80
13745,Sardieu,38473,38,88,396,76,280,244,600,484
13746,Sassenage,38474,38,1220,2857,1288,3610,2465,7363,4077
13747,Satolas-et-Bonce,38475,38,118,671,238,747,494,1479,789
13748,Savas-Mépin,38476,38,74,247,71,268,168,507,321
13749,Séchilienne,38478,38,70,279,71,316,189,576,349
13750,Semons,38479,38,37,107,35,97,58,190,144
13751,Septème,38480,38,144,545,200,687,369,1256,689
13752,Sérézin-de-la-Tour,38481,38,73,336,53,238,268,559,409
13753,Sermérieu,38483,38,143,399,125,549,310,984,542
13754,Serpaize,38484,38,104,507,136,509,407,1052,611
13755,Seyssinet-Pariset,38485,38,1502,2777,1513,3822,2265,7600,4279
13756,Seyssins,38486,38,1155,1698,390,2414,1155,3959,2853
13757,Seyssuel,38487,38,234,524,159,608,367,1134,758
13758,Siccieu-Saint-Julien-et-Carisieu,38488,38,38,155,55,220,98,373,193
13759,Siévoz,38489,38,10,20,0,65,20,85,30
13760,Sillans,38490,38,135,521,139,635,383,1157,656
13761,Sinard,38492,38,12,197,44,182,143,369,209
13762,Soleymieu,38494,38,60,228,40,192,200,432,288
13763,La Sône,38495,38,78,91,38,192,97,327,169
13764,Sonnay,38496,38,131,333,80,408,226,714,464
13765,Sousville,38497,38,25,5,10,90,5,105,30
13766,Succieu,38498,38,30,193,61,245,150,456,223
13767,Susville,38499,38,130,345,100,385,305,790,475
13768,Têche,38500,38,55,130,50,215,120,385,185
13769,Tencin,38501,38,115,604,266,413,549,1228,719
13770,La Terrasse,38503,38,228,673,225,857,416,1498,901
13771,Theys,38504,38,210,510,145,665,420,1230,720
13772,Thodure,38505,38,110,159,79,198,123,400,269
13773,Tignieu-Jameyzieu,38507,38,687,1960,711,1887,1451,4049,2647
13774,Torchefelon,38508,38,41,228,21,192,168,381,269
13775,La Tour-du-Pin,38509,38,964,2079,1112,2017,1485,4614,3043
13776,Le Touvet,38511,38,283,909,234,974,653,1861,1192
13777,Tramolé,38512,38,66,196,20,204,129,353,262
13778,Treffort,38513,38,12,104,8,68,59,135,116
13779,Tréminis,38514,38,35,40,5,70,35,110,75
13780,Trept,38515,38,172,528,158,610,404,1172,700
13781,La Tronche,38516,38,669,1377,1016,1743,1010,3769,2046
13782,Tullins,38517,38,875,2002,809,2284,1314,4407,2877
13783,Valbonnais,38518,38,100,95,30,155,105,290,195
13784,Valencin,38519,38,125,776,208,847,628,1683,901
13785,Valencogne,38520,38,88,195,37,159,120,316,283
13786,La Valette,38521,38,12,20,0,24,16,40,32
13787,Valjouffrey,38522,38,20,20,10,77,10,97,40
13788,Varacieux,38523,38,104,244,80,264,164,508,348
13789,Varces-Allières-et-Risset,38524,38,563,1782,634,2179,1241,4054,2345
13790,Vasselin,38525,38,35,125,60,160,80,300,160
13791,Vatilieu,38526,38,60,88,36,100,72,208,148
13792,Vaujany,38527,38,43,57,18,69,65,152,100
13793,Vaulnaveys-le-Bas,38528,38,136,304,76,436,236,748,440
13794,Vaulnaveys-le-Haut,38529,38,414,910,282,1214,749,2245,1324
13795,Vaulx-Milieu,38530,38,115,698,205,815,559,1579,813
13796,Velanne,38531,38,36,112,52,220,92,364,148
13797,Vénérieu,38532,38,20,226,80,252,136,468,246
13798,Venon,38533,38,125,145,70,270,100,440,270
13799,Vénosc,38534,38,65,150,120,275,144,539,215
13800,Vernas,38535,38,12,56,48,100,36,184,68
13801,Vernioz,38536,38,179,290,108,445,190,743,469
13802,La Verpillière,38537,38,555,1877,817,1928,1484,4229,2432
13803,Le Versoud,38538,38,439,1266,411,1460,985,2856,1705
13804,Vertrieu,38539,38,64,192,56,176,160,392,256
13805,Veurey-Voroize,38540,38,205,395,165,445,235,845,600
13806,Veyssilieu,38542,38,4,90,8,120,46,174,94
13807,Vézeronce-Curtin,38543,38,207,586,155,625,421,1201,793
13808,Vienne,38544,38,3973,6944,3625,8225,5630,17480,10917
13809,Vif,38545,38,771,2208,715,2644,1565,4924,2979
13810,Vignieu,38546,38,110,260,110,315,190,615,370
13811,Villard-Bonnot,38547,38,890,1861,767,2221,1402,4390,2751
13812,Villard-de-Lans,38548,38,533,1032,294,1534,638,2466,1565
13813,Villard-Notre-Dame,38549,38,3,7,6,12,0,18,10
13814,Villard-Reculas,38550,38,6,3,6,23,6,35,9
13815,Villard-Reymond,38551,38,4,4,0,16,12,28,8
13816,Villard-Saint-Christophe,38552,38,80,110,30,115,70,215,190
13817,Villefontaine,38553,38,768,6337,2151,4877,4202,11230,7105
13818,Villemoirieu,38554,38,168,555,129,598,395,1122,723
13819,Villeneuve-de-Marc,38555,38,145,275,95,415,200,710,420
13820,Ville-sous-Anjou,38556,38,208,267,59,383,205,647,475
13821,Villette-d'Anthon,38557,38,291,1264,400,1775,894,3069,1555
13822,Villette-de-Vienne,38558,38,136,526,128,534,392,1054,662
13823,Vinay,38559,38,567,933,382,1121,892,2395,1500
13824,Virieu,38560,38,106,235,89,300,157,546,341
13825,Viriville,38561,38,160,460,110,535,355,1000,620
13826,Vizille,38562,38,1017,1729,882,2179,1562,4623,2746
13827,Voiron,38563,38,3157,4720,2272,6035,3557,11864,7877
13828,Voissant,38564,38,50,40,10,69,54,133,90
13829,Voreppe,38565,38,1095,2259,964,3332,1553,5849,3354
13830,Vourey,38566,38,143,390,164,613,269,1046,533
13831,Chamrousse,38567,38,16,95,44,149,117,310,111
13832,Abergement-la-Ronce,39001,39,108,244,49,222,143,414,352
13833,Abergement-le-Grand,39002,39,8,8,4,24,12,40,16
13834,Abergement-le-Petit,39003,39,0,0,6,6,6,18,0
13835,Abergement-lès-Thésy,39004,39,5,20,0,25,5,30,25
13836,Aiglepierre,39006,39,29,112,12,130,74,216,141
13837,Alièze,39007,39,6,35,6,46,29,81,41
13838,Amange,39008,39,36,112,52,120,68,240,148
13839,Andelot-en-Montagne,39009,39,70,135,50,205,85,340,205
13840,Andelot-Morval,39010,39,8,12,8,36,8,52,20
13841,Annoire,39011,39,48,72,61,113,53,227,120
13842,Arbois,39013,39,677,539,337,1105,447,1889,1216
13843,Archelange,39014,39,16,41,19,65,43,127,57
13844,Ardon,39015,39,25,20,5,55,15,75,45
13845,Arinthod,39016,39,174,240,70,365,157,592,414
13846,Arlay,39017,39,121,285,123,450,222,795,406
13847,Aromas,39018,39,30,121,31,143,61,235,151
13848,Les Arsures,39019,39,4,64,12,104,48,164,68
13849,Arsure-Arsurette,39020,39,21,18,16,24,8,48,39
13850,La Chailleuse,39021,39,99,113,42,171,137,350,212
13851,Asnans-Beauvoisin,39022,39,120,152,72,252,120,444,272
13852,L'Aubépin,39023,39,20,32,4,44,28,76,52
13853,Audelange,39024,39,20,55,30,125,45,200,75
13854,Augea,39025,39,37,50,25,77,56,158,87
13855,Augerans,39026,39,32,32,32,40,40,112,64
13856,Augisey,39027,39,36,72,16,68,48,132,108
13857,Aumont,39028,39,90,91,4,77,127,208,181
13858,Aumur,39029,39,48,80,36,136,64,236,128
13859,Authume,39030,39,95,180,60,315,177,552,275
13860,Auxange,39031,39,35,45,35,55,30,120,80
13861,Avignon-lès-Saint-Claude,39032,39,50,105,10,120,75,205,155
13862,Balaiseaux,39034,39,20,76,32,88,56,176,96
13863,Balanod,39035,39,44,100,52,68,88,208,144
13864,La Balme-d'Épy,39036,39,8,12,0,21,12,33,20
13865,Bans,39037,39,12,59,9,47,33,89,71
13866,Barésia-sur-l'Ain,39038,39,20,44,12,24,44,80,64
13867,La Barre,39039,39,15,55,25,100,30,155,70
13868,Barretaine,39040,39,16,24,9,65,32,106,40
13869,Baume-les-Messieurs,39041,39,48,16,24,64,24,112,64
13870,Baverans,39042,39,52,147,24,149,119,292,199
13871,Beaufort,39043,39,170,282,104,265,224,593,452
13872,Beffia,39045,39,6,22,0,15,12,27,28
13873,Bellecombe,39046,39,0,10,5,35,15,55,10
13874,Bellefontaine,39047,39,88,111,33,172,79,284,199
13875,Belmont,39048,39,15,65,5,126,65,196,80
13876,Bersaillin,39049,39,64,96,20,132,76,228,160
13877,Besain,39050,39,12,25,16,78,16,110,37
13878,Biarne,39051,39,25,105,20,165,75,260,130
13879,Bief-des-Maisons,39052,39,10,15,0,40,5,45,25
13880,Bief-du-Fourg,39053,39,20,47,21,33,28,82,67
13881,Biefmorin,39054,39,4,20,0,20,20,40,24
13882,Billecul,39055,39,8,8,0,20,0,20,16
13883,Bletterans,39056,39,315,305,105,415,245,765,620
13884,Blois-sur-Seille,39057,39,24,28,8,40,24,72,52
13885,Blye,39058,39,16,40,4,60,36,100,56
13886,Bois-d'Amont,39059,39,176,433,172,464,392,1028,609
13887,Bois-de-Gand,39060,39,30,10,0,15,10,25,40
13888,Boissia,39061,39,20,40,16,28,16,60,60
13889,La Boissière,39062,39,12,8,0,32,8,40,20
13890,Bonlieu,39063,39,55,75,20,80,30,130,130
13891,Bonnaud,39064,39,10,5,0,20,5,25,15
13892,Bonnefontaine,39065,39,12,32,0,36,24,60,44
13893,Bornay,39066,39,9,43,6,56,29,91,52
13894,Les Bouchoux,39068,39,28,73,8,94,74,176,101
13895,Bourcia,39069,39,12,25,8,48,8,64,37
13896,Bourg-de-Sirod,39070,39,12,32,4,32,24,60,44
13897,Bracon,39072,39,22,36,15,143,19,177,58
13898,Brainans,39073,39,32,24,4,68,24,96,56
13899,Brans,39074,39,35,60,20,55,70,145,95
13900,Bréry,39075,39,29,45,4,77,30,111,74
13901,La Bretenière,39076,39,24,56,32,36,64,132,80
13902,Bretenières,39077,39,0,10,0,30,0,30,10
13903,Brevans,39078,39,72,128,60,264,108,432,200
13904,Briod,39079,39,4,40,16,96,44,156,44
13905,Broissia,39080,39,4,21,0,21,16,37,25
13906,Buvilly,39081,39,32,96,24,160,64,248,128
13907,Censeau,39083,39,40,85,45,75,55,175,125
13908,Cernans,39084,39,20,35,5,50,20,75,55
13909,Cerniébaud,39085,39,0,20,8,20,20,48,20
13910,Cernon,39086,39,30,65,30,90,30,150,95
13911,Cesancey,39088,39,10,94,18,155,78,251,104
13912,Cézia,39089,39,8,16,0,36,4,40,24
13913,Chaînée-des-Coupis,39090,39,15,65,15,55,45,115,80
13914,Les Chalesmes,39091,39,10,25,10,45,5,60,35
13915,Chambéria,39092,39,13,29,12,60,29,101,42
13916,Chamblay,39093,39,43,76,22,108,58,188,119
13917,Chamole,39094,39,15,40,15,70,30,115,55
13918,Champagne-sur-Loue,39095,39,3,27,3,40,34,77,30
13919,Champagney,39096,39,30,190,55,88,133,276,220
13920,Champagnole,39097,39,1475,1545,719,2685,1165,4569,3020
13921,Champdivers,39099,39,45,90,80,150,70,300,135
13922,Champrougier,39100,39,3,20,3,42,15,60,23
13923,Champvans,39101,39,229,322,162,385,222,769,551
13924,Chancia,39102,39,12,51,23,66,33,122,63
13925,La Chapelle-sur-Furieuse,39103,39,24,108,4,108,88,200,132
13926,Chapelle-Voland,39104,39,134,122,25,194,87,306,256
13927,Chapois,39105,39,20,47,13,63,42,118,67
13928,Charchilla,39106,39,16,33,4,148,36,188,49
13929,Charcier,39107,39,9,12,0,48,15,63,21
13930,Charency,39108,39,10,10,5,15,10,30,20
13931,Charézier,39109,39,21,26,8,67,21,96,47
13932,La Charme,39110,39,0,20,5,15,20,40,20
13933,Charnod,39111,39,10,0,5,25,0,30,10
13934,La Chassagne,39112,39,45,25,5,50,5,60,70
13935,Chassal,39113,39,54,84,25,163,51,239,138
13936,Château-Chalon,39114,39,48,32,16,40,20,76,80
13937,Château-des-Prés,39115,39,4,44,20,42,54,116,48
13938,La Châtelaine,39116,39,15,20,10,60,15,85,35
13939,Chatelay,39117,39,8,8,8,37,13,58,16
13940,Châtel-de-Joux,39118,39,10,20,0,25,5,30,30
13941,Le Chateley,39119,39,24,16,4,32,8,44,40
13942,Châtelneuf,39120,39,12,30,13,39,21,73,42
13943,Châtenois,39121,39,28,92,32,112,92,236,120
13944,Châtillon,39122,39,36,18,12,42,18,72,54
13945,Chatonnay,39123,39,8,35,4,9,22,35,43
13946,Chaumergy,39124,39,84,125,15,140,115,270,209
13947,La Chaumusse,39126,39,24,112,20,120,108,248,136
13948,Chaussenans,39127,39,3,19,9,35,9,53,22
13949,Chaussin,39128,39,312,332,184,520,264,968,644
13950,Chaux-des-Crotenay,39129,39,40,80,40,132,88,260,120
13951,Nanchez,39130,39,26,131,44,189,83,316,157
13952,La Chaux-du-Dombief,39131,39,35,130,59,160,145,364,165
13953,La Chaux-en-Bresse,39132,39,0,15,5,20,10,35,15
13954,Chaux-Champagny,39133,39,8,20,8,24,16,48,28
13955,Chavéria,39134,39,24,92,20,80,44,144,116
13956,Chazelles,39135,39,20,36,4,48,28,80,56
13957,Chemenot,39136,39,6,6,0,9,6,15,12
13958,Chemilla,39137,39,16,12,24,40,20,84,28
13959,Chemin,39138,39,35,75,25,150,55,230,110
13960,Chêne-Bernard,39139,39,15,20,0,25,5,30,35
13961,Chêne-Sec,39140,39,25,0,0,0,10,10,25
13962,Chevigny,39141,39,22,82,29,61,59,149,104
13963,Chevreaux,39142,39,25,10,15,60,15,90,35
13964,Chevrotaine,39143,39,10,5,5,5,5,15,15
13965,Chille,39145,39,46,73,9,113,48,170,119
13966,Chilly-le-Vignoble,39146,39,48,174,73,198,106,377,222
13967,Chilly-sur-Salins,39147,39,21,22,16,20,16,52,43
13968,Chisséria,39148,39,5,0,10,35,5,50,5
13969,Chissey-sur-Loue,39149,39,55,35,40,155,35,230,90
13970,Choisey,39150,39,140,289,69,394,191,654,429
13971,Choux,39151,39,10,25,25,40,35,100,35
13972,Cize,39153,39,74,167,26,336,134,496,241
13973,Clairvaux-les-Lacs,39154,39,280,290,155,405,245,805,570
13974,Clucy,39155,39,20,12,12,20,4,36,32
13975,Cogna,39156,39,45,80,0,70,60,130,125
13976,Coiserette,39157,39,8,8,0,12,20,32,16
13977,Coisia,39158,39,0,55,30,45,65,140,55
13978,Colonne,39159,39,36,48,40,72,56,168,84
13979,Commenailles,39160,39,116,220,40,224,204,468,336
13980,Condamine,39162,39,25,60,15,85,75,175,85
13981,Condes,39163,39,5,25,5,40,25,70,30
13982,Conliège,39164,39,122,89,92,231,69,392,211
13983,Conte,39165,39,0,8,4,24,16,44,8
13984,Cornod,39166,39,70,70,5,65,40,110,140
13985,Cosges,39167,39,30,80,35,130,85,250,110
13986,Courbette,39168,39,10,10,0,15,10,25,20
13987,Courbouzon,39169,39,59,133,20,244,77,341,192
13988,Courlans,39170,39,75,276,58,264,175,497,351
13989,Courlaoux,39171,39,60,288,92,380,200,672,348
13990,Courtefontaine,39172,39,12,76,24,60,80,164,88
13991,Cousance,39173,39,148,275,117,436,197,750,423
13992,Coyrière,39174,39,10,0,0,45,5,50,10
13993,Coyron,39175,39,15,15,0,35,10,45,30
13994,Cramans,39176,39,92,124,40,132,92,264,216
13995,Hauteroche,39177,39,91,202,26,341,157,524,293
13996,Crans,39178,39,12,16,12,20,8,40,28
13997,Crenans,39179,39,20,50,15,100,45,160,70
13998,Cressia,39180,39,22,45,12,90,34,136,67
13999,Crissey,39182,39,84,126,33,237,88,358,210
14000,Crotenay,39183,39,72,152,48,200,122,370,224
14001,Les Crozets,39184,39,45,35,15,90,20,125,80
14002,Cuisia,39185,39,85,65,20,145,65,230,150
14003,Cuttura,39186,39,10,60,20,165,55,240,70
14004,Cuvier,39187,39,20,62,20,56,57,133,82
14005,Dammartin-Marpain,39188,39,48,80,24,60,84,168,128
14006,Damparis,39189,39,374,726,228,916,510,1654,1100
14007,Dampierre,39190,39,120,295,75,395,259,729,415
14008,Darbonnay,39191,39,10,20,15,30,20,65,30
14009,Denezières,39192,39,0,15,0,45,10,55,15
14010,Le Deschaux,39193,39,120,335,50,300,240,590,455
14011,Desnes,39194,39,50,109,12,146,87,245,159
14012,Dessia,39195,39,3,13,6,9,13,28,16
14013,Les Deux-Fays,39196,39,18,14,9,36,3,48,32
14014,Digna,39197,39,55,70,15,125,70,210,125
14015,Dole,39198,39,3484,5284,2489,7427,3705,13621,8768
14016,Domblans,39199,39,96,262,44,282,247,573,358
14017,Dompierre-sur-Mont,39200,39,28,68,12,80,48,140,96
14018,Doucier,39201,39,25,95,20,105,54,179,120
14019,Dournon,39202,39,13,25,12,49,8,69,38
14020,Doye,39203,39,12,28,12,24,20,56,40
14021,Dramelay,39204,39,0,10,0,15,5,20,10
14022,Éclans-Nenon,39205,39,40,110,35,100,110,245,150
14023,Écleux,39206,39,48,48,12,35,43,90,96
14024,Écrille,39207,39,10,35,0,25,20,45,45
14025,Entre-deux-Monts,39208,39,25,35,10,50,20,80,60
14026,Val d'Épy,39209,39,38,57,15,92,67,174,95
14027,Équevillon,39210,39,87,131,21,185,89,295,218
14028,Les Essards-Taignevaux,39211,39,52,72,28,80,44,152,124
14029,Esserval-Tartre,39214,39,20,20,16,20,24,60,40
14030,Étival,39216,39,45,85,10,100,64,174,130
14031,L'Étoile,39217,39,60,90,65,255,75,395,150
14032,Étrepigney,39218,39,55,125,25,140,100,265,180
14033,Évans,39219,39,56,172,40,184,160,384,228
14034,Falletans,39220,39,56,128,16,116,84,216,184
14035,La Favière,39221,39,6,0,3,6,0,9,6
14036,Fay-en-Montagne,39222,39,16,20,8,36,8,52,36
14037,La Ferté,39223,39,16,29,6,82,23,111,45
14038,Fétigny,39224,39,5,10,0,35,15,50,15
14039,Le Fied,39225,39,8,60,21,70,29,120,68
14040,Foncine-le-Bas,39227,39,25,30,21,81,8,110,55
14041,Foncine-le-Haut,39228,39,132,264,124,308,200,632,396
14042,Fontainebrux,39229,39,15,40,15,93,40,148,55
14043,Fontenu,39230,39,4,13,8,8,16,32,17
14044,Fort-du-Plasne,39232,39,59,97,12,162,68,242,156
14045,Foucherans,39233,39,361,462,210,561,391,1162,823
14046,Foulenay,39234,39,21,12,0,20,13,33,33
14047,Fraisans,39235,39,140,344,120,276,308,704,484
14048,Francheville,39236,39,12,16,0,8,8,16,28
14049,Fraroz,39237,39,0,15,10,25,5,40,15
14050,Frasne-les-Meulières,39238,39,0,30,25,30,30,85,30
14051,La Frasnée,39239,39,9,3,6,6,0,12,12
14052,Le Frasnois,39240,39,12,24,28,48,36,112,36
14053,Frébuans,39241,39,75,95,20,115,80,215,170
14054,Froideville,39243,39,10,15,0,20,15,35,25
14055,Frontenay,39244,39,30,35,30,55,20,105,65
14056,Gatey,39245,39,55,110,20,124,75,219,165
14057,Gendrey,39246,39,30,120,45,100,110,255,150
14058,Genod,39247,39,16,8,0,21,8,29,24
14059,Geraise,39248,39,15,0,5,0,10,15,15
14060,Germigney,39249,39,24,9,6,21,6,33,33
14061,Geruge,39250,39,4,31,37,40,38,115,35
14062,Gevingey,39251,39,76,116,20,132,92,244,192
14063,Gevry,39252,39,90,160,45,233,150,428,250
14064,Gigny,39253,39,17,72,22,96,52,170,89
14065,Gillois,39254,39,13,35,9,32,20,61,48
14066,Gizia,39255,39,25,31,17,75,19,111,56
14067,Grande-Rivière,39258,39,29,87,29,179,49,257,116
14068,Grange-de-Vaivre,39259,39,25,0,0,5,0,5,25
14069,Graye-et-Charnay,39261,39,12,27,0,55,21,76,39
14070,Gredisans,39262,39,25,15,5,50,20,75,40
14071,Grozon,39263,39,31,115,18,117,102,237,146
14072,Grusse,39264,39,16,30,12,59,30,101,46
14073,Hautecour,39265,39,15,29,3,89,25,117,44
14074,Les Hays,39266,39,69,80,25,85,65,175,149
14075,Ivory,39267,39,20,30,4,16,16,36,50
14076,Ivrey,39268,39,0,8,12,32,0,44,8
14077,Jeurre,39269,39,38,58,16,65,44,125,96
14078,Jouhe,39270,39,25,170,15,185,140,340,195
14079,Lac-des-Rouges-Truites,39271,39,48,101,52,128,48,228,149
14080,Ladoye-sur-Seille,39272,39,9,3,3,24,6,33,12
14081,Lains,39273,39,25,10,5,35,15,55,35
14082,Lajoux,39274,39,15,45,20,105,50,175,60
14083,Lamoura,39275,39,28,158,33,193,145,371,186
14084,Le Larderet,39277,39,10,15,10,25,20,55,25
14085,Largillay-Marsonnay,39278,39,16,28,28,60,28,116,44
14086,Larnaud,39279,39,55,175,20,203,120,343,230
14087,Larrivoire,39280,39,12,32,16,44,28,88,44
14088,Le Latet,39281,39,8,26,4,20,17,41,34
14089,La Latette,39282,39,20,15,10,30,0,40,35
14090,Lavancia-Epercy,39283,39,60,164,60,240,116,416,224
14091,Lavangeot,39284,39,20,20,12,48,20,80,40
14092,Lavans-lès-Dole,39285,39,36,79,39,59,57,155,115
14093,Lavans-lès-Saint-Claude,39286,39,269,492,162,568,374,1104,761
14094,Lavans-sur-Valouse,39287,39,20,32,8,24,24,56,52
14095,Lavigny,39288,39,44,67,20,123,49,192,111
14096,Lect,39289,39,41,93,19,94,74,187,134
14097,Légna,39290,39,15,50,15,85,45,145,65
14098,Lemuy,39291,39,64,60,25,90,15,130,124
14099,Lent,39292,39,4,28,8,84,12,104,32
14100,Leschères,39293,39,15,72,20,68,44,132,87
14101,Loisia,39295,39,30,25,12,53,17,82,55
14102,Lombard,39296,39,15,70,20,64,60,144,85
14103,Longchaumois,39297,39,120,260,102,396,212,710,380
14104,Longcochon,39298,39,0,21,8,8,20,36,21
14105,Longwy-sur-le-Doubs,39299,39,96,148,36,160,104,300,244
14106,Lons-le-Saunier,39300,39,3077,3373,1975,5300,2744,10019,6450
14107,Loulle,39301,39,16,43,12,32,37,81,59
14108,Louvatange,39302,39,19,23,6,22,15,43,42
14109,Louvenne,39303,39,20,31,0,30,27,57,51
14110,Le Louverot,39304,39,10,25,10,135,30,175,35
14111,La Loye,39305,39,75,133,27,160,97,284,208
14112,Macornay,39306,39,120,195,95,435,135,665,315
14113,Maisod,39307,39,37,77,15,81,65,161,114
14114,Malange,39308,39,8,78,16,66,50,132,86
14115,Mallerey,39309,39,8,12,0,25,8,33,20
14116,Mantry,39310,39,90,115,25,125,95,245,205
14117,Marigna-sur-Valouse,39312,39,25,35,10,25,25,60,60
14118,Marigny,39313,39,19,36,18,65,16,99,55
14119,Marnézia,39314,39,20,30,5,20,20,45,50
14120,Marnoz,39315,39,27,111,18,152,72,242,138
14121,La Marre,39317,39,70,90,25,70,65,160,160
14122,Martigna,39318,39,32,52,4,56,56,116,84
14123,Mathenay,39319,39,0,50,0,45,55,100,50
14124,Maynal,39320,39,32,76,28,136,72,236,108
14125,Menétru-le-Vignoble,39321,39,30,30,15,45,30,90,60
14126,Menétrux-en-Joux,39322,39,10,5,0,25,5,30,15
14127,Menotey,39323,39,20,56,16,120,52,188,76
14128,Mérona,39324,39,0,0,0,8,4,12,0
14129,Mesnay,39325,39,52,132,48,236,92,376,184
14130,Mesnois,39326,39,20,50,25,85,20,130,70
14131,Messia-sur-Sorne,39327,39,99,187,44,296,131,471,286
14132,Meussia,39328,39,65,122,81,95,86,262,187
14133,Mièges,39329,39,4,43,25,36,32,93,47
14134,Miéry,39330,39,16,52,20,28,40,88,68
14135,Mignovillard,39331,39,68,184,55,241,164,460,252
14136,Moirans-en-Montagne,39333,39,302,490,220,661,395,1276,792
14137,Moiron,39334,39,10,35,5,59,20,84,45
14138,Moissey,39335,39,107,114,38,135,81,254,221
14139,Molain,39336,39,0,40,10,30,35,75,40
14140,Molamboz,39337,39,12,16,8,24,20,52,28
14141,Molay,39338,39,95,90,45,190,80,315,185
14142,Molinges,39339,39,140,193,54,188,123,365,333
14143,Les Molunes,39341,39,15,40,5,85,5,95,55
14144,Monay,39342,39,25,30,0,55,10,65,55
14145,Monnetay,39343,39,0,11,0,10,0,10,11
14146,Monnet-la-Ville,39344,39,29,77,30,109,66,205,106
14147,Monnières,39345,39,70,125,10,160,75,245,195
14148,Montagna-le-Reconduit,39346,39,30,25,0,40,30,70,55
14149,Montagna-le-Templier,39347,39,12,18,14,30,12,56,30
14150,Montaigu,39348,39,65,94,12,163,58,233,159
14151,Montain,39349,39,65,125,0,165,85,250,190
14152,Montbarrey,39350,39,55,65,20,115,60,195,120
14153,Montcusel,39351,39,16,50,9,54,27,90,66
14154,Monteplain,39352,39,0,34,12,50,20,82,34
14155,Montfleur,39353,39,50,60,5,50,45,100,110
14156,Montholier,39354,39,16,88,36,128,72,236,104
14157,Montigny-lès-Arsures,39355,39,60,64,8,104,44,156,124
14158,Montigny-sur-l'Ain,39356,39,12,60,8,68,44,120,72
14159,Montmarlon,39359,39,0,13,0,8,8,16,13
14160,Montmirey-la-Ville,39360,39,38,35,10,45,30,85,73
14161,Montmirey-le-Château,39361,39,13,51,8,64,20,92,64
14162,Montmorot,39362,39,576,507,303,939,465,1707,1083
14163,Montrevel,39363,39,15,10,10,45,20,75,25
14164,Montrond,39364,39,65,140,50,135,110,295,205
14165,Mont-sous-Vaudrey,39365,39,156,259,136,342,174,652,415
14166,Mont-sur-Monnet,39366,39,20,77,34,40,49,123,97
14167,Morbier,39367,39,232,478,283,781,446,1510,710
14168,Hauts de Bienne,39368,39,534,1360,877,1505,908,3290,1894
14169,Mouchard,39370,39,172,244,116,300,160,576,416
14170,Mournans-Charbonny,39372,39,16,27,0,28,16,44,43
14171,Les Moussières,39373,39,25,40,5,40,45,90,65
14172,Moutonne,39375,39,8,40,0,28,44,72,48
14173,Moutoux,39376,39,0,12,12,20,16,48,12
14174,Mutigney,39377,39,35,55,15,45,25,85,90
14175,Nanc-lès-Saint-Amour,39378,39,74,74,17,74,62,153,148
14176,Nance,39379,39,69,109,13,145,102,260,178
14177,Nancuise,39380,39,0,0,4,20,4,28,0
14178,Les Nans,39381,39,9,11,6,39,9,54,20
14179,Neublans-Abergement,39385,39,100,130,25,190,75,290,230
14180,Neuvilley,39386,39,20,20,0,8,32,40,40
14181,Nevy-lès-Dole,39387,39,16,60,52,92,44,188,76
14182,Nevy-sur-Seille,39388,39,32,44,16,108,28,152,76
14183,Ney,39389,39,105,100,75,195,85,355,205
14184,Nogna,39390,39,25,75,45,80,55,180,100
14185,Nozeroy,39391,39,45,90,40,160,45,245,135
14186,Offlanges,39392,39,24,48,8,61,64,133,72
14187,Onglières,39393,39,10,10,10,25,0,35,20
14188,Onoz,39394,39,30,10,15,15,5,35,40
14189,Orbagna,39395,39,28,50,20,41,48,109,78
14190,Orchamps,39396,39,78,274,75,263,253,591,352
14191,Orgelet,39397,39,245,301,116,499,226,841,546
14192,Ougney,39398,39,16,112,25,75,95,195,128
14193,Ounans,39399,39,20,105,30,125,70,225,125
14194,Our,39400,39,14,30,6,50,19,75,44
14195,Oussières,39401,39,10,50,25,105,45,175,60
14196,Pagney,39402,39,27,86,48,119,73,240,113
14197,Pagnoz,39403,39,45,60,35,90,5,130,105
14198,Pannessières,39404,39,44,108,25,200,73,298,152
14199,Parcey,39405,39,90,245,95,359,194,648,335
14200,Le Pasquier,39406,39,5,45,35,130,35,200,50
14201,Passenans,39407,39,68,70,20,85,95,200,138
14202,Patornay,39408,39,45,25,0,25,30,55,70
14203,Peintre,39409,39,24,31,8,34,12,54,55
14204,Perrigny,39411,39,328,301,91,473,224,788,629
14205,Peseux,39412,39,30,81,8,94,59,161,111
14206,La Pesse,39413,39,16,92,20,165,56,241,108
14207,Le Petit-Mercey,39414,39,4,28,12,48,16,76,32
14208,Petit-Noir,39415,39,155,272,76,360,172,608,427
14209,Les Piards,39417,39,25,26,6,38,30,74,51
14210,Picarreau,39418,39,5,30,5,40,30,75,35
14211,Pillemoine,39419,39,6,17,3,12,12,27,23
14212,Pimorin,39420,39,15,45,15,80,20,115,60
14213,Le Pin,39421,39,45,55,5,125,30,160,100
14214,Plainoiseau,39422,39,50,125,40,195,115,350,175
14215,Plaisia,39423,39,8,12,24,64,4,92,20
14216,Les Planches-en-Montagne,39424,39,29,28,4,46,20,70,57
14217,Les Planches-près-Arbois,39425,39,24,36,4,20,28,52,60
14218,Plasne,39426,39,29,52,3,67,52,122,81
14219,Plénise,39427,39,8,8,8,12,4,24,16
14220,Plénisette,39428,39,5,15,0,10,5,15,20
14221,Pleure,39429,39,75,90,35,170,55,260,165
14222,Plumont,39430,39,16,9,4,42,8,54,25
14223,Poids-de-Fiole,39431,39,24,72,24,148,48,220,96
14224,Pointre,39432,39,10,35,10,35,30,75,45
14225,Poligny,39434,39,523,897,604,1283,558,2445,1420
14226,Pont-de-Poitte,39435,39,122,155,49,249,95,393,277
14227,Pont-d'Héry,39436,39,10,35,15,55,60,130,45
14228,Pont-du-Navoy,39437,39,56,48,28,60,48,136,104
14229,Port-Lesney,39439,39,71,99,32,200,61,293,170
14230,Pratz,39440,39,50,185,30,175,120,325,235
14231,Prémanon,39441,39,56,312,148,276,368,792,368
14232,Présilly,39443,39,12,43,0,36,17,53,55
14233,Pretin,39444,39,0,16,8,28,12,48,16
14234,Publy,39445,39,24,73,12,103,41,156,97
14235,Pupillin,39446,39,35,50,10,95,40,145,85
14236,Quintigny,39447,39,16,49,16,73,52,141,65
14237,Rahon,39448,39,20,106,29,192,103,324,126
14238,Rainans,39449,39,8,72,12,90,54,156,80
14239,Ranchot,39451,39,40,145,35,165,110,310,185
14240,Rans,39452,39,75,175,55,115,105,275,250
14241,Ravilloles,39453,39,35,155,35,199,90,324,190
14242,Recanoz,39454,39,20,15,20,10,20,50,35
14243,Reithouse,39455,39,8,24,0,24,8,32,32
14244,Relans,39456,39,30,105,48,95,85,228,135
14245,Les Repôts,39457,39,0,12,4,20,16,40,12
14246,Revigny,39458,39,35,35,5,100,65,170,70
14247,La Rixouse,39460,39,12,46,6,72,22,100,58
14248,Rix,39461,39,15,15,10,30,15,55,30
14249,Rochefort-sur-Nenon,39462,39,49,114,43,218,77,338,163
14250,Rogna,39463,39,20,56,4,72,72,148,76
14251,Romain,39464,39,16,72,32,68,32,132,88
14252,Romange,39465,39,5,65,20,95,25,140,70
14253,Rosay,39466,39,32,16,12,48,12,72,48
14254,Rotalier,39467,39,36,40,20,52,32,104,76
14255,Rothonay,39468,39,24,30,0,38,20,58,54
14256,Rouffange,39469,39,16,17,4,20,20,44,33
14257,Les Rousses,39470,39,268,753,411,978,794,2183,1021
14258,Ruffey-sur-Seille,39471,39,75,157,54,257,112,423,232
14259,Rye,39472,39,44,44,8,56,48,112,88
14260,Saffloz,39473,39,5,15,20,60,5,85,20
14261,Sainte-Agnès,39474,39,4,96,24,124,96,244,100
14262,Saint-Amour,39475,39,390,513,297,704,357,1358,903
14263,Saint-Aubin,39476,39,212,484,144,552,316,1012,696
14264,Saint-Baraing,39477,39,30,60,30,65,65,160,90
14265,Saint-Claude,39478,39,1512,2404,929,3088,1814,5831,3916
14266,Saint-Cyr-Montmalin,39479,39,25,40,10,100,40,150,65
14267,Saint-Didier,39480,39,5,50,30,130,55,215,55
14268,Saint-Germain-en-Montagne,39481,39,20,124,40,160,108,308,144
14269,Saint-Hymetière,39483,39,24,32,20,20,12,52,56
14270,Saint-Jean-d'Étreux,39484,39,12,21,12,76,18,106,33
14271,Saint-Julien,39485,39,75,75,55,100,75,230,150
14272,Saint-Lamain,39486,39,12,28,4,56,20,80,40
14273,Saint-Laurent-en-Grandvaux,39487,39,216,413,236,544,370,1150,629
14274,Saint-Lothain,39489,39,66,126,16,147,74,237,192
14275,Saint-Loup,39490,39,40,80,25,95,60,180,120
14276,Saint-Lupicin,39491,39,295,535,215,720,290,1225,830
14277,Saint-Maur,39492,39,25,44,8,55,39,102,69
14278,Saint-Maurice-Crillat,39493,39,24,68,16,80,48,144,92
14279,Saint-Pierre,39494,39,21,57,38,119,53,210,78
14280,Saint-Thiébaud,39495,39,10,25,0,30,10,40,35
14281,Saizenay,39497,39,3,23,3,47,20,70,26
14282,Salans,39498,39,66,155,44,148,117,309,221
14283,Saligney,39499,39,16,61,17,78,16,111,77
14284,Salins-les-Bains,39500,39,433,454,161,892,388,1441,887
14285,Sampans,39501,39,88,345,89,265,238,592,433
14286,Santans,39502,39,35,85,30,105,70,205,120
14287,Sapois,39503,39,50,60,30,145,60,235,110
14288,Sarrogna,39504,39,30,45,0,100,50,150,75
14289,Saugeot,39505,39,4,9,0,38,0,38,13
14290,Savigna,39506,39,17,26,8,33,31,72,43
14291,Séligney,39507,39,10,10,0,45,0,45,20
14292,Sellières,39508,39,150,139,64,247,120,431,289
14293,Septmoncel,39510,39,99,125,80,190,144,414,224
14294,Sergenaux,39511,39,8,20,0,20,12,32,28
14295,Sergenon,39512,39,10,15,0,25,15,40,25
14296,Sermange,39513,39,28,80,36,60,68,164,108
14297,Serre-les-Moulières,39514,39,15,60,10,40,60,110,75
14298,Sirod,39517,39,85,127,45,179,96,320,212
14299,Songeson,39518,39,5,30,10,15,20,45,35
14300,Soucia,39519,39,48,65,5,49,30,84,113
14301,Souvans,39520,39,95,110,35,155,80,270,205
14302,Supt,39522,39,35,10,5,40,10,55,45
14303,Syam,39523,39,73,35,15,40,35,90,108
14304,Tassenières,39525,39,56,98,41,76,73,190,154
14305,Tavaux,39526,39,659,890,355,1352,640,2347,1549
14306,Taxenne,39527,39,16,4,4,48,16,68,20
14307,Thervay,39528,39,60,105,15,150,50,215,165
14308,Thésy,39529,39,10,10,5,25,15,45,20
14309,Thoirette,39530,39,90,165,25,220,150,395,255
14310,Thoiria,39531,39,28,60,0,56,64,120,88
14311,Thoissia,39532,39,10,15,0,15,10,25,25
14312,Toulouse-le-Château,39533,39,45,57,4,46,38,88,102
14313,La Tour-du-Meix,39534,39,20,55,10,105,40,155,75
14314,Tourmont,39535,39,30,118,26,185,82,293,148
14315,Trenal,39537,39,12,83,32,143,56,231,95
14316,Uxelles,39538,39,10,0,5,5,20,30,10
14317,Vadans,39539,39,45,55,30,80,45,155,100
14318,Valempoulières,39540,39,36,64,4,68,48,120,100
14319,Valfin-sur-Valouse,39542,39,24,28,0,24,12,36,52
14320,Vannoz,39543,39,30,35,15,60,35,110,65
14321,Le Vaudioux,39545,39,4,38,12,82,22,116,42
14322,Vaudrey,39546,39,64,112,24,116,64,204,176
14323,Vaux-lès-Saint-Claude,39547,39,96,158,41,239,125,405,254
14324,Vaux-sur-Poligny,39548,39,4,28,0,56,12,68,32
14325,Vercia,39549,39,45,80,30,98,65,193,125
14326,Verges,39550,39,28,52,16,56,32,104,80
14327,Véria,39551,39,20,15,5,40,25,70,35
14328,Vernantois,39552,39,55,75,40,110,40,190,130
14329,Le Vernois,39553,39,10,85,40,95,65,200,95
14330,Vers-en-Montagne,39554,39,24,64,8,80,52,140,88
14331,Vers-sous-Sellières,39555,39,40,64,20,52,52,124,104
14332,Vertamboz,39556,39,12,18,3,24,6,33,30
14333,Vescles,39557,39,55,40,0,60,45,105,95
14334,Vevy,39558,39,40,65,7,61,41,109,105
14335,La Vieille-Loye,39559,39,45,105,55,100,100,255,150
14336,Villard-Saint-Sauveur,39560,39,51,128,25,294,76,395,179
14337,Villards-d'Héria,39561,39,52,112,32,136,100,268,164
14338,Villard-sur-Bienne,39562,39,6,60,6,30,53,89,66
14339,Villechantria,39564,39,40,10,10,55,0,65,50
14340,Villeneuve-d'Aval,39565,39,5,25,0,45,20,65,30
14341,Villeneuve-lès-Charnod,39566,39,6,23,7,27,9,43,29
14342,Villeneuve-sous-Pymont,39567,39,40,52,16,100,60,176,92
14343,Villerserine,39568,39,10,10,0,35,0,35,20
14344,Villers-Farlay,39569,39,44,189,69,187,123,379,233
14345,Villers-les-Bois,39570,39,32,48,8,72,36,116,80
14346,Villers-Robert,39571,39,35,35,20,70,40,130,70
14347,Villette-lès-Arbois,39572,39,54,79,12,109,74,195,133
14348,Villette-lès-Dole,39573,39,114,174,45,232,136,413,288
14349,Villevieux,39574,39,81,146,79,207,122,408,227
14350,Le Villey,39575,39,16,16,16,12,4,32,32
14351,Vincelles,39576,39,30,90,20,170,80,270,120
14352,Vincent,39577,39,12,100,36,104,76,216,112
14353,Viry,39579,39,100,220,68,352,180,600,320
14354,Vitreux,39581,39,39,70,40,51,44,135,109
14355,Voiteur,39582,39,100,135,65,300,110,475,235
14356,Vosbles,39583,39,8,17,0,47,26,73,25
14357,Vriange,39584,39,5,20,25,60,25,110,25
14358,Vulvoz,39585,39,4,8,0,0,8,8,12
14359,Aresches,39586,39,0,9,0,15,9,24,9
14360,Aire-sur-l'Adour,40001,40,1021,1160,647,2124,867,3638,2181
14361,Amou,40002,40,268,292,88,564,252,904,560
14362,Angoumé,40003,40,20,85,5,110,60,175,105
14363,Angresse,40004,40,215,489,132,531,505,1168,704
14364,Arboucave,40005,40,23,27,19,52,48,119,50
14365,Arengosse,40006,40,150,135,55,260,125,440,285
14366,Argelos,40007,40,55,15,20,75,15,110,70
14367,Argelouse,40008,40,9,6,0,50,3,53,15
14368,Arjuzanx,40009,40,32,72,16,48,60,124,104
14369,Arsague,40011,40,56,96,16,108,88,212,152
14370,Artassenx,40012,40,35,50,20,105,40,165,85
14371,Arthez-d'Armagnac,40013,40,15,30,0,45,25,70,45
14372,Arue,40014,40,50,52,42,110,34,186,102
14373,Arx,40015,40,12,12,0,24,20,44,24
14374,Aubagnan,40016,40,24,30,21,94,35,150,54
14375,Audignon,40017,40,54,78,49,120,57,226,132
14376,Audon,40018,40,65,55,10,160,60,230,120
14377,Aureilhan,40019,40,156,236,80,468,148,696,392
14378,Aurice,40020,40,75,135,40,290,85,415,210
14379,Azur,40021,40,78,179,28,260,170,458,257
14380,Bahus-Soubiran,40022,40,64,85,50,154,60,264,149
14381,Baigts,40023,40,95,60,30,105,50,185,155
14382,Banos,40024,40,40,72,16,88,72,176,112
14383,Bascons,40025,40,130,182,65,429,65,559,312
14384,Bas-Mauco,40026,40,50,115,5,105,90,200,165
14385,Bassercles,40027,40,15,25,15,70,20,105,40
14386,Bastennes,40028,40,48,40,24,100,48,172,88
14387,Bats,40029,40,25,72,25,100,66,191,97
14388,Baudignan,40030,40,15,0,28,20,5,53,15
14389,Bégaar,40031,40,152,240,88,385,232,705,392
14390,Belhade,40032,40,20,45,0,65,65,130,65
14391,Bélis,40033,40,20,40,8,72,20,100,60
14392,Bélus,40034,40,50,170,45,250,100,395,220
14393,Bénesse-lès-Dax,40035,40,35,142,16,215,74,305,177
14394,Bénesse-Maremne,40036,40,309,722,253,838,629,1720,1031
14395,Benquet,40037,40,219,360,100,614,269,983,579
14396,Bergouey,40038,40,20,9,4,34,8,46,29
14397,Betbezer-d'Armagnac,40039,40,32,22,14,38,12,64,54
14398,Beylongue,40040,40,75,90,10,145,70,225,165
14399,Beyries,40041,40,20,20,12,44,24,80,40
14400,Biarrotte,40042,40,35,45,20,120,50,190,80
14401,Bias,40043,40,54,124,85,304,77,466,178
14402,Biaudos,40044,40,85,220,74,311,144,529,305
14403,Biscarrosse,40046,40,2229,2921,983,5348,2481,8812,5150
14404,Bonnegarde,40047,40,45,77,20,138,20,178,122
14405,Boos,40048,40,20,140,25,100,130,255,160
14406,Bordères-et-Lamensans,40049,40,24,72,17,142,59,218,96
14407,Bostens,40050,40,8,43,12,62,37,111,51
14408,Bougue,40051,40,48,176,44,308,128,480,224
14409,Bourdalat,40052,40,34,65,23,34,58,115,99
14410,Bourriot-Bergonce,40053,40,46,53,12,130,52,194,99
14411,Brassempouy,40054,40,29,46,15,96,39,150,75
14412,Bretagne-de-Marsan,40055,40,64,330,113,450,320,883,394
14413,Brocas,40056,40,96,174,76,240,159,475,270
14414,Buanes,40057,40,40,60,30,100,50,180,100
14415,Cachen,40058,40,45,50,35,75,35,145,95
14416,Cagnotte,40059,40,51,212,51,230,151,432,263
14417,Callen,40060,40,20,16,28,60,20,108,36
14418,Campagne,40061,40,164,244,68,364,176,608,408
14419,Campet-et-Lamolère,40062,40,16,68,12,100,83,195,84
14420,Candresse,40063,40,173,152,46,260,119,425,325
14421,Canenx-et-Réaut,40064,40,20,30,15,55,30,100,50
14422,Capbreton,40065,40,1692,1420,679,2845,1492,5016,3112
14423,Carcarès-Sainte-Croix,40066,40,65,85,40,171,89,300,150
14424,Carcen-Ponson,40067,40,76,166,32,253,133,418,242
14425,Cassen,40068,40,80,136,44,204,104,352,216
14426,Castaignos-Souslens,40069,40,50,110,65,125,60,250,160
14427,Castandet,40070,40,80,90,25,180,55,260,170
14428,Castelnau-Chalosse,40071,40,88,140,48,164,112,324,228
14429,Castelnau-Tursan,40072,40,40,40,0,90,20,110,80
14430,Castelner,40073,40,32,26,0,12,20,32,58
14431,Castel-Sarrazin,40074,40,59,115,65,218,85,368,174
14432,Castets,40075,40,252,380,188,720,372,1280,632
14433,Cauna,40076,40,30,95,40,205,60,305,125
14434,Cauneille,40077,40,135,135,55,220,175,450,270
14435,Caupenne,40078,40,60,96,28,144,84,256,156
14436,Cazalis,40079,40,15,30,25,65,15,105,45
14437,Cazères-sur-l'Adour,40080,40,195,245,70,344,214,628,440
14438,Cère,40081,40,12,105,32,100,101,233,117
14439,Classun,40082,40,8,58,41,72,47,160,66
14440,Clèdes,40083,40,20,12,8,37,17,62,32
14441,Clermont,40084,40,80,195,10,300,165,475,275
14442,Commensacq,40085,40,72,112,12,156,84,252,184
14443,Coudures,40086,40,81,120,70,130,85,285,201
14444,Créon-d'Armagnac,40087,40,38,51,25,144,36,205,89
14445,Dax,40088,40,3687,3484,2674,6562,3197,12433,7171
14446,Doazit,40089,40,105,215,50,355,140,545,320
14447,Donzacq,40090,40,100,105,30,140,90,260,205
14448,Duhort-Bachen,40091,40,72,152,52,232,136,420,224
14449,Dumes,40092,40,4,80,32,92,72,196,84
14450,Escalans,40093,40,12,60,24,124,56,204,72
14451,Escource,40094,40,76,121,40,249,133,422,197
14452,Estibeaux,40095,40,65,149,46,207,136,389,214
14453,Estigarde,40096,40,5,55,15,55,20,90,60
14454,Eugénie-les-Bains,40097,40,66,49,71,136,58,265,115
14455,Eyres-Moncube,40098,40,52,92,20,116,80,216,144
14456,Fargues,40099,40,80,80,25,88,70,183,160
14457,Le Frêche,40100,40,52,80,28,160,68,256,132
14458,Gaas,40101,40,48,132,32,216,92,340,180
14459,Gabarret,40102,40,270,200,65,490,155,710,470
14460,Gaillères,40103,40,84,157,25,185,110,320,241
14461,Gamarde-les-Bains,40104,40,132,268,108,336,280,724,400
14462,Garein,40105,40,50,90,30,125,120,275,140
14463,Garrey,40106,40,16,48,28,76,20,124,64
14464,Garrosse,40107,40,40,55,10,130,45,185,95
14465,Gastes,40108,40,103,119,36,218,136,390,222
14466,Gaujacq,40109,40,80,90,25,185,65,275,170
14467,Geaune,40110,40,80,110,85,205,105,395,190
14468,Geloux,40111,40,100,184,32,220,192,444,284
14469,Gibret,40112,40,20,40,10,33,30,73,60
14470,Goos,40113,40,51,149,27,179,81,287,200
14471,Gourbera,40114,40,15,100,20,140,100,260,115
14472,Gousse,40115,40,30,100,15,70,100,185,130
14473,Gouts,40116,40,12,52,12,120,68,200,64
14474,Grenade-sur-l'Adour,40117,40,296,603,272,834,444,1550,899
14475,Habas,40118,40,215,355,85,600,240,925,570
14476,Hagetmau,40119,40,900,800,485,1705,630,2820,1700
14477,Hastingues,40120,40,90,144,35,179,140,354,234
14478,Hauriet,40121,40,38,74,12,65,43,120,112
14479,Haut-Mauco,40122,40,95,220,41,379,140,560,315
14480,Herm,40123,40,89,257,70,380,244,694,346
14481,Herré,40124,40,21,21,0,61,4,65,42
14482,Heugas,40125,40,175,265,90,545,250,885,440
14483,Hinx,40126,40,290,450,150,643,325,1118,740
14484,Hontanx,40127,40,106,142,43,141,99,283,248
14485,Horsarrieu,40128,40,136,112,44,232,132,408,248
14486,Josse,40129,40,75,205,90,335,135,560,280
14487,Labastide-Chalosse,40130,40,32,38,8,28,21,57,70
14488,Labastide-d'Armagnac,40131,40,102,113,38,224,107,369,215
14489,Labatut,40132,40,129,390,80,555,279,914,519
14490,Labenne,40133,40,624,1415,384,1725,1356,3465,2039
14491,Labouheyre,40134,40,329,628,277,969,415,1661,957
14492,Labrit,40135,40,132,164,56,260,176,492,296
14493,Lacajunte,40136,40,20,40,12,56,20,88,60
14494,Lacquy,40137,40,4,77,26,76,65,167,81
14495,Lacrabe,40138,40,39,45,10,120,35,165,84
14496,Laglorieuse,40139,40,45,103,29,250,59,338,148
14497,Lagrange,40140,40,60,44,16,84,8,108,104
14498,Lahosse,40141,40,35,84,25,118,69,212,119
14499,Laluque,40142,40,128,264,114,232,233,579,392
14500,Lamothe,40143,40,64,56,20,120,64,204,120
14501,Larbey,40144,40,5,55,5,125,50,180,60
14502,Larrivière-Saint-Savin,40145,40,94,152,4,246,73,323,246
14503,Latrille,40146,40,9,19,6,71,15,92,28
14504,Laurède,40147,40,70,65,40,185,40,265,135
14505,Lauret,40148,40,12,24,8,28,28,64,36
14506,Lencouacq,40149,40,68,64,32,180,72,284,132
14507,Léon,40150,40,292,388,100,804,368,1272,680
14508,Lesgor,40151,40,19,120,65,144,100,309,139
14509,Lesperon,40152,40,165,220,75,395,175,645,385
14510,Le Leuy,40153,40,29,36,4,110,33,147,65
14511,Lévignacq,40154,40,84,40,16,160,20,196,124
14512,Linxe,40155,40,228,297,84,485,239,808,525
14513,Liposthey,40156,40,32,140,56,104,141,301,172
14514,Lit-et-Mixe,40157,40,304,221,54,580,201,835,525
14515,Losse,40158,40,36,36,32,144,16,192,72
14516,Louer,40159,40,25,60,45,100,50,195,85
14517,Lourquen,40160,40,28,31,13,51,28,92,59
14518,Lubbon,40161,40,10,20,0,55,15,70,30
14519,Lucbardez-et-Bargues,40162,40,42,177,41,138,132,311,219
14520,Lüe,40163,40,65,81,38,216,87,341,146
14521,Retjons,40164,40,60,60,12,104,80,196,120
14522,Luglon,40165,40,24,85,27,145,56,228,109
14523,Lussagnet,40166,40,35,15,10,10,10,30,50
14524,Luxey,40167,40,130,93,70,186,59,315,223
14525,Magescq,40168,40,268,456,184,592,444,1220,724
14526,Maillas,40169,40,15,25,10,49,20,79,40
14527,Maillères,40170,40,37,73,8,73,39,120,110
14528,Mano,40171,40,35,15,5,45,30,80,50
14529,Mant,40172,40,70,65,20,90,45,155,135
14530,Marpaps,40173,40,9,26,10,32,29,71,35
14531,Mauries,40174,40,10,30,10,25,20,55,40
14532,Maurrin,40175,40,39,95,30,147,81,258,134
14533,Mauvezin-d'Armagnac,40176,40,8,20,0,52,24,76,28
14534,Maylis,40177,40,69,65,18,76,29,123,134
14535,Mazerolles,40178,40,65,137,45,369,65,479,202
14536,Mées,40179,40,212,388,128,652,348,1128,600
14537,Meilhan,40180,40,119,234,88,387,188,663,353
14538,Messanges,40181,40,98,208,59,318,204,581,306
14539,Mézos,40182,40,184,144,44,380,92,516,328
14540,Mimbaste,40183,40,196,272,40,372,196,608,468
14541,Mimizan,40184,40,1509,1159,485,2629,1000,4114,2668
14542,Miramont-Sensacq,40185,40,88,60,20,136,56,212,148
14543,Misson,40186,40,95,170,25,285,190,500,265
14544,Moliets-et-Maa,40187,40,94,194,74,400,284,758,288
14545,Momuy,40188,40,68,108,44,132,72,248,176
14546,Monget,40189,40,10,25,0,45,15,60,35
14547,Monségur,40190,40,56,72,44,160,68,272,128
14548,Montaut,40191,40,80,148,60,268,80,408,228
14549,Mont-de-Marsan,40192,40,4080,6155,3900,9582,5072,18554,10235
14550,Montégut,40193,40,3,15,6,22,9,37,18
14551,Montfort-en-Chalosse,40194,40,156,184,96,416,152,664,340
14552,Montgaillard,40195,40,60,185,55,175,145,375,245
14553,Montsoué,40196,40,90,110,70,190,100,360,200
14554,Morcenx,40197,40,956,785,310,1435,600,2345,1741
14555,Morganx,40198,40,10,45,15,75,35,125,55
14556,Mouscardès,40199,40,42,75,0,91,35,126,117
14557,Moustey,40200,40,108,92,80,200,96,376,200
14558,Mugron,40201,40,268,292,120,404,236,760,560
14559,Narrosse,40202,40,359,686,296,1253,418,1967,1045
14560,Nassiet,40203,40,65,95,20,105,85,210,160
14561,Nerbis,40204,40,52,52,12,124,32,168,104
14562,Nousse,40205,40,44,21,27,97,19,143,65
14563,Oeyregave,40206,40,49,95,20,114,75,209,144
14564,Oeyreluy,40207,40,234,315,35,483,215,733,549
14565,Onard,40208,40,45,83,13,116,76,205,128
14566,Ondres,40209,40,649,1096,416,1675,1024,3115,1745
14567,Onesse-Laharie,40210,40,92,192,60,420,144,624,284
14568,Orist,40211,40,68,192,72,200,144,416,260
14569,Orthevielle,40212,40,132,228,68,272,192,532,360
14570,Orx,40213,40,31,155,24,197,148,369,186
14571,Ossages,40214,40,62,101,34,170,75,279,163
14572,Ousse-Suzan,40215,40,30,60,15,115,35,165,90
14573,Ozourt,40216,40,40,50,5,50,55,110,90
14574,Parentis-en-Born,40217,40,820,1408,473,1910,1029,3412,2228
14575,Parleboscq,40218,40,125,115,10,200,65,275,240
14576,Payros-Cazautets,40219,40,16,8,0,38,8,46,24
14577,Pécorade,40220,40,40,20,20,65,10,95,60
14578,Perquie,40221,40,50,70,25,145,60,230,120
14579,Pey,40222,40,90,140,35,255,125,415,230
14580,Peyre,40223,40,40,76,4,80,40,124,116
14581,Peyrehorade,40224,40,467,802,274,1216,597,2087,1269
14582,Philondenx,40225,40,35,60,0,50,55,105,95
14583,Pimbo,40226,40,20,44,4,76,48,128,64
14584,Pissos,40227,40,250,275,105,470,290,865,525
14585,Pomarez,40228,40,292,256,100,576,196,872,548
14586,Pontenx-les-Forges,40229,40,184,392,136,532,292,960,576
14587,Pontonx-sur-l'Adour,40230,40,353,650,314,824,519,1657,1003
14588,Port-de-Lanne,40231,40,123,218,75,286,178,539,341
14589,Poudenx,40232,40,35,55,15,95,45,155,90
14590,Pouillon,40233,40,441,614,256,1156,351,1763,1055
14591,Pouydesseaux,40234,40,72,283,76,272,230,578,355
14592,Poyanne,40235,40,57,166,33,233,132,398,223
14593,Poyartin,40236,40,85,205,70,305,155,530,290
14594,Préchacq-les-Bains,40237,40,136,126,52,189,108,349,262
14595,Pujo-le-Plan,40238,40,48,184,8,240,136,384,232
14596,Puyol-Cazalet,40239,40,19,20,9,31,12,52,39
14597,Renung,40240,40,34,133,26,214,98,338,167
14598,Rimbez-et-Baudiets,40242,40,20,30,10,50,15,75,50
14599,Rion-des-Landes,40243,40,478,458,212,835,402,1449,936
14600,Rivière-Saas-et-Gourby,40244,40,174,304,100,366,272,738,478
14601,Roquefort,40245,40,319,321,150,686,257,1093,640
14602,Sabres,40246,40,136,252,124,440,156,720,388
14603,Saint-Agnet,40247,40,21,56,15,30,48,93,77
14604,Saint-André-de-Seignanx,40248,40,140,402,116,624,341,1081,542
14605,Saint-Aubin,40249,40,75,135,45,190,65,300,210
14606,Saint-Avit,40250,40,26,104,30,252,106,388,130
14607,Saint-Barthélemy,40251,40,32,107,40,138,91,269,139
14608,Sainte-Colombe,40252,40,75,185,35,190,185,410,260
14609,Saint-Cricq-Chalosse,40253,40,76,160,32,200,168,400,236
14610,Saint-Cricq-du-Gave,40254,40,46,71,24,129,89,242,117
14611,Saint-Cricq-Villeneuve,40255,40,70,110,50,145,80,275,180
14612,Saint-Étienne-d'Orthe,40256,40,68,194,36,212,185,433,262
14613,Sainte-Eulalie-en-Born,40257,40,160,231,75,542,240,857,391
14614,Sainte-Foy,40258,40,20,80,16,96,64,176,100
14615,Saint-Gein,40259,40,30,109,19,147,84,250,139
14616,Saint-Geours-d'Auribat,40260,40,60,88,39,89,63,191,148
14617,Saint-Geours-de-Maremne,40261,40,285,665,205,778,600,1583,950
14618,Saint-Gor,40262,40,25,75,5,120,85,210,100
14619,Saint-Jean-de-Lier,40263,40,52,91,33,105,82,220,143
14620,Saint-Jean-de-Marsacq,40264,40,162,358,125,467,300,892,520
14621,Saint-Julien-d'Armagnac,40265,40,12,9,0,46,9,55,21
14622,Saint-Julien-en-Born,40266,40,286,295,124,487,284,895,581
14623,Saint-Justin,40267,40,170,175,115,360,150,625,345
14624,Saint-Laurent-de-Gosse,40268,40,59,120,33,148,141,322,179
14625,Saint-Lon-les-Mines,40269,40,148,288,52,388,292,732,436
14626,Saint-Loubouer,40270,40,65,82,8,173,67,248,147
14627,Sainte-Marie-de-Gosse,40271,40,103,350,101,318,242,661,453
14628,Saint-Martin-de-Hinx,40272,40,140,290,175,518,260,953,430
14629,Saint-Martin-de-Seignanx,40273,40,561,1094,432,1800,949,3181,1655
14630,Saint-Martin-d'Oney,40274,40,185,340,140,390,295,825,525
14631,Saint-Maurice-sur-Adour,40275,40,49,129,44,201,96,341,178
14632,Saint-Michel-Escalus,40276,40,38,32,9,126,44,179,70
14633,Saint-Pandelon,40277,40,76,112,92,300,100,492,188
14634,Saint-Paul-en-Born,40278,40,104,167,59,403,134,596,271
14635,Saint-Paul-lès-Dax,40279,40,2464,2313,1407,4318,2171,7896,4777
14636,Saint-Perdon,40280,40,156,455,140,449,419,1008,611
14637,Saint-Pierre-du-Mont,40281,40,1119,2189,997,3220,1719,5936,3308
14638,Saint-Sever,40282,40,796,1085,522,1554,626,2702,1881
14639,Saint-Vincent-de-Paul,40283,40,370,675,177,967,610,1754,1045
14640,Saint-Vincent-de-Tyrosse,40284,40,1253,1751,750,2280,1554,4584,3004
14641,Saint-Yaguen,40285,40,42,119,25,259,112,396,161
14642,Samadet,40286,40,172,258,78,339,173,590,430
14643,Sanguinet,40287,40,422,875,227,1249,813,2289,1297
14644,Sarbazan,40288,40,190,315,55,350,275,680,505
14645,Sarraziet,40289,40,42,46,20,34,48,102,88
14646,Sarron,40290,40,5,20,10,65,10,85,25
14647,Saubion,40291,40,147,343,91,520,285,896,490
14648,Saubrigues,40292,40,220,330,84,490,229,803,550
14649,Saubusse,40293,40,94,263,106,258,244,608,357
14650,Saugnac-et-Cambran,40294,40,240,368,115,562,266,943,608
14651,Saugnacq-et-Muret,40295,40,92,275,80,224,246,550,367
14652,Seignosse,40296,40,534,862,209,1220,892,2321,1396
14653,Le Sen,40297,40,6,49,12,67,34,113,55
14654,Serres-Gaston,40298,40,46,102,4,120,91,215,148
14655,Serreslous-et-Arribans,40299,40,9,57,12,69,33,114,66
14656,Seyresse,40300,40,108,208,44,304,176,524,316
14657,Siest,40301,40,12,38,4,36,26,66,50
14658,Sindères,40302,40,20,25,35,80,15,130,45
14659,Solférino,40303,40,40,96,16,140,44,200,136
14660,Soorts-Hossegor,40304,40,875,529,245,1479,506,2230,1404
14661,Sorbets,40305,40,44,32,20,44,48,112,76
14662,Sorde-l'Abbaye,40306,40,111,157,33,191,100,324,268
14663,Sore,40307,40,145,230,55,397,180,632,375
14664,Sort-en-Chalosse,40308,40,108,236,35,325,162,522,344
14665,Souprosse,40309,40,148,212,88,416,144,648,360
14666,Soustons,40310,40,1255,1537,489,2638,1474,4601,2792
14667,Taller,40311,40,48,156,48,204,142,394,204
14668,Tarnos,40312,40,1478,2899,1089,4168,2321,7578,4377
14669,Tartas,40313,40,486,655,219,1060,563,1842,1141
14670,Tercis-les-Bains,40314,40,110,250,85,480,240,805,360
14671,Téthieu,40315,40,108,164,32,204,188,424,272
14672,Tilh,40316,40,120,140,88,320,125,533,260
14673,Tosse,40317,40,384,508,162,837,563,1562,892
14674,Toulouzette,40318,40,29,67,20,110,49,179,96
14675,Trensacq,40319,40,45,60,10,85,50,145,105
14676,Uchacq-et-Parentis,40320,40,52,118,42,271,68,381,170
14677,Urgons,40321,40,38,52,6,54,72,132,90
14678,Uza,40322,40,28,24,8,76,16,100,52
14679,Vert,40323,40,22,53,4,99,33,136,75
14680,Vicq-d'Auribat,40324,40,30,80,15,95,50,160,110
14681,Vielle-Tursan,40325,40,20,55,10,100,65,175,75
14682,Vielle-Saint-Girons,40326,40,219,215,90,464,215,769,434
14683,Vielle-Soubiran,40327,40,28,64,16,104,52,172,92
14684,Vieux-Boucau-les-Bains,40328,40,397,204,137,457,283,877,601
14685,Le Vignau,40329,40,56,128,36,156,124,316,184
14686,Villenave,40330,40,64,54,16,79,50,145,118
14687,Villeneuve-de-Marsan,40331,40,373,544,140,776,445,1361,917
14688,Ychoux,40332,40,292,534,148,657,450,1255,826
14689,Ygos-Saint-Saturnin,40333,40,177,262,99,471,234,804,439
14690,Yzosse,40334,40,75,95,10,130,75,215,170
14691,Ambloy,41001,41,25,35,15,60,45,120,60
14692,Angé,41002,41,108,179,100,346,145,591,287
14693,Areines,41003,41,53,107,59,186,93,338,160
14694,Artins,41004,41,70,65,40,95,15,150,135
14695,Arville,41005,41,9,9,3,31,12,46,18
14696,Autainville,41006,41,60,108,24,124,96,244,168
14697,Authon,41007,41,105,168,44,172,190,406,273
14698,Avaray,41008,41,87,196,28,209,135,372,283
14699,Averdon,41009,41,83,148,49,236,131,416,231
14700,Azé,41010,41,104,304,64,360,184,608,408
14701,Baigneaux,41011,41,6,14,0,15,6,21,20
14702,Baillou,41012,41,32,64,24,88,40,152,96
14703,Bauzy,41013,41,52,64,20,84,56,160,116
14704,Beauchêne,41014,41,24,44,8,56,44,108,68
14705,Beauvilliers,41015,41,4,40,0,16,28,44,44
14706,Billy,41016,41,155,240,75,280,245,600,395
14707,Binas,41017,41,120,184,40,232,148,420,304
14708,Blois,41018,41,5719,11295,6820,13159,7934,27913,17014
14709,Boisseau,41019,41,12,32,8,28,28,64,44
14710,Bonneveau,41020,41,62,95,30,187,71,288,157
14711,Bouffry,41022,41,30,30,25,50,15,90,60
14712,Boursay,41024,41,25,35,0,85,20,105,60
14713,Bracieux,41025,41,221,219,84,388,217,689,440
14714,Brévainville,41026,41,20,35,20,55,45,120,55
14715,Briou,41027,41,4,44,16,44,32,92,48
14716,Busloup,41028,41,60,95,60,140,75,275,155
14717,Candé-sur-Beuvron,41029,41,128,405,140,507,302,949,533
14718,Cellé,41030,41,43,48,13,68,38,119,91
14719,Cellettes,41031,41,289,560,185,1061,415,1661,849
14720,Chailles,41032,41,320,625,176,841,465,1482,945
14721,Chambon-sur-Cisse,41033,41,84,132,45,273,94,412,216
14722,Chambord,41034,41,18,6,9,36,16,61,24
14723,Champigny-en-Beauce,41035,41,56,154,36,169,125,330,210
14724,Chaon,41036,41,72,100,28,188,72,288,172
14725,La Chapelle-Enchérie,41037,41,20,60,35,55,40,130,80
14726,La Chapelle-Montmartin,41038,41,66,93,16,110,97,223,159
14727,La Chapelle-Saint-Martin-en-Plaine,41039,41,55,210,80,185,185,450,265
14728,La Chapelle-Vendômoise,41040,41,112,168,44,292,112,448,280
14729,La Chapelle-Vicomtesse,41041,41,28,24,20,68,40,128,52
14730,Châteauvieux,41042,41,80,96,24,192,88,304,176
14731,Châtillon-sur-Cher,41043,41,238,415,150,584,320,1054,653
14732,Châtres-sur-Cher,41044,41,235,205,75,350,155,580,440
14733,Chaumont-sur-Loire,41045,41,210,245,100,350,160,610,455
14734,Chaumont-sur-Tharonne,41046,41,155,278,90,396,162,648,433
14735,La Chaussée-Saint-Victor,41047,41,835,915,410,1445,705,2560,1750
14736,Chauvigny-du-Perche,41048,41,45,50,5,75,30,110,95
14737,Chémery,41049,41,165,219,103,285,203,591,384
14738,Cheverny,41050,41,144,220,80,360,184,624,364
14739,Chissay-en-Touraine,41051,41,220,215,60,308,205,573,435
14740,Chitenay,41052,41,99,260,95,384,204,683,359
14741,Choue,41053,41,55,130,5,230,115,350,185
14742,Choussy,41054,41,25,83,16,101,64,181,108
14743,Chouzy-sur-Cisse,41055,41,228,470,193,670,440,1303,698
14744,Conan,41057,41,15,48,15,71,36,122,63
14745,Concriers,41058,41,8,44,20,52,40,112,52
14746,Contres,41059,41,663,800,319,986,608,1913,1463
14747,Cormenon,41060,41,164,120,60,232,88,380,284
14748,Cormeray,41061,41,95,454,159,490,344,993,549
14749,Couddes,41062,41,94,105,30,138,98,266,199
14750,Couffy,41063,41,75,108,22,181,86,289,183
14751,Coulanges,41064,41,30,53,34,134,31,199,83
14752,Coulommiers-la-Tour,41065,41,64,108,48,172,116,336,172
14753,Courbouzon,41066,41,31,99,24,140,63,227,130
14754,Cour-Cheverny,41067,41,460,514,244,919,387,1550,974
14755,Courmemin,41068,41,88,100,72,160,76,308,188
14756,Cour-sur-Loire,41069,41,54,29,28,97,39,164,83
14757,Couture-sur-Loir,41070,41,155,40,20,120,65,205,195
14758,Crouy-sur-Cosson,41071,41,88,104,32,185,88,305,192
14759,Crucheray,41072,41,65,85,40,140,65,245,150
14760,Danzé,41073,41,75,195,15,292,130,437,270
14761,Dhuizon,41074,41,200,303,81,401,180,662,503
14762,Droué,41075,41,224,165,60,354,120,534,389
14763,Épiais,41077,41,20,35,30,50,5,85,55
14764,Épuisay,41078,41,92,228,88,204,164,456,320
14765,Les Essarts,41079,41,45,30,5,25,15,45,75
14766,Faverolles-sur-Cher,41080,41,210,340,110,430,230,770,550
14767,Faye,41081,41,30,50,10,105,40,155,80
14768,Feings,41082,41,65,220,60,185,180,425,285
14769,La Ferté-Beauharnais,41083,41,89,98,53,172,82,307,187
14770,La Ferté-Imbault,41084,41,212,188,88,320,160,568,400
14771,La Ferté-Saint-Cyr,41085,41,112,232,112,412,184,708,344
14772,Fontaines-en-Sologne,41086,41,89,165,45,195,140,380,254
14773,Fontaine-les-Coteaux,41087,41,60,55,15,157,55,227,115
14774,Fontaine-Raoul,41088,41,19,38,6,97,24,127,57
14775,La Fontenelle,41089,41,20,40,25,65,40,130,60
14776,Fortan,41090,41,16,104,16,96,76,188,120
14777,Fossé,41091,41,84,391,112,364,342,818,475
14778,Fougères-sur-Bièvre,41092,41,108,220,72,216,180,468,328
14779,Françay,41093,41,23,71,12,86,47,145,94
14780,Fresnes,41094,41,158,246,53,367,220,640,404
14781,Fréteval,41095,41,147,262,82,396,178,656,409
14782,Le Gault-Perche,41096,41,79,63,12,111,38,161,142
14783,Gièvres,41097,41,352,392,152,752,316,1220,744
14784,Gombergean,41098,41,15,50,15,70,45,130,65
14785,Gy-en-Sologne,41099,41,70,85,55,215,80,350,155
14786,Les Hayes,41100,41,25,30,15,75,35,125,55
14787,Herbault,41101,41,175,310,125,360,215,700,485
14788,Houssay,41102,41,64,104,16,128,76,220,168
14789,Huisseau-en-Beauce,41103,41,47,96,25,123,80,228,143
14790,Huisseau-sur-Cosson,41104,41,285,565,175,790,420,1385,850
14791,Josnes,41105,41,155,219,60,314,149,523,374
14792,Lamotte-Beuvron,41106,41,820,963,351,1523,852,2726,1783
14793,Lancé,41107,41,68,120,36,144,100,280,188
14794,Lancôme,41108,41,10,35,0,60,25,85,45
14795,Landes-le-Gaulois,41109,41,80,220,44,216,168,428,300
14796,Langon,41110,41,115,211,50,260,165,475,326
14797,Lassay-sur-Croisne,41112,41,32,64,20,112,44,176,96
14798,Lavardin,41113,41,38,23,18,59,22,99,61
14799,Lestiou,41114,41,28,84,48,64,60,172,112
14800,Lignières,41115,41,90,70,10,160,65,235,160
14801,Lisle,41116,41,19,45,13,66,23,102,64
14802,Loreux,41118,41,44,44,0,80,52,132,88
14803,Lorges,41119,41,20,112,52,100,88,240,132
14804,Lunay,41120,41,167,241,56,482,193,731,408
14805,La Madeleine-Villefrouin,41121,41,0,10,10,10,10,30,10
14806,Maray,41122,41,23,38,22,76,32,130,61
14807,Marchenoir,41123,41,99,107,45,139,69,253,206
14808,Marcilly-en-Beauce,41124,41,30,90,25,175,40,240,120
14809,Marcilly-en-Gault,41125,41,139,164,19,234,135,388,303
14810,Mareuil-sur-Cher,41126,41,129,214,61,388,191,640,343
14811,La Marolle-en-Sologne,41127,41,88,104,28,116,72,216,192
14812,Marolles,41128,41,115,195,50,275,115,440,310
14813,Maslives,41129,41,90,203,65,196,168,429,293
14814,Maves,41130,41,40,210,50,235,130,415,250
14815,Mazangé,41131,41,88,240,68,340,168,576,328
14816,Méhers,41132,41,60,80,40,80,80,200,140
14817,Menars,41134,41,76,112,60,288,68,416,188
14818,Mennetou-sur-Cher,41135,41,140,172,84,280,192,556,312
14819,Mer,41136,41,848,1515,616,1937,1140,3693,2363
14820,Mesland,41137,41,76,140,48,184,116,348,216
14821,Meslay,41138,41,60,52,24,136,28,188,112
14822,Meusnes,41139,41,272,264,80,312,160,552,536
14823,Millançay,41140,41,126,147,8,333,90,431,273
14824,Moisy,41141,41,20,119,16,91,91,198,139
14825,Valencisse,41142,41,164,445,72,732,298,1102,609
14826,Mondoubleau,41143,41,412,223,96,454,139,689,635
14827,Monteaux,41144,41,158,180,40,270,145,455,338
14828,Monthou-sur-Bièvre,41145,41,56,283,60,210,212,482,339
14829,Monthou-sur-Cher,41146,41,124,210,105,335,205,645,334
14830,Les Montils,41147,41,216,527,184,608,384,1176,743
14831,Montlivault,41148,41,178,345,82,426,259,767,523
14832,Montoire-sur-le-Loir,41149,41,989,535,280,1335,376,1991,1524
14833,Mont-près-Chambord,41150,41,444,679,272,1201,531,2004,1123
14834,Montrichard Val de Cher,41151,41,770,543,418,1436,515,2369,1313
14835,Montrieux-en-Sologne,41152,41,72,176,80,240,108,428,248
14836,Montrouveau,41153,41,16,21,21,50,21,92,37
14837,Morée,41154,41,215,195,85,325,155,565,410
14838,Muides-sur-Loire,41155,41,191,324,98,371,271,740,515
14839,Mulsans,41156,41,8,147,48,168,129,345,155
14840,Mur-de-Sologne,41157,41,230,405,104,370,320,794,635
14841,Naveil,41158,41,302,562,112,787,365,1264,864
14842,Neung-sur-Beuvron,41159,41,170,240,119,445,175,739,410
14843,Neuvy,41160,41,35,57,22,100,39,161,92
14844,Nouan-le-Fuzelier,41161,41,350,465,215,810,400,1425,815
14845,Nourray,41163,41,15,30,10,55,15,80,45
14846,Noyers-sur-Cher,41164,41,544,587,170,1012,389,1571,1131
14847,Oigny,41165,41,20,20,0,25,20,45,40
14848,Oisly,41166,41,44,88,24,128,68,220,132
14849,Onzain,41167,41,582,771,176,1168,596,1940,1353
14850,Orçay,41168,41,12,68,24,92,44,160,80
14851,Ouchamps,41170,41,50,200,28,295,175,498,250
14852,Oucques,41171,41,255,345,115,470,230,815,600
14853,Ouzouer-le-Doyen,41172,41,30,90,10,44,80,134,120
14854,Beauce la Romaine,41173,41,441,922,258,979,694,1931,1363
14855,Périgny,41174,41,30,35,0,95,20,115,65
14856,Pezou,41175,41,192,236,108,364,176,648,428
14857,Pierrefitte-sur-Sauldre,41176,41,150,125,80,340,95,515,275
14858,Le Plessis-Dorin,41177,41,65,15,0,64,12,76,80
14859,Le Plessis-l'Échelle,41178,41,15,15,5,25,5,35,30
14860,Le Poislay,41179,41,55,35,10,65,25,100,90
14861,Pontlevoy,41180,41,320,336,120,468,240,828,656
14862,Pouillé,41181,41,126,178,47,258,115,420,304
14863,Pray,41182,41,40,105,25,55,80,160,145
14864,Prunay-Cassereau,41184,41,63,155,51,191,102,344,218
14865,Pruniers-en-Sologne,41185,41,315,627,125,905,463,1493,942
14866,Rahart,41186,41,31,85,21,74,62,157,116
14867,Renay,41187,41,28,28,4,60,28,92,56
14868,Rhodon,41188,41,20,40,0,20,45,65,60
14869,Rilly-sur-Loire,41189,41,44,84,52,120,76,248,128
14870,Rocé,41190,41,8,52,20,84,52,156,60
14871,Roches,41191,41,15,20,0,6,21,27,35
14872,Les Roches-l'Évêque,41192,41,6,59,24,102,62,188,65
14873,Romilly,41193,41,36,30,12,72,18,102,66
14874,Romorantin-Lanthenay,41194,41,3065,3667,1480,5751,2717,9948,6732
14875,Rougeou,41195,41,12,29,4,49,22,75,41
14876,Ruan-sur-Egvonne,41196,41,5,20,5,25,30,60,25
14877,Saint-Agil,41197,41,60,45,15,75,60,150,105
14878,Saint-Aignan,41198,41,549,492,257,912,337,1506,1041
14879,Saint-Amand-Longpré,41199,41,128,304,104,360,260,724,432
14880,Sainte-Anne,41200,41,38,99,38,113,76,227,137
14881,Saint-Arnoult,41201,41,51,63,10,97,49,156,114
14882,Saint-Avit,41202,41,10,35,20,25,20,65,45
14883,Saint-Bohaire,41203,41,55,140,40,165,105,310,195
14884,Saint-Claude-de-Diray,41204,41,165,395,117,754,283,1154,560
14885,Saint-Cyr-du-Gault,41205,41,32,32,8,56,40,104,64
14886,Saint-Denis-sur-Loire,41206,41,108,123,41,389,111,541,231
14887,Saint-Dyé-sur-Loire,41207,41,149,220,95,379,225,699,369
14888,Saint-Étienne-des-Guérets,41208,41,9,9,3,33,12,48,18
14889,Saint-Firmin-des-Prés,41209,41,80,216,45,315,166,526,296
14890,Sainte-Gemmes,41210,41,8,24,12,28,24,64,32
14891,Saint-Georges-sur-Cher,41211,41,432,581,152,770,479,1401,1013
14892,Saint-Gervais-la-Forêt,41212,41,555,755,230,1182,500,1912,1310
14893,Saint-Gourgon,41213,41,10,30,0,40,25,65,40
14894,Saint-Hilaire-la-Gravelle,41214,41,72,173,33,227,171,431,245
14895,Saint-Jacques-des-Guérets,41215,41,15,15,10,40,10,60,30
14896,Saint-Jean-Froidmentel,41216,41,64,124,44,136,82,262,188
14897,Saint-Julien-de-Chédon,41217,41,152,148,36,288,112,436,300
14898,Saint-Julien-sur-Cher,41218,41,164,168,44,244,164,452,332
14899,Saint-Laurent-des-Bois,41219,41,60,65,25,85,35,145,125
14900,Saint-Laurent-Nouan,41220,41,395,1111,448,1292,810,2550,1506
14901,Saint-Léonard-en-Beauce,41221,41,48,152,80,240,116,436,200
14902,Saint-Loup,41222,41,35,85,15,120,90,225,120
14903,Saint-Lubin-en-Vergonnois,41223,41,60,172,48,332,112,492,232
14904,Saint-Marc-du-Cor,41224,41,25,40,5,75,40,120,65
14905,Saint-Martin-des-Bois,41225,41,90,108,35,260,97,392,198
14906,Saint-Ouen,41226,41,599,679,179,1262,524,1965,1278
14907,Saint-Rimay,41228,41,44,68,12,108,48,168,112
14908,Saint-Romain-sur-Cher,41229,41,236,348,116,552,260,928,584
14909,Saint-Sulpice-de-Pommeray,41230,41,270,399,101,753,268,1122,669
14910,Saint-Viâtre,41231,41,266,256,100,365,230,695,522
14911,Salbris,41232,41,961,1056,463,1878,841,3182,2017
14912,Sambin,41233,41,100,248,66,296,164,526,348
14913,Santenay,41234,41,48,80,4,88,72,164,128
14914,Sargé-sur-Braye,41235,41,95,265,65,420,230,715,360
14915,Sasnières,41236,41,5,35,0,30,30,60,40
14916,Sassay,41237,41,76,304,61,299,214,574,380
14917,Savigny-sur-Braye,41238,41,335,416,125,725,336,1186,751
14918,Seigy,41239,41,220,180,92,444,152,688,400
14919,Seillac,41240,41,16,14,17,53,0,70,30
14920,Selles-Saint-Denis,41241,41,219,228,89,434,199,722,447
14921,Selles-sur-Cher,41242,41,880,918,330,1532,559,2421,1798
14922,Selommes,41243,41,70,200,65,285,135,485,270
14923,Séris,41245,41,49,105,35,85,90,210,154
14924,Seur,41246,41,30,125,15,235,80,330,155
14925,Soings-en-Sologne,41247,41,246,423,184,459,283,926,669
14926,Souday,41248,41,140,110,20,165,65,250,250
14927,Souesmes,41249,41,288,176,88,420,144,652,464
14928,Sougé,41250,41,79,87,19,159,69,247,166
14929,Souvigny-en-Sologne,41251,41,104,92,32,184,92,308,196
14930,Suèvres,41252,41,168,447,112,551,296,959,615
14931,Talcy,41253,41,45,50,20,85,45,150,95
14932,Le Temple,41254,41,26,38,12,62,16,90,64
14933,Ternay,41255,41,56,92,24,88,64,176,148
14934,Theillay,41256,41,272,244,100,476,220,796,516
14935,Thenay,41257,41,185,180,47,275,140,462,365
14936,Thésée,41258,41,169,255,80,415,235,730,424
14937,Thoré-la-Rochette,41259,41,136,196,61,272,158,491,332
14938,Thoury,41260,41,38,102,19,114,88,221,140
14939,Tourailles,41261,41,12,35,0,46,26,72,47
14940,Tour-en-Sologne,41262,41,88,253,105,353,241,699,341
14941,Tréhet,41263,41,24,12,12,32,8,52,36
14942,Troo,41265,41,58,54,9,86,46,141,112
14943,Valaire,41266,41,25,8,4,16,4,24,33
14944,Vallières-les-Grandes,41267,41,84,249,35,266,168,469,333
14945,Veilleins,41268,41,46,20,8,32,18,58,66
14946,Vendôme,41269,41,3049,3512,1639,5178,2497,9314,6561
14947,Vernou-en-Sologne,41271,41,79,145,16,195,98,309,224
14948,Veuves,41272,41,16,64,16,100,40,156,80
14949,Vievy-le-Rayé,41273,41,88,73,38,157,72,267,161
14950,Villavard,41274,41,30,21,3,56,10,69,51
14951,La Ville-aux-Clercs,41275,41,106,321,72,365,219,656,427
14952,Villebarou,41276,41,279,710,179,867,485,1531,989
14953,Villebout,41277,41,8,21,4,70,12,86,29
14954,Villechauve,41278,41,60,80,15,90,60,165,140
14955,Villedieu-le-Château,41279,41,81,59,25,117,55,197,140
14956,Villefranche-sur-Cher,41280,41,385,598,215,955,480,1650,983
14957,Villefrancoeur,41281,41,27,90,43,137,80,260,117
14958,Villeherviers,41282,41,35,110,10,155,115,280,145
14959,Villemardy,41283,41,28,76,24,72,68,164,104
14960,Villeneuve-Frouville,41284,41,3,12,6,21,3,30,15
14961,Villeny,41285,41,45,130,25,125,140,290,175
14962,Villeporcher,41286,41,12,40,12,56,28,96,52
14963,Villerable,41287,41,70,110,45,210,80,335,180
14964,Villerbon,41288,41,134,200,35,298,130,463,334
14965,Villermain,41289,41,28,98,12,113,87,212,126
14966,Villeromain,41290,41,32,69,16,53,64,133,101
14967,Villetrun,41291,41,45,90,10,80,90,180,135
14968,Villexanton,41292,41,10,35,25,85,30,140,45
14969,Villiersfaux,41293,41,10,70,15,115,60,190,80
14970,Villiers-sur-Loir,41294,41,115,274,100,474,194,768,389
14971,Vineuil,41295,41,989,1735,515,2707,1239,4461,2724
14972,Vouzon,41296,41,151,374,107,445,287,839,525
14973,Yvoy-le-Marron,41297,41,84,116,44,196,108,348,200
14974,Aboën,42001,42,30,108,48,109,83,240,138
14975,Ailleux,42002,42,28,24,28,60,12,100,52
14976,Ambierle,42003,42,216,488,74,692,316,1082,704
14977,Amions,42004,42,36,60,32,112,44,188,96
14978,Andrézieux-Bouthéon,42005,42,901,2553,1250,3014,1819,6083,3454
14979,Apinac,42006,42,68,92,16,156,68,240,160
14980,Arcinges,42007,42,30,45,20,46,25,91,75
14981,Arcon,42008,42,28,16,4,32,20,56,44
14982,Arthun,42009,42,44,124,64,228,100,392,168
14983,Aveizieux,42010,42,136,433,116,493,357,966,569
14984,Balbigny,42011,42,400,810,245,850,528,1623,1210
14985,Bard,42012,42,63,170,20,278,115,413,233
14986,Bellegarde-en-Forez,42013,42,190,595,100,565,410,1075,785
14987,Belleroche,42014,42,20,65,35,135,50,220,85
14988,Belmont-de-la-Loire,42015,42,240,316,140,568,228,936,556
14989,La Bénisson-Dieu,42016,42,35,102,33,144,72,249,137
14990,Le Bessat,42017,42,20,93,57,178,55,290,113
14991,Bessey,42018,42,25,135,25,150,95,270,160
14992,Boën-sur-Lignon,42019,42,615,600,310,1020,470,1800,1215
14993,Boisset-lès-Montrond,42020,42,74,340,99,316,269,684,414
14994,Boisset-Saint-Priest,42021,42,100,320,65,428,265,758,420
14995,Bonson,42022,42,415,851,338,1446,672,2456,1266
14996,Bourg-Argental,42023,42,436,658,221,919,509,1649,1094
14997,Boyer,42025,42,5,65,25,80,35,140,70
14998,Briennon,42026,42,255,400,105,573,320,998,655
14999,Bully,42027,42,28,128,28,144,92,264,156
15000,Burdignes,42028,42,37,71,24,110,45,179,108
15001,Bussières,42029,42,192,416,120,452,280,852,608
15002,Bussy-Albieux,42030,42,77,140,12,130,110,252,217
15003,Caloire,42031,42,20,104,24,148,56,228,124
15004,Cellieu,42032,42,132,447,168,619,300,1087,579
15005,Le Cergne,42033,42,75,160,55,259,125,439,235
15006,Cervières,42034,42,10,20,10,45,20,75,30
15007,Cezay,42035,42,53,55,25,87,30,142,108
15008,Chagnon,42036,42,33,110,68,163,68,299,143
15009,Chalain-d'Uzore,42037,42,55,155,20,169,125,314,210
15010,Chalain-le-Comtal,42038,42,34,189,75,165,183,423,223
15011,Chalmazel-Jeansagnière,42039,42,88,85,28,149,68,245,173
15012,La Chamba,42040,42,0,25,5,20,20,45,25
15013,Chambéon,42041,42,16,140,48,184,124,356,156
15014,Chambles,42042,42,93,252,51,310,206,567,345
15015,Chamboeuf,42043,42,156,452,92,571,284,947,608
15016,Le Chambon-Feugerolles,42044,42,1742,3155,1322,3892,1938,7152,4897
15017,La Chambonie,42045,42,9,6,3,9,9,21,15
15018,Champdieu,42046,42,180,421,161,569,387,1117,601
15019,Champoly,42047,42,52,77,20,96,68,184,129
15020,Chandon,42048,42,154,350,134,458,233,825,504
15021,Changy,42049,42,45,142,60,236,74,370,187
15022,La Chapelle-en-Lafaye,42050,42,47,30,0,20,30,50,77
15023,La Chapelle-Villars,42051,42,36,164,24,180,120,324,200
15024,Charlieu,42052,42,643,779,417,1088,588,2093,1422
15025,Châteauneuf,42053,42,196,376,88,553,296,937,572
15026,Châtelneuf,42054,42,19,75,46,53,76,175,94
15027,Châtelus,42055,42,0,30,20,55,15,90,30
15028,Chavanay,42056,42,315,703,340,897,538,1775,1018
15029,Chazelles-sur-Lavieu,42058,42,12,90,8,113,68,189,102
15030,Chazelles-sur-Lyon,42059,42,864,1171,593,1408,925,2926,2035
15031,Chenereilles,42060,42,28,144,32,172,136,340,172
15032,Cherier,42061,42,131,119,51,88,86,225,250
15033,Chevrières,42062,42,92,364,56,280,276,612,456
15034,Chirassimont,42063,42,21,100,27,117,82,226,121
15035,Chuyer,42064,42,75,205,45,290,145,480,280
15036,Civens,42065,42,124,376,104,504,248,856,500
15037,Cleppé,42066,42,48,164,36,216,120,372,212
15038,Colombier,42067,42,35,55,30,125,30,185,90
15039,Combre,42068,42,32,152,4,118,100,222,184
15040,Commelle-Vernay,42069,42,389,663,134,1120,469,1723,1052
15041,Cordelle,42070,42,100,220,65,310,150,525,320
15042,Le Coteau,42071,42,1415,1217,636,2205,907,3748,2632
15043,La Côte-en-Couzan,42072,42,10,10,10,30,10,50,20
15044,Cottance,42073,42,68,170,66,201,135,402,238
15045,Coutouvre,42074,42,169,235,110,388,160,658,404
15046,Craintilleux,42075,42,72,408,80,380,284,744,480
15047,Cremeaux,42076,42,108,200,76,300,212,588,308
15048,Croizet-sur-Gand,42077,42,44,88,32,84,72,188,132
15049,Le Crozet,42078,42,45,60,15,115,40,170,105
15050,Cuinzier,42079,42,80,240,35,155,215,405,320
15051,Cuzieu,42081,42,90,401,149,429,310,888,491
15052,Dancé,42082,42,17,49,4,43,46,93,66
15053,Dargoire,42083,42,29,128,18,168,121,307,157
15054,Débats-Rivière-d'Orpra,42084,42,10,30,15,70,25,110,40
15055,Doizieux,42085,42,50,240,75,320,155,550,290
15056,Écoche,42086,42,80,160,32,172,104,308,240
15057,Écotay-l'Olme,42087,42,158,314,44,492,201,737,472
15058,Épercieux-Saint-Paul,42088,42,44,220,56,228,144,428,264
15059,Essertines-en-Châtelneuf,42089,42,38,182,57,261,115,433,220
15060,Essertines-en-Donzy,42090,42,30,165,55,150,110,315,195
15061,Estivareilles,42091,42,108,188,40,248,100,388,296
15062,L'Étrat,42092,42,375,555,255,965,410,1630,930
15063,Farnay,42093,42,111,393,82,491,255,828,504
15064,Feurs,42094,42,1574,1626,687,2506,1215,4408,3200
15065,Firminy,42095,42,3215,3728,1711,5312,2434,9457,6943
15066,Fontanès,42096,42,59,192,64,218,95,377,251
15067,La Fouillouse,42097,42,567,994,459,1351,777,2587,1561
15068,Fourneaux,42098,42,60,185,25,200,120,345,245
15069,Fraisses,42099,42,635,863,352,1250,597,2199,1498
15070,La Gimond,42100,42,40,80,15,75,55,145,120
15071,Graix,42101,42,12,24,14,51,15,80,36
15072,Grammond,42102,42,85,259,88,235,155,478,344
15073,La Grand-Croix,42103,42,515,1433,505,1465,930,2900,1948
15074,La Gresle,42104,42,95,180,130,220,150,500,275
15075,Grézieux-le-Fromental,42105,42,8,56,20,72,28,120,64
15076,Grézolles,42106,42,55,40,30,100,55,185,95
15077,Gumières,42107,42,45,70,15,130,55,200,115
15078,L'Hôpital-le-Grand,42108,42,80,297,96,216,276,588,377
15079,L'Hôpital-sous-Rochefort,42109,42,10,15,5,50,30,85,25
15080,L'Horme,42110,42,644,1167,657,1556,679,2892,1811
15081,Jarnosse,42112,42,40,150,15,118,120,253,190
15082,Jas,42113,42,40,65,5,60,55,120,105
15083,Jonzieux,42115,42,130,275,100,375,235,710,405
15084,Juré,42116,42,54,35,4,71,39,114,89
15085,Lavieu,42117,42,10,20,5,35,25,65,30
15086,Lay,42118,42,88,160,60,192,124,376,248
15087,Leigneux,42119,42,85,80,45,130,55,230,165
15088,Lentigny,42120,42,161,408,115,601,306,1022,569
15089,Lérigneux,42121,42,25,25,0,55,50,105,50
15090,Lézigneux,42122,42,116,522,75,547,385,1007,638
15091,Lorette,42123,42,597,1075,557,1571,806,2934,1672
15092,Lupé,42124,42,45,85,40,90,70,200,130
15093,Luré,42125,42,32,32,4,60,28,92,64
15094,Luriecq,42126,42,97,407,62,346,278,686,504
15095,Mably,42127,42,1256,1732,531,2649,1129,4309,2988
15096,Machézal,42128,42,40,105,20,145,95,260,145
15097,Maclas,42129,42,246,415,123,549,373,1045,661
15098,Magneux-Haute-Rive,42130,42,26,156,31,145,133,309,182
15099,Maizilly,42131,42,25,115,25,85,100,210,140
15100,Malleval,42132,42,68,172,20,200,108,328,240
15101,Marcenod,42133,42,60,210,100,180,140,420,270
15102,Marcilly-le-Châtel,42134,42,105,380,130,483,285,898,485
15103,Marclopt,42135,42,16,150,49,150,107,306,166
15104,Marcoux,42136,42,105,185,85,260,120,465,290
15105,Margerie-Chantagret,42137,42,69,222,81,206,182,469,291
15106,Maringes,42138,42,65,180,95,195,120,410,245
15107,Marlhes,42139,42,145,287,105,455,170,730,432
15108,Marols,42140,42,115,115,25,110,85,220,230
15109,Mars,42141,42,59,128,48,166,103,317,187
15110,Merle-Leignec,42142,42,40,45,29,105,51,185,85
15111,Mizérieux,42143,42,5,110,35,118,130,283,115
15112,Montagny,42145,42,165,271,120,305,145,570,436
15113,Montarcher,42146,42,6,9,0,28,3,31,15
15114,Montbrison,42147,42,2308,3494,1880,4725,2662,9267,5802
15115,Montchal,42148,42,64,140,32,124,148,304,204
15116,Montrond-les-Bains,42149,42,786,1190,483,1760,842,3085,1976
15117,Montverdun,42150,42,141,332,71,337,264,672,473
15118,Mornand-en-Forez,42151,42,63,67,42,97,56,195,130
15119,Nandax,42152,42,15,160,50,140,95,285,175
15120,Neaux,42153,42,45,125,50,165,100,315,170
15121,Néronde,42154,42,26,57,69,174,50,293,83
15122,Nervieux,42155,42,114,251,81,286,173,540,365
15123,Neulise,42156,42,144,312,144,332,264,740,456
15124,Noailly,42157,42,64,224,96,252,152,500,288
15125,Les Noës,42158,42,24,60,5,60,50,115,84
15126,Noirétable,42159,42,321,291,125,552,210,887,612
15127,Nollieux,42160,42,45,60,20,30,45,95,105
15128,Notre-Dame-de-Boisset,42161,42,31,143,22,192,109,323,174
15129,Ouches,42162,42,130,295,60,455,210,725,425
15130,La Pacaudière,42163,42,176,196,100,332,144,576,372
15131,Palogneux,42164,42,0,20,10,40,5,55,20
15132,Panissières,42165,42,496,674,284,940,479,1703,1170
15133,Parigny,42166,42,30,195,30,220,115,365,225
15134,Pavezin,42167,42,45,100,20,130,70,220,145
15135,Pélussin,42168,42,404,883,397,1157,703,2257,1287
15136,Périgneux,42169,42,140,389,75,470,373,918,529
15137,Perreux,42170,42,274,542,145,680,385,1210,816
15138,Pinay,42171,42,28,84,16,92,64,172,112
15139,Planfoy,42172,42,136,252,76,328,220,624,388
15140,Pommiers,42173,42,51,76,34,107,43,184,127
15141,Poncins,42174,42,92,276,40,336,224,600,368
15142,Pouilly-lès-Feurs,42175,42,120,330,90,465,239,794,450
15143,Pouilly-les-Nonains,42176,42,211,514,169,695,370,1234,725
15144,Pouilly-sous-Charlieu,42177,42,525,550,155,855,440,1450,1075
15145,Pradines,42178,42,72,223,49,196,158,403,295
15146,Pralong,42179,42,45,260,50,375,180,605,305
15147,Précieux,42180,42,100,215,105,345,175,625,315
15148,Régny,42181,42,190,383,120,562,210,892,573
15149,Renaison,42182,42,424,655,190,1154,510,1854,1079
15150,La Ricamarie,42183,42,942,2196,951,2501,1270,4722,3138
15151,Riorges,42184,42,1921,2308,889,3817,1580,6286,4229
15152,Rivas,42185,42,25,188,35,188,125,348,213
15153,Rive-de-Gier,42186,42,1859,3979,1640,4069,2867,8576,5838
15154,Roanne,42187,42,6365,7203,4577,10235,5424,20236,13568
15155,Roche,42188,42,37,48,20,79,47,146,85
15156,Roche-la-Molière,42189,42,1220,2293,900,3605,1720,6225,3513
15157,Roisey,42191,42,88,232,76,308,172,556,320
15158,Rozier-Côtes-d'Aurec,42192,42,54,128,5,134,137,276,182
15159,Rozier-en-Donzy,42193,42,200,409,110,457,291,858,609
15160,Sail-les-Bains,42194,42,46,21,37,52,4,93,67
15161,Sail-sous-Couzan,42195,42,170,175,45,325,195,565,345
15162,Sainte-Agathe-en-Donzy,42196,42,0,8,16,47,24,87,8
15163,Sainte-Agathe-la-Bouteresse,42197,42,145,235,119,398,140,657,380
15164,Saint-Alban-les-Eaux,42198,42,113,218,51,305,156,512,331
15165,Saint-André-d'Apchon,42199,42,288,476,100,708,332,1140,764
15166,Saint-André-le-Puy,42200,42,164,385,115,545,250,910,549
15167,Saint-Appolinard,42201,42,116,158,25,185,111,321,274
15168,Saint-Barthélemy-Lestra,42202,42,81,194,52,223,91,366,275
15169,Saint-Bonnet-des-Quarts,42203,42,51,63,10,155,71,236,114
15170,Saint-Bonnet-le-Château,42204,42,326,270,150,417,240,807,596
15171,Saint-Bonnet-le-Courreau,42205,42,105,150,50,265,130,445,255
15172,Saint-Bonnet-les-Oules,42206,42,170,424,91,546,337,974,594
15173,Saint-Chamond,42207,42,5129,8407,3832,11061,5879,20772,13536
15174,Saint-Christo-en-Jarez,42208,42,120,535,180,570,400,1150,655
15175,Sainte-Colombe-sur-Gand,42209,42,20,112,40,144,104,288,132
15176,Sainte-Croix-en-Jarez,42210,42,43,111,29,149,81,259,154
15177,Saint-Cyprien,42211,42,192,673,189,861,470,1520,865
15178,Saint-Cyr-de-Favières,42212,42,56,253,68,269,179,516,309
15179,Saint-Cyr-de-Valorges,42213,42,55,90,20,90,55,165,145
15180,Saint-Cyr-les-Vignes,42214,42,44,248,84,321,208,613,292
15181,Saint-Denis-de-Cabanne,42215,42,245,290,130,395,215,740,535
15182,Saint-Denis-sur-Coise,42216,42,28,229,48,165,157,370,257
15183,Saint-Didier-sur-Rochefort,42217,42,55,46,29,128,63,220,101
15184,Saint-Étienne,42218,42,24724,39563,25911,45913,30026,101850,64287
15185,Saint-Étienne-le-Molard,42219,42,123,263,80,270,187,537,386
15186,Saint-Forgeux-Lespinasse,42220,42,60,194,39,109,162,310,254
15187,Sainte-Foy-Saint-Sulpice,42221,42,55,151,10,165,130,305,206
15188,Saint-Galmier,42222,42,566,1248,548,1927,944,3419,1814
15189,Saint-Genest-Lerpt,42223,42,765,1403,734,1988,1016,3738,2168
15190,Saint-Genest-Malifaux,42224,42,340,695,250,950,510,1710,1035
15191,Genilac,42225,42,426,1059,390,1114,727,2231,1485
15192,Saint-Georges-de-Baroille,42226,42,56,112,60,88,88,236,168
15193,Saint-Georges-en-Couzan,42227,42,72,68,40,172,68,280,140
15194,Saint-Georges-Haute-Ville,42228,42,120,349,136,469,285,890,469
15195,Saint-Germain-la-Montagne,42229,42,4,39,4,123,31,158,43
15196,Saint-Germain-Laval,42230,42,280,335,105,545,285,935,615
15197,Saint-Germain-Lespinasse,42231,42,193,278,139,329,208,676,471
15198,Saint-Haon-le-Châtel,42232,42,85,145,60,225,90,375,230
15199,Saint-Haon-le-Vieux,42233,42,85,245,60,360,200,620,330
15200,Saint-Héand,42234,42,500,813,339,1164,549,2052,1313
15201,Saint-Hilaire-Cusson-la-Valmitte,42235,42,51,81,9,72,62,143,132
15202,Saint-Hilaire-sous-Charlieu,42236,42,30,162,48,143,124,315,192
15203,Saint-Jean-Bonnefonds,42237,42,765,1671,691,2230,1228,4149,2436
15204,Saint-Jean-la-Vêtre,42238,42,73,44,18,103,52,173,117
15205,Saint-Jean-Saint-Maurice-sur-Loire,42239,42,136,295,71,354,217,642,431
15206,Saint-Jean-Soleymieux,42240,42,90,192,30,252,151,433,282
15207,Saint-Jodard,42241,42,60,80,50,90,55,195,140
15208,Saint-Joseph,42242,42,233,518,115,639,393,1147,751
15209,Saint-Julien-d'Oddes,42243,42,55,80,20,60,60,140,135
15210,Saint-Julien-la-Vêtre,42245,42,90,60,25,145,40,210,150
15211,Saint-Julien-Molin-Molette,42246,42,125,252,90,372,222,684,377
15212,Saint-Just-en-Bas,42247,42,25,70,15,140,45,200,95
15213,Saint-Just-en-Chevalet,42248,42,167,183,51,413,143,607,350
15214,Saint-Just-la-Pendue,42249,42,301,385,100,464,292,856,686
15215,Saint-Laurent-la-Conche,42251,42,40,165,65,228,130,423,205
15216,Saint-Laurent-Rochefort,42252,42,42,45,6,69,44,119,87
15217,Saint-Léger-sur-Roanne,42253,42,150,310,30,380,230,640,460
15218,Saint-Marcel-de-Félines,42254,42,68,184,64,256,196,516,252
15219,Saint-Marcel-d'Urfé,42255,42,50,70,35,110,25,170,120
15220,Saint-Marcellin-en-Forez,42256,42,447,1221,476,1383,957,2816,1668
15221,Saint-Martin-d'Estréaux,42257,42,195,191,25,325,105,455,386
15222,Saint-Martin-la-Plaine,42259,42,385,910,455,1330,660,2445,1295
15223,Saint-Martin-la-Sauveté,42260,42,110,220,80,370,185,635,330
15224,Saint-Martin-Lestra,42261,42,60,290,90,235,215,540,350
15225,Saint-Maurice-en-Gourgois,42262,42,148,555,142,494,367,1003,703
15226,Saint-Médard-en-Forez,42264,42,90,310,80,330,250,660,400
15227,Saint-Michel-sur-Rhône,42265,42,98,204,45,304,165,514,302
15228,Saint-Nizier-de-Fornas,42266,42,155,145,55,210,110,375,300
15229,Saint-Nizier-sous-Charlieu,42267,42,201,375,110,578,325,1013,576
15230,Saint-Paul-de-Vézelin,42268,42,52,68,24,100,56,180,120
15231,Saint-Paul-d'Uzore,42269,42,12,38,8,45,29,82,50
15232,Saint-Paul-en-Cornillon,42270,42,62,304,104,481,260,845,366
15233,Saint-Paul-en-Jarez,42271,42,492,1227,444,1393,812,2649,1719
15234,Saint-Pierre-de-Boeuf,42272,42,172,424,204,572,288,1064,596
15235,Saint-Pierre-la-Noaille,42273,42,36,104,32,108,84,224,140
15236,Saint-Polgues,42274,42,18,46,22,103,31,156,64
15237,Saint-Priest-en-Jarez,42275,42,737,1199,673,2099,965,3737,1936
15238,Saint-Priest-la-Prugne,42276,42,85,70,22,149,57,228,155
15239,Saint-Priest-la-Roche,42277,42,56,100,32,96,68,196,156
15240,Saint-Priest-la-Vêtre,42278,42,12,36,16,44,44,104,48
15241,Saint-Just-Saint-Rambert,42279,42,1651,3361,1370,4674,2532,8576,5012
15242,Saint-Régis-du-Coin,42280,42,35,125,45,100,90,235,160
15243,Saint-Rirand,42281,42,9,28,0,35,32,67,37
15244,Saint-Romain-d'Urfé,42282,42,40,40,5,124,15,144,80
15245,Saint-Romain-en-Jarez,42283,42,113,337,75,332,285,692,450
15246,Saint-Romain-la-Motte,42284,42,145,336,87,558,258,903,481
15247,Saint-Romain-le-Puy,42285,42,437,1114,292,1130,839,2261,1551
15248,Saint-Romain-les-Atheux,42286,42,72,276,112,312,232,656,348
15249,Saint-Sauveur-en-Rue,42287,42,95,215,80,380,200,660,310
15250,Saint-Sixte,42288,42,96,172,56,244,164,464,268
15251,Saint-Symphorien-de-Lay,42289,42,235,515,120,570,350,1040,750
15252,Saint-Thomas-la-Garde,42290,42,60,140,16,217,98,331,200
15253,Saint-Thurin,42291,42,38,30,18,46,18,82,68
15254,Saint-Victor-sur-Rhins,42293,42,140,338,100,328,236,664,478
15255,Saint-Vincent-de-Boisset,42294,42,128,215,40,335,148,523,343
15256,Les Salles,42295,42,49,106,49,125,87,261,155
15257,Salt-en-Donzy,42296,42,80,135,30,160,115,305,215
15258,Salvizinet,42297,42,66,150,34,238,87,359,216
15259,Sauvain,42298,42,60,68,28,168,60,256,128
15260,Savigneux,42299,42,426,801,436,1124,610,2170,1227
15261,Sevelinges,42300,42,70,185,35,235,120,390,255
15262,Soleymieux,42301,42,75,145,90,220,105,415,220
15263,Sorbiers,42302,42,995,2016,689,2811,1422,4922,3011
15264,Souternon,42303,42,44,44,12,160,28,200,88
15265,Sury-le-Comtal,42304,42,706,1774,639,1617,1280,3536,2480
15266,La Talaudière,42305,42,997,1232,643,2036,876,3555,2229
15267,Tarentaise,42306,42,26,112,17,224,47,288,138
15268,Tartaras,42307,42,39,241,82,197,205,484,280
15269,La Terrasse-sur-Dorlay,42308,42,41,183,112,233,143,488,224
15270,Thélis-la-Combe,42310,42,25,30,15,60,35,110,55
15271,La Tour-en-Jarez,42311,42,112,384,124,468,272,864,496
15272,La Tourette,42312,42,69,140,44,193,98,335,209
15273,Trelins,42313,42,80,135,55,250,115,420,215
15274,La Tuilière,42314,42,40,38,16,120,29,165,78
15275,Unias,42315,42,10,140,45,130,125,300,150
15276,Unieux,42316,42,1303,2378,836,2687,1612,5135,3681
15277,Urbise,42317,42,20,40,0,55,30,85,60
15278,Usson-en-Forez,42318,42,247,266,70,507,239,816,513
15279,Valeille,42319,42,74,206,48,167,150,365,280
15280,Valfleury,42320,42,68,214,33,127,154,314,282
15281,La Valla-sur-Rochefort,42321,42,16,0,16,34,6,56,16
15282,La Valla-en-Gier,42322,42,58,272,96,249,228,573,330
15283,Veauche,42323,42,983,2086,817,3193,1644,5654,3069
15284,Veauchette,42324,42,48,371,92,330,294,716,419
15285,Vendranges,42325,42,40,110,30,120,50,200,150
15286,Véranne,42326,42,70,215,55,340,140,535,285
15287,Vérin,42327,42,40,160,55,288,135,478,200
15288,Verrières-en-Forez,42328,42,76,164,36,224,132,392,240
15289,La Versanne,42329,42,48,80,24,116,92,232,128
15290,Villars,42330,42,1170,1860,751,2921,1300,4972,3030
15291,Villemontais,42331,42,108,224,86,393,134,613,332
15292,Villerest,42332,42,467,1069,373,1887,807,3067,1536
15293,Villers,42333,42,80,160,45,175,115,335,240
15294,Violay,42334,42,210,324,95,400,195,690,534
15295,Viricelles,42335,42,60,130,35,135,115,285,190
15296,Virigneux,42336,42,66,180,34,201,119,354,246
15297,Vivans,42337,42,41,57,37,30,30,97,98
15298,Vougy,42338,42,196,296,80,609,220,909,492
15299,Chausseterre,42339,42,56,44,4,96,52,152,100
15300,Agnat,43001,43,35,35,5,75,40,120,70
15301,Aiguilhe,43002,43,288,340,88,588,240,916,628
15302,Allègre,43003,43,192,138,35,298,105,438,330
15303,Alleyrac,43004,43,24,28,0,44,20,64,52
15304,Alleyras,43005,43,79,30,0,44,20,64,109
15305,Ally,43006,43,30,25,10,60,25,95,55
15306,Araules,43007,43,43,144,23,228,85,336,187
15307,Arlempdes,43008,43,33,9,0,43,12,55,42
15308,Arlet,43009,43,0,10,0,15,10,25,10
15309,Arsac-en-Velay,43010,43,100,375,70,400,275,745,475
15310,Aubazat,43011,43,26,39,6,53,35,94,65
15311,Aurec-sur-Loire,43012,43,676,1680,444,1887,1219,3550,2356
15312,Vissac-Auteyrac,43013,43,83,65,30,110,55,195,148
15313,Autrac,43014,43,5,5,5,35,5,45,10
15314,Auvers,43015,43,12,8,0,24,12,36,20
15315,Auzon,43016,43,117,145,81,323,119,523,262
15316,Azérat,43017,43,16,44,9,103,43,155,60
15317,Bains,43018,43,126,340,64,397,291,752,466
15318,Barges,43019,43,9,13,0,31,12,43,22
15319,Bas-en-Basset,43020,43,583,1001,371,1521,699,2591,1584
15320,Beaulieu,43021,43,140,220,112,320,152,584,360
15321,Beaumont,43022,43,25,70,10,95,75,180,95
15322,Beaune-sur-Arzon,43023,43,24,60,12,92,44,148,84
15323,Beaux,43024,43,80,172,60,268,132,460,252
15324,Beauzac,43025,43,317,691,231,879,599,1709,1008
15325,Bellevue-la-Montagne,43026,43,59,90,30,160,75,265,149
15326,Berbezit,43027,43,5,5,0,30,5,35,10
15327,Bessamorel,43028,43,60,132,20,96,112,228,192
15328,La Besseyre-Saint-Mary,43029,43,21,26,10,26,21,57,47
15329,Blanzac,43030,43,25,80,60,105,70,235,105
15330,Blassac,43031,43,45,20,10,75,20,105,65
15331,Blavozy,43032,43,214,380,114,601,252,967,594
15332,Blesle,43033,43,83,92,62,246,94,402,175
15333,Boisset,43034,43,16,74,26,85,56,167,90
15334,Bonneval,43035,43,20,0,0,40,0,40,20
15335,Borne,43036,43,42,116,32,90,96,218,158
15336,Le Bouchet-Saint-Nicolas,43037,43,44,68,20,68,52,140,112
15337,Bournoncle-Saint-Pierre,43038,43,102,192,115,294,203,612,294
15338,Le Brignon,43039,43,73,113,47,189,98,334,186
15339,Brioude,43040,43,1246,1245,575,2252,997,3824,2491
15340,Brives-Charensac,43041,43,612,726,480,1548,575,2603,1338
15341,Cayres,43042,43,75,173,56,150,162,368,248
15342,Céaux-d'Allègre,43043,43,107,90,40,137,53,230,197
15343,Cerzat,43044,43,4,32,28,112,20,160,36
15344,Ceyssac,43045,43,33,73,21,154,81,256,106
15345,Chadrac,43046,43,369,495,219,1022,382,1623,864
15346,Chadron,43047,43,21,70,15,91,65,171,91
15347,La Chaise-Dieu,43048,43,65,100,69,253,84,406,165
15348,Chamalières-sur-Loire,43049,43,105,105,20,185,85,290,210
15349,Chambezon,43050,43,10,30,0,45,25,70,40
15350,Le Chambon-sur-Lignon,43051,43,492,399,138,921,340,1399,891
15351,Champagnac-le-Vieux,43052,43,75,50,0,80,25,105,125
15352,Champclause,43053,43,20,40,15,120,15,150,60
15353,Chanaleilles,43054,43,33,38,0,54,40,94,71
15354,Chaniat,43055,43,22,34,24,45,26,95,56
15355,Chanteuges,43056,43,60,104,44,152,88,284,164
15356,La Chapelle-Bertin,43057,43,0,5,5,42,0,47,5
15357,La Chapelle-d'Aurec,43058,43,66,349,41,215,254,510,415
15358,La Chapelle-Geneste,43059,43,45,10,10,35,5,50,55
15359,Charraix,43060,43,16,28,0,20,28,48,44
15360,Chaspinhac,43061,43,48,228,64,288,152,504,276
15361,Chaspuzac,43062,43,24,212,40,268,192,500,236
15362,Chassagnes,43063,43,19,26,23,55,23,101,45
15363,Chassignolles,43064,43,15,10,0,40,5,45,25
15364,Chastel,43065,43,50,15,15,40,15,70,65
15365,Chaudeyrolles,43066,43,0,25,5,65,5,75,25
15366,Chavaniac-Lafayette,43067,43,38,52,24,83,30,137,90
15367,Chazelles,43068,43,4,8,0,16,8,24,12
15368,Chenereilles,43069,43,56,77,16,73,53,142,133
15369,Chilhac,43070,43,48,32,16,60,40,116,80
15370,Chomelix,43071,43,65,90,40,185,90,315,155
15371,La Chomette,43072,43,48,40,16,40,20,76,88
15372,Cistrières,43073,43,40,15,0,55,25,80,55
15373,Cohade,43074,43,50,230,65,324,185,574,280
15374,Collat,43075,43,21,12,0,15,15,30,33
15375,Connangles,43076,43,42,26,0,39,29,68,68
15376,Costaros,43077,43,97,136,40,184,109,333,233
15377,Coubon,43078,43,329,757,187,1165,534,1886,1086
15378,Couteuges,43079,43,50,55,15,80,40,135,105
15379,Craponne-sur-Arzon,43080,43,421,342,121,760,244,1125,763
15380,Cronce,43082,43,4,24,8,20,28,56,28
15381,Cubelles,43083,43,28,26,0,32,34,66,54
15382,Cussac-sur-Loire,43084,43,156,453,136,605,393,1134,609
15383,Desges,43085,43,25,10,0,5,20,25,35
15384,Domeyrat,43086,43,40,50,15,70,30,115,90
15385,Dunières,43087,43,434,658,227,961,535,1723,1092
15386,Espalem,43088,43,30,70,25,80,80,185,100
15387,Espaly-Saint-Marcel,43089,43,405,795,385,1265,600,2250,1200
15388,Esplantas-Vazeilles,43090,43,38,15,10,38,20,68,53
15389,Les Estables,43091,43,40,70,30,130,45,205,110
15390,Fay-sur-Lignon,43092,43,130,73,29,77,42,148,203
15391,Félines,43093,43,30,63,8,132,39,179,93
15392,Ferrussac,43094,43,25,15,5,30,10,45,40
15393,Fix-Saint-Geneys,43095,43,30,35,10,25,30,65,65
15394,Fontannes,43096,43,85,240,100,315,185,600,325
15395,Freycenet-la-Cuche,43097,43,24,16,3,34,9,46,40
15396,Freycenet-la-Tour,43098,43,18,9,0,36,16,52,27
15397,Frugerès-les-Mines,43099,43,75,120,70,206,95,371,195
15398,Frugières-le-Pin,43100,43,14,32,12,61,13,86,46
15399,Goudet,43101,43,8,8,0,28,4,32,16
15400,Grazac,43102,43,80,310,65,303,260,628,390
15401,Grenier-Montgon,43103,43,20,20,10,45,20,75,40
15402,Grèzes,43104,43,25,30,5,80,45,130,55
15403,Javaugues,43105,43,20,45,10,80,61,151,65
15404,Jax,43106,43,28,32,20,20,28,68,60
15405,Josat,43107,43,30,3,9,25,0,34,33
15406,Jullianges,43108,43,75,75,35,170,70,275,150
15407,Lafarre,43109,43,8,8,0,36,8,44,16
15408,Lamothe,43110,43,65,213,104,325,159,588,278
15409,Landos,43111,43,180,185,45,325,155,525,365
15410,Langeac,43112,43,703,630,265,1446,445,2156,1333
15411,Lantriac,43113,43,188,484,180,592,380,1152,672
15412,Lapte,43114,43,248,468,164,508,308,980,716
15413,Laussonne,43115,43,135,180,85,395,170,650,315
15414,Laval-sur-Doulon,43116,43,10,0,0,40,0,40,10
15415,Lavaudieu,43117,43,56,52,4,68,48,120,108
15416,Lavoûte-Chilhac,43118,43,55,50,15,115,30,160,105
15417,Lavoûte-sur-Loire,43119,43,100,199,92,290,145,527,299
15418,Lempdes-sur-Allagnon,43120,43,148,326,89,405,278,772,474
15419,Léotoing,43121,43,30,45,15,85,55,155,75
15420,Lissac,43122,43,30,55,10,110,55,175,85
15421,Lorlanges,43123,43,13,87,38,102,80,220,100
15422,Loudes,43124,43,91,216,89,301,147,537,307
15423,Lubilhac,43125,43,35,5,0,20,20,40,40
15424,Malrevers,43126,43,60,150,65,265,135,465,210
15425,Malvalette,43127,43,63,221,31,232,191,454,284
15426,Malvières,43128,43,16,24,20,44,24,88,40
15427,Le Mas-de-Tence,43129,43,32,44,8,56,44,108,76
15428,Mazet-Saint-Voy,43130,43,230,210,60,475,145,680,440
15429,Mazerat-Aurouze,43131,43,40,40,8,92,28,128,80
15430,Mazeyrat-d'Allier,43132,43,198,384,155,518,270,943,582
15431,Mercoeur,43133,43,45,25,5,45,30,80,70
15432,Mézères,43134,43,12,48,0,56,40,96,60
15433,Le Monastier-sur-Gazeille,43135,43,276,324,108,620,244,972,600
15434,Monistrol-d'Allier,43136,43,63,35,5,83,40,128,98
15435,Monistrol-sur-Loire,43137,43,670,2371,830,2898,1809,5537,3041
15436,Monlet,43138,43,83,59,12,141,48,201,142
15437,Montclard,43139,43,6,12,3,12,9,24,18
15438,Le Monteil,43140,43,29,187,20,277,104,401,216
15439,Montfaucon-en-Velay,43141,43,175,280,130,365,220,715,455
15440,Montregard,43142,43,92,156,32,204,124,360,248
15441,Montusclat,43143,43,0,20,19,93,10,122,20
15442,Moudeyres,43144,43,16,36,4,20,36,60,52
15443,Ouides,43145,43,0,8,8,24,8,40,8
15444,Paulhac,43147,43,45,162,52,283,76,411,207
15445,Paulhaguet,43148,43,135,180,60,310,130,500,315
15446,Pébrac,43149,43,15,15,5,50,25,80,30
15447,Le Pertuis,43150,43,56,92,40,168,68,276,148
15448,Pinols,43151,43,45,30,10,85,20,115,75
15449,Polignac,43152,43,295,674,166,1080,471,1717,969
15450,Pont-Salomon,43153,43,149,557,213,656,440,1309,706
15451,Pradelles,43154,43,45,112,20,218,71,309,157
15452,Prades,43155,43,8,8,8,40,8,56,16
15453,Présailles,43156,43,48,20,4,60,4,68,68
15454,Le Puy-en-Velay,43157,43,2654,3988,2433,5671,2832,10936,6642
15455,Queyrières,43158,43,40,70,15,105,75,195,110
15456,Raucoules,43159,43,125,245,80,295,175,550,370
15457,Rauret,43160,43,45,20,8,68,8,84,65
15458,Retournac,43162,43,550,615,165,1018,435,1618,1165
15459,Riotord,43163,43,156,209,90,448,152,690,365
15460,Roche-en-Régnier,43164,43,90,85,20,204,52,276,175
15461,Rosières,43165,43,208,296,104,480,316,900,504
15462,Saint-André-de-Chalencon,43166,43,70,70,30,135,35,200,140
15463,Saint-Arcons-d'Allier,43167,43,32,40,8,76,32,116,72
15464,Saint-Arcons-de-Barges,43168,43,25,0,0,75,10,85,25
15465,Saint-Austremoine,43169,43,0,0,5,30,15,50,0
15466,Saint-Beauzire,43170,43,22,92,24,83,71,178,114
15467,Saint-Bérain,43171,43,15,13,3,18,15,36,28
15468,Saint-Bonnet-le-Froid,43172,43,30,100,20,80,55,155,130
15469,Saint-Christophe-d'Allier,43173,43,22,9,0,38,3,41,31
15470,Saint-Christophe-sur-Dolaison,43174,43,76,208,80,432,132,644,284
15471,Saint-Cirgues,43175,43,28,44,12,56,20,88,72
15472,Saint-Didier-d'Allier,43176,43,16,4,0,8,8,16,20
15473,Saint-Didier-en-Velay,43177,43,424,865,346,964,724,2034,1289
15474,Saint-Didier-sur-Doulon,43178,43,50,15,10,75,30,115,65
15475,Saint-Étienne-du-Vigan,43180,43,30,30,0,35,20,55,60
15476,Saint-Étienne-Lardeyrol,43181,43,75,230,35,213,210,458,305
15477,Saint-Étienne-sur-Blesle,43182,43,15,10,5,15,10,30,25
15478,Sainte-Eugénie-de-Villeneuve,43183,43,6,15,0,26,26,52,21
15479,Saint-Ferréol-d'Auroure,43184,43,200,608,242,870,449,1561,808
15480,Sainte-Florine,43185,43,465,628,264,1104,512,1880,1093
15481,Saint-Front,43186,43,75,65,25,171,60,256,140
15482,Saint-Geneys-près-Saint-Paulien,43187,43,20,92,28,120,72,220,112
15483,Saint-Georges-d'Aurac,43188,43,45,83,47,146,66,259,128
15484,Saint-Georges-Lagricol,43189,43,50,125,55,190,100,345,175
15485,Saint-Germain-Laprade,43190,43,330,853,347,1335,575,2257,1183
15486,Saint-Géron,43191,43,47,72,16,41,59,116,119
15487,Saint-Haon,43192,43,65,35,35,159,15,209,100
15488,Saint-Hilaire,43193,43,22,40,3,39,33,75,62
15489,Saint-Hostien,43194,43,50,175,41,177,153,371,225
15490,Saint-Ilpize,43195,43,16,44,8,100,36,144,60
15491,Saint-Jean-d'Aubrigoux,43196,43,30,25,20,60,40,120,55
15492,Saint-Jean-de-Nay,43197,43,75,45,35,150,40,225,120
15493,Saint-Jean-Lachalm,43198,43,68,48,32,96,32,160,116
15494,Saint-Jeures,43199,43,172,248,64,264,208,536,420
15495,Saint-Julien-Chapteuil,43200,43,305,395,135,715,280,1130,700
15496,Saint-Julien-d'Ance,43201,43,34,58,12,89,39,140,92
15497,Saint-Julien-des-Chazes,43202,43,15,0,15,30,0,45,15
15498,Saint-Julien-du-Pinet,43203,43,36,104,32,200,72,304,140
15499,Saint-Julien-Molhesabate,43204,43,50,31,0,45,24,69,81
15500,Saint-Just-Malmont,43205,43,315,1070,365,1470,875,2710,1385
15501,Saint-Just-près-Brioude,43206,43,60,105,25,150,95,270,165
15502,Saint-Laurent-Chabreuges,43207,43,30,50,35,100,40,175,80
15503,Sainte-Marguerite,43208,43,0,8,0,16,8,24,8
15504,Saint-Martin-de-Fugères,43210,43,12,30,12,79,45,136,42
15505,Saint-Maurice-de-Lignon,43211,43,225,751,228,640,597,1465,976
15506,Saint-Pal-de-Chalencon,43212,43,127,164,61,376,144,581,291
15507,Saint-Pal-de-Mons,43213,43,188,596,232,692,480,1404,784
15508,Saint-Pal-de-Senouire,43214,43,4,39,0,59,13,72,43
15509,Saint-Paul-de-Tartas,43215,43,36,48,12,44,56,112,84
15510,Saint-Paulien,43216,43,260,585,268,735,444,1447,845
15511,Saint-Pierre-du-Champ,43217,43,82,82,40,179,57,276,164
15512,Saint-Pierre-Eynac,43218,43,124,296,92,320,252,664,420
15513,Saint-Préjet-Armandon,43219,43,9,9,9,39,6,54,18
15514,Saint-Préjet-d'Allier,43220,43,31,26,3,52,18,73,57
15515,Saint-Privat-d'Allier,43221,43,48,66,12,133,65,210,114
15516,Saint-Privat-du-Dragon,43222,43,40,25,15,55,25,95,65
15517,Saint-Romain-Lachalm,43223,43,89,295,94,285,223,602,384
15518,Sainte-Sigolène,43224,43,601,1650,575,1727,1157,3459,2251
15519,Saint-Vénérand,43225,43,12,3,3,9,6,18,15
15520,Saint-Vert,43226,43,32,4,4,16,24,44,36
15521,Saint-Victor-Malescours,43227,43,65,200,140,335,105,580,265
15522,Saint-Victor-sur-Arlanc,43228,43,12,9,6,40,6,52,21
15523,Saint-Vidal,43229,43,34,143,58,196,90,344,177
15524,Saint-Vincent,43230,43,135,253,65,360,194,619,388
15525,Salettes,43231,43,70,15,5,20,5,30,85
15526,Salzuit,43232,43,59,68,16,120,44,180,127
15527,Sanssac-l'Église,43233,43,136,321,100,356,224,680,457
15528,Saugues,43234,43,328,349,76,559,367,1002,677
15529,La Séauve-sur-Semène,43236,43,160,420,128,382,294,804,580
15530,Sembadel,43237,43,27,38,31,72,30,133,65
15531,Séneujols,43238,43,45,75,25,105,55,185,120
15532,Siaugues-Sainte-Marie,43239,43,140,184,48,224,188,460,324
15533,Solignac-sous-Roche,43240,43,50,80,10,80,30,120,130
15534,Solignac-sur-Loire,43241,43,92,308,140,404,236,780,400
15535,Tailhac,43242,43,4,20,4,16,24,44,24
15536,Tence,43244,43,436,671,275,1170,488,1933,1107
15537,Thoras,43245,43,65,39,15,97,36,148,104
15538,Tiranges,43246,43,94,104,18,157,61,236,198
15539,Torsiac,43247,43,24,20,8,32,0,40,44
15540,Valprivas,43249,43,57,98,31,158,67,256,155
15541,Vals-le-Chastel,43250,43,5,0,10,25,0,35,5
15542,Vals-près-le-Puy,43251,43,655,584,231,1067,538,1836,1239
15543,Varennes-Saint-Honorat,43252,43,12,0,0,6,0,6,12
15544,Les Vastres,43253,43,40,30,10,80,25,115,70
15545,Vazeilles-Limandre,43254,43,35,85,5,70,65,140,120
15546,Venteuges,43256,43,34,68,23,82,92,197,102
15547,Vergezac,43257,43,62,120,33,116,89,238,182
15548,Vergongheon,43258,43,274,427,85,639,356,1080,701
15549,Vernassal,43259,43,55,75,35,140,60,235,130
15550,Le Vernet,43260,43,0,0,6,6,3,15,0
15551,Vézézoux,43261,43,46,126,44,188,118,350,172
15552,Vieille-Brioude,43262,43,110,250,75,530,210,815,360
15553,Vielprat,43263,43,5,0,0,50,0,50,5
15554,Villeneuve-d'Allier,43264,43,55,65,20,109,60,189,120
15555,Les Villettes,43265,43,57,464,108,319,341,768,521
15556,Vorey,43267,43,245,276,116,401,211,728,521
15557,Yssingeaux,43268,43,980,1494,674,2304,1301,4279,2474
15558,Abbaretz,44001,44,213,644,187,567,358,1112,857
15559,Aigrefeuille-sur-Maine,44002,44,276,1107,272,965,821,2058,1383
15560,Ancenis,44003,44,1160,1808,736,2091,1328,4155,2968
15561,Chaumes-en-Retz,44005,44,686,1935,646,1673,1526,3845,2621
15562,Assérac,44006,44,156,437,96,663,339,1098,593
15563,Avessac,44007,44,368,681,247,732,483,1462,1049
15564,Basse-Goulaine,44009,44,731,2226,694,3358,1265,5317,2957
15565,Batz-sur-Mer,44010,44,529,606,180,1227,442,1849,1135
15566,La Bernerie-en-Retz,44012,44,628,418,126,1107,270,1503,1046
15567,Besné,44013,44,186,872,242,763,758,1763,1058
15568,Le Bignon,44014,44,259,1032,253,1139,866,2258,1291
15569,Blain,44015,44,932,2582,878,2840,1965,5683,3514
15570,La Boissière-du-Doré,44016,44,55,310,145,248,300,693,365
15571,Bonnoeuvre,44017,44,70,130,45,225,95,365,200
15572,Bouaye,44018,44,621,1922,624,2278,1338,4240,2543
15573,Bouée,44019,44,70,252,47,321,181,549,322
15574,Bouguenais,44020,44,1857,4875,1836,5836,3678,11350,6732
15575,Villeneuve-en-Retz,44021,44,544,1316,320,1378,949,2647,1860
15576,Boussay,44022,44,245,640,185,910,515,1610,885
15577,Bouvron,44023,44,295,900,340,730,660,1730,1195
15578,Brains,44024,44,110,829,209,958,563,1730,939
15579,Campbon,44025,44,361,1185,325,1080,913,2318,1546
15580,Carquefou,44026,44,1590,5046,1959,6014,3324,11297,6636
15581,Casson,44027,44,43,731,143,652,532,1327,774
15582,Le Cellier,44028,44,378,987,270,1309,695,2274,1365
15583,Divatte-sur-Loire,44029,44,476,1839,663,2198,1357,4218,2315
15584,La Chapelle-des-Marais,44030,44,447,1125,389,1203,807,2399,1572
15585,La Chapelle-Glain,44031,44,155,230,40,265,150,455,385
15586,La Chapelle-Heulin,44032,44,264,1068,260,748,866,1874,1332
15587,La Chapelle-Launay,44033,44,192,769,207,997,632,1836,961
15588,La Chapelle-sur-Erdre,44035,44,1858,5071,1890,6379,3603,11872,6929
15589,Châteaubriant,44036,44,1841,2791,1053,3903,1883,6839,4632
15590,Château-Thébaud,44037,44,220,899,172,943,576,1691,1119
15591,Chauvé,44038,44,225,770,279,792,556,1627,995
15592,Cheix-en-Retz,44039,44,61,338,41,240,296,577,399
15593,La Chevrolière,44041,44,420,1339,529,1732,1175,3436,1759
15594,Clisson,44043,44,726,1567,646,2205,1337,4188,2293
15595,Conquereuil,44044,44,90,312,83,295,237,615,402
15596,Cordemais,44045,44,185,1117,383,901,868,2152,1302
15597,Corsept,44046,44,127,855,170,817,630,1617,982
15598,Couëron,44047,44,2115,5410,1866,6430,4112,12408,7525
15599,Couffé,44048,44,127,777,216,698,579,1493,904
15600,Le Croisic,44049,44,1029,477,288,1481,413,2182,1506
15601,Crossac,44050,44,245,810,222,942,601,1765,1055
15602,Derval,44051,44,388,997,355,853,727,1935,1385
15603,Donges,44052,44,698,2207,740,2083,1559,4382,2905
15604,Drefféac,44053,44,161,645,186,601,490,1277,806
15605,Erbray,44054,44,238,849,262,976,580,1818,1087
15606,La Baule-Escoublac,44055,44,4010,2466,888,5938,1836,8662,6476
15607,Fay-de-Bretagne,44056,44,276,1075,284,876,869,2029,1351
15608,Fégréac,44057,44,228,691,119,689,495,1303,919
15609,Fercé,44058,44,84,116,84,132,76,292,200
15610,Frossay,44061,44,215,982,303,843,779,1925,1197
15611,Le Gâvre,44062,44,133,544,127,473,345,945,677
15612,Gétigné,44063,44,261,865,395,1206,679,2280,1126
15613,Gorges,44064,44,377,1388,359,1160,1011,2530,1765
15614,Grand-Auverné,44065,44,110,230,60,230,155,445,340
15615,Grandchamps-des-Fontaines,44066,44,229,1894,486,1415,1362,3263,2123
15616,Guémené-Penfao,44067,44,798,1366,414,1577,924,2915,2164
15617,Guenrouet,44068,44,250,935,341,926,712,1979,1185
15618,Guérande,44069,44,1959,3829,1324,5944,2624,9892,5788
15619,La Haie-Fouassière,44070,44,425,1233,475,1408,909,2792,1658
15620,Haute-Goulaine,44071,44,552,1529,389,1930,945,3264,2081
15621,Herbignac,44072,44,524,1775,549,2066,1360,3975,2299
15622,Héric,44073,44,390,1790,552,1557,1262,3371,2180
15623,Indre,44074,44,420,1034,350,1226,897,2473,1454
15624,Issé,44075,44,196,500,116,632,380,1128,696
15625,Jans,44076,44,139,369,129,351,261,741,508
15626,Joué-sur-Erdre,44077,44,196,743,212,598,534,1344,939
15627,Juigné-des-Moutiers,44078,44,50,70,35,125,70,230,120
15628,Le Landreau,44079,44,178,843,319,849,681,1849,1021
15629,Lavau-sur-Loire,44080,44,39,203,29,249,186,464,242
15630,Legé,44081,44,588,1087,411,1232,904,2547,1675
15631,Ligné,44082,44,244,1696,391,1256,1251,2898,1940
15632,La Limouzinière,44083,44,143,760,233,531,588,1352,903
15633,Le Loroux-Bottereau,44084,44,658,2285,821,2101,1859,4781,2943
15634,Louisfert,44085,44,61,302,74,294,218,586,363
15635,Lusanger,44086,44,128,300,88,280,236,604,428
15636,Machecoul-Saint-Même,44087,44,943,1752,602,2297,1352,4251,2695
15637,Maisdon-sur-Sèvre,44088,44,152,864,292,756,743,1791,1016
15638,Malville,44089,44,166,959,370,1046,756,2172,1125
15639,La Marne,44090,44,95,386,175,400,282,857,481
15640,Marsac-sur-Don,44091,44,136,440,139,393,305,837,576
15641,Massérac,44092,44,95,165,30,235,150,415,260
15642,Maumusson,44093,44,124,292,128,252,228,608,416
15643,Mauves-sur-Loire,44094,44,145,869,262,1103,619,1984,1014
15644,La Meilleraye-de-Bretagne,44095,44,152,429,185,364,317,866,581
15645,Mésanger,44096,44,348,1438,387,1331,1054,2772,1786
15646,Mesquer,44097,44,393,345,76,761,230,1067,738
15647,Missillac,44098,44,414,1385,425,1539,1183,3147,1799
15648,Moisdon-la-Rivière,44099,44,270,550,140,569,345,1054,820
15649,Monnières,44100,44,165,602,179,592,466,1237,767
15650,La Montagne,44101,44,752,1695,432,1741,1274,3447,2447
15651,Montbert,44102,44,236,914,244,932,664,1840,1150
15652,Montoir-de-Bretagne,44103,44,645,1794,639,2371,1330,4340,2439
15653,Montrelais,44104,44,68,260,48,272,208,528,328
15654,Mouais,44105,44,25,125,40,110,100,250,150
15655,Les Moutiers-en-Retz,44106,44,218,295,130,650,284,1064,513
15656,Mouzeil,44107,44,115,630,160,471,533,1164,745
15657,Mouzillon,44108,44,208,789,343,745,677,1765,997
15658,Nantes,44109,44,27877,67139,62075,72698,59096,193869,95016
15659,Nort-sur-Erdre,44110,44,792,2408,669,2314,1983,4966,3200
15660,Notre-Dame-des-Landes,44111,44,159,652,214,556,437,1207,811
15661,Noyal-sur-Brutz,44112,44,50,180,55,180,135,370,230
15662,Nozay,44113,44,441,1106,394,1012,871,2277,1547
15663,Orvault,44114,44,3374,5983,2495,8454,4421,15370,9357
15664,Oudon,44115,44,281,1033,328,1108,817,2253,1314
15665,Paimboeuf,44116,44,433,788,346,872,620,1838,1221
15666,Le Pallet,44117,44,244,1008,345,899,729,1973,1252
15667,Pannecé,44118,44,125,430,85,339,365,789,555
15668,Paulx,44119,44,157,614,191,428,494,1113,771
15669,Le Pellerin,44120,44,402,1347,503,1392,1036,2931,1749
15670,Petit-Auverné,44121,44,50,110,25,180,65,270,160
15671,Petit-Mars,44122,44,265,1162,253,978,895,2126,1427
15672,Pierric,44123,44,66,233,67,322,198,587,299
15673,Le Pin,44124,44,112,208,88,212,160,460,320
15674,Piriac-sur-Mer,44125,44,496,301,134,930,217,1281,797
15675,La Plaine-sur-Mer,44126,44,641,886,212,1471,716,2399,1527
15676,La Planche,44127,44,184,685,212,753,602,1567,869
15677,Plessé,44128,44,415,1564,438,1438,1183,3059,1979
15678,Pontchâteau,44129,44,949,2804,990,2901,2285,6176,3753
15679,Pont-Saint-Martin,44130,44,541,1485,436,1813,1225,3474,2026
15680,Pornic,44131,44,2741,2941,753,5781,1971,8505,5682
15681,Pornichet,44132,44,1872,1990,867,4132,1572,6571,3862
15682,Port-Saint-Père,44133,44,315,762,315,851,543,1709,1077
15683,Pouillé-les-Côteaux,44134,44,44,291,108,248,274,630,335
15684,Le Pouliguen,44135,44,1147,610,234,1862,474,2570,1757
15685,Préfailles,44136,44,302,160,45,593,115,753,462
15686,Prinquiau,44137,44,228,1127,343,805,926,2074,1355
15687,Puceul,44138,44,65,378,33,268,304,605,443
15688,Quilly,44139,44,51,385,167,390,308,865,436
15689,La Regrippière,44140,44,104,496,172,388,380,940,600
15690,La Remaudière,44141,44,85,400,115,340,330,785,485
15691,Remouillé,44142,44,144,541,147,532,430,1109,685
15692,Rezé,44143,44,4820,9696,4548,11478,7862,23888,14516
15693,Riaillé,44144,44,207,639,217,608,458,1283,846
15694,Rouans,44145,44,147,845,191,867,613,1671,992
15695,Rougé,44146,44,253,557,144,798,315,1257,810
15696,Ruffigné,44148,44,73,186,49,176,135,360,259
15697,Saffré,44149,44,312,1116,372,991,929,2292,1428
15698,Saint-Aignan-Grandlieu,44150,44,261,983,354,1472,673,2499,1244
15699,Saint-André-des-Eaux,44151,44,535,1706,491,1943,1250,3684,2241
15700,Sainte-Anne-sur-Brivet,44152,44,160,875,244,859,709,1812,1035
15701,Saint-Aubin-des-Châteaux,44153,44,174,504,168,422,356,946,678
15702,Saint-Brevin-les-Pins,44154,44,2001,2695,810,4643,2109,7562,4696
15703,Saint-Colomban,44155,44,225,1025,275,822,885,1982,1250
15704,Corcoué-sur-Logne,44156,44,212,728,329,752,566,1647,940
15705,Saint-Étienne-de-Mer-Morte,44157,44,123,538,159,388,399,946,661
15706,Saint-Étienne-de-Montluc,44158,44,561,1823,634,2256,1268,4158,2384
15707,Saint-Fiacre-sur-Maine,44159,44,93,329,94,323,259,676,422
15708,Saint-Géréon,44160,44,516,646,201,987,428,1616,1162
15709,Saint-Gildas-des-Bois,44161,44,350,993,342,1064,663,2069,1343
15710,Saint-Herblain,44162,44,5184,11069,5124,13324,8787,27235,16253
15711,Vair-sur-Loire,44163,44,454,1425,235,1250,1165,2650,1879
15712,Saint-Hilaire-de-Chaléons,44164,44,189,700,175,542,540,1257,889
15713,Saint-Hilaire-de-Clisson,44165,44,130,700,160,663,505,1328,830
15714,Saint-Jean-de-Boiseau,44166,44,444,1659,545,1585,1170,3300,2103
15715,Saint-Joachim,44168,44,582,813,381,1255,744,2380,1395
15716,Saint-Julien-de-Concelles,44169,44,595,1866,526,2187,1430,4143,2461
15717,Saint-Julien-de-Vouvantes,44170,44,70,194,83,339,136,558,264
15718,Saint-Léger-les-Vignes,44171,44,95,497,153,512,360,1025,592
15719,Sainte-Luce-sur-Loire,44172,44,1131,3956,1623,4814,2899,9336,5087
15720,Saint-Lumine-de-Clisson,44173,44,128,633,224,592,498,1314,761
15721,Saint-Lumine-de-Coutais,44174,44,140,630,265,550,470,1285,770
15722,Saint-Lyphard,44175,44,374,1249,445,1423,929,2797,1623
15723,Saint-Malo-de-Guersac,44176,44,330,770,260,1145,655,2060,1100
15724,Saint-Mars-de-Coutais,44178,44,209,812,115,826,587,1528,1021
15725,Saint-Mars-du-Désert,44179,44,326,1390,443,1377,1060,2880,1716
15726,Saint-Mars-la-Jaille,44180,44,301,646,177,729,444,1350,947
15727,Saint-Michel-Chef-Chef,44182,44,718,980,292,1759,830,2881,1698
15728,Saint-Molf,44183,44,128,809,220,681,637,1538,937
15729,Saint-Nazaire,44184,44,9534,16123,7911,22209,12111,42231,25657
15730,Saint-Nicolas-de-Redon,44185,44,450,703,281,1105,474,1860,1153
15731,Sainte-Pazanne,44186,44,489,2067,461,1652,1568,3681,2556
15732,Saint-Père-en-Retz,44187,44,456,1135,457,1364,810,2631,1591
15733,Saint-Philbert-de-Grand-Lieu,44188,44,572,2588,892,2589,1863,5344,3160
15734,Sainte-Reine-de-Bretagne,44189,44,148,617,188,727,460,1375,765
15735,Saint-Sébastien-sur-Loire,44190,44,3586,5940,2872,8240,4559,15671,9526
15736,Saint-Sulpice-des-Landes,44191,44,120,196,88,164,112,364,316
15737,Saint-Viaud,44192,44,244,685,192,672,532,1396,929
15738,Saint-Vincent-des-Landes,44193,44,170,403,97,398,266,761,573
15739,Sautron,44194,44,1125,1590,645,2788,1109,4542,2715
15740,Savenay,44195,44,822,2414,868,1796,2019,4683,3236
15741,Sévérac,44196,44,210,440,145,540,315,1000,650
15742,Sion-les-Mines,44197,44,276,404,165,511,246,922,680
15743,Les Sorinières,44198,44,743,2049,816,2688,1371,4875,2792
15744,Soudan,44199,44,182,531,191,659,344,1194,713
15745,Soulvache,44200,44,40,85,20,145,50,215,125
15746,Sucé-sur-Erdre,44201,44,682,1777,481,2428,1147,4056,2459
15747,Teillé,44202,44,188,488,164,436,392,992,676
15748,Le Temple-de-Bretagne,44203,44,108,558,196,552,430,1178,666
15749,Thouaré-sur-Loire,44204,44,641,2522,898,2755,1987,5640,3163
15750,Les Touches,44205,44,226,690,222,606,509,1337,916
15751,Touvois,44206,44,194,519,117,403,383,903,713
15752,Trans-sur-Erdre,44207,44,58,300,48,268,212,528,358
15753,Treffieux,44208,44,88,204,88,248,156,492,292
15754,Treillières,44209,44,452,2491,672,3030,1606,5308,2943
15755,Trignac,44210,44,873,1882,743,2306,1441,4490,2755
15756,La Turballe,44211,44,915,790,365,1642,665,2672,1705
15757,Vallet,44212,44,697,2430,980,2636,1741,5357,3127
15758,Loireauxence,44213,44,881,2089,780,1978,1458,4216,2970
15759,Vay,44214,44,172,674,200,512,504,1216,846
15760,Vertou,44215,44,2725,5573,1825,8503,3945,14273,8298
15761,Vieillevigne,44216,44,388,1109,333,1150,799,2282,1497
15762,Vigneux-de-Bretagne,44217,44,270,1574,460,1986,1204,3650,1844
15763,Villepot,44218,44,95,165,80,235,105,420,260
15764,Vritz,44219,44,112,168,80,248,164,492,280
15765,Vue,44220,44,139,523,214,323,423,960,662
15766,La Chevallerais,44221,44,68,566,156,276,475,907,634
15767,La Roche-Blanche,44222,44,102,351,94,322,233,649,453
15768,Geneston,44223,44,189,1144,287,968,952,2207,1333
15769,La Grigonnais,44224,44,95,535,165,424,385,974,630
15770,Adon,45001,45,33,45,30,73,35,138,78
15771,Aillant-sur-Milleron,45002,45,56,77,47,128,51,226,133
15772,Amilly,45004,45,1915,2854,993,4045,1920,6958,4769
15773,Andonville,45005,45,24,60,32,68,32,132,84
15774,Ardon,45006,45,123,216,126,421,148,695,339
15775,Artenay,45008,45,334,399,114,484,429,1027,733
15776,Aschères-le-Marché,45009,45,173,360,70,270,300,640,533
15777,Ascoux,45010,45,72,317,69,298,226,593,389
15778,Attray,45011,45,40,55,20,50,55,125,95
15779,Audeville,45012,45,0,53,12,41,52,105,53
15780,Augerville-la-Rivière,45013,45,8,32,29,100,21,150,40
15781,Aulnay-la-Rivière,45014,45,60,112,40,220,96,356,172
15782,Autruy-sur-Juine,45015,45,72,128,56,258,112,426,200
15783,Autry-le-Châtel,45016,45,75,226,80,407,170,657,301
15784,Auvilliers-en-Gâtinais,45017,45,40,75,43,175,40,258,115
15785,Auxy,45018,45,79,281,33,311,145,489,360
15786,Baccon,45019,45,100,204,45,193,170,408,304
15787,Le Bardon,45020,45,94,260,111,357,234,702,354
15788,Barville-en-Gâtinais,45021,45,74,90,20,55,84,159,164
15789,Batilly-en-Gâtinais,45022,45,46,92,51,119,75,245,138
15790,Batilly-en-Puisaye,45023,45,5,40,0,50,25,75,45
15791,Baule,45024,45,204,552,192,685,357,1234,756
15792,Bazoches-les-Gallerandes,45025,45,181,349,170,520,181,871,530
15793,Bazoches-sur-le-Betz,45026,45,135,225,30,335,215,580,360
15794,Beauchamps-sur-Huillard,45027,45,72,96,36,88,112,236,168
15795,Beaugency,45028,45,1094,1896,805,2080,1386,4271,2990
15796,Beaulieu-sur-Loire,45029,45,264,440,160,592,364,1116,704
15797,Beaune-la-Rolande,45030,45,281,378,189,634,216,1039,659
15798,Bellegarde,45031,45,270,430,214,468,270,952,700
15799,Le Bignon-Mirabeau,45032,45,24,76,24,124,60,208,100
15800,Boësses,45033,45,72,104,16,136,72,224,176
15801,Boigny-sur-Bionne,45034,45,275,520,160,868,280,1308,795
15802,Boiscommun,45035,45,224,288,84,328,212,624,512
15803,Boismorand,45036,45,125,221,50,270,155,475,346
15804,Boisseaux,45037,45,40,177,8,104,109,221,217
15805,Bondaroy,45038,45,72,108,20,116,88,224,180
15806,Bonnée,45039,45,113,120,47,243,113,403,233
15807,Bonny-sur-Loire,45040,45,408,425,130,653,265,1048,833
15808,Bordeaux-en-Gâtinais,45041,45,16,22,3,27,25,55,38
15809,Les Bordes,45042,45,250,495,170,540,395,1105,745
15810,Bou,45043,45,93,220,60,398,140,598,313
15811,Bougy-lez-Neuville,45044,45,25,40,15,70,5,90,65
15812,Bouilly-en-Gâtinais,45045,45,40,85,40,115,40,195,125
15813,Boulay-les-Barres,45046,45,30,182,59,225,109,393,212
15814,Bouzonville-aux-Bois,45047,45,40,124,40,132,104,276,164
15815,Bouzy-la-Forêt,45049,45,110,369,89,333,325,747,479
15816,Boynes,45050,45,158,390,70,429,275,774,548
15817,Bray-en-Val,45051,45,136,372,136,396,328,860,508
15818,Breteau,45052,45,12,12,16,24,8,48,24
15819,Briare,45053,45,989,1225,455,1798,1019,3272,2214
15820,Briarres-sur-Essonne,45054,45,62,147,39,171,85,295,209
15821,Bricy,45055,45,20,112,60,160,96,316,132
15822,Bromeilles,45056,45,60,84,24,83,25,132,144
15823,Bucy-le-Roi,45058,45,15,40,20,70,30,120,55
15824,Bucy-Saint-Liphard,45059,45,28,32,28,96,28,152,60
15825,La Bussière,45060,45,149,210,45,280,130,455,359
15826,Cepoy,45061,45,351,555,170,810,391,1371,906
15827,Cercottes,45062,45,64,496,120,288,436,844,560
15828,Cerdon,45063,45,242,203,63,302,134,499,445
15829,Cernoy-en-Berry,45064,45,45,120,50,165,80,295,165
15830,Césarville-Dossainville,45065,45,8,80,39,51,55,145,88
15831,Chailly-en-Gâtinais,45066,45,96,156,72,224,152,448,252
15832,Chaingy,45067,45,319,888,246,1304,655,2205,1207
15833,Châlette-sur-Loing,45068,45,1926,3342,1277,3623,2323,7223,5268
15834,Chambon-la-Forêt,45069,45,79,268,37,257,222,516,347
15835,Champoulet,45070,45,0,0,0,26,6,32,0
15836,Chanteau,45072,45,68,324,188,480,276,944,392
15837,Chantecoq,45073,45,90,95,45,180,75,300,185
15838,La Chapelle-Onzerain,45074,45,33,29,4,12,18,34,62
15839,La Chapelle-Saint-Mesmin,45075,45,1174,2598,1036,2994,1899,5929,3772
15840,La Chapelle-Saint-Sépulcre,45076,45,30,50,5,110,55,170,80
15841,La Chapelle-sur-Aveyron,45077,45,64,191,24,187,185,396,255
15842,Chapelon,45078,45,60,60,36,44,64,144,120
15843,Le Charme,45079,45,19,29,0,56,15,71,48
15844,Charmont-en-Beauce,45080,45,60,86,25,170,40,235,146
15845,Charsonville,45081,45,48,167,33,174,130,337,215
15846,Châteauneuf-sur-Loire,45082,45,1132,1988,898,2270,1516,4684,3120
15847,Château-Renard,45083,45,416,444,239,765,312,1316,860
15848,Châtenoy,45084,45,65,123,20,150,119,289,188
15849,Châtillon-Coligny,45085,45,333,345,175,724,239,1138,678
15850,Châtillon-le-Roi,45086,45,47,77,4,65,63,132,124
15851,Châtillon-sur-Loire,45087,45,487,765,285,909,595,1789,1252
15852,Chaussy,45088,45,65,70,40,90,50,180,135
15853,Chécy,45089,45,849,2398,628,2823,1904,5355,3247
15854,Chevannes,45091,45,62,95,10,100,75,185,157
15855,Chevillon-sur-Huillard,45092,45,140,335,130,575,200,905,475
15856,Chevilly,45093,45,270,733,273,694,632,1599,1003
15857,Chevry-sous-le-Bignon,45094,45,45,45,15,85,25,125,90
15858,Chilleurs-aux-Bois,45095,45,249,495,218,567,348,1133,744
15859,Les Choux,45096,45,96,104,40,144,84,268,200
15860,Chuelles,45097,45,144,264,108,416,228,752,408
15861,Cléry-Saint-André,45098,45,402,878,336,1141,625,2102,1280
15862,Coinces,45099,45,36,168,40,164,160,364,204
15863,Combleux,45100,45,64,124,28,196,76,300,188
15864,Combreux,45101,45,44,68,4,64,76,144,112
15865,Conflans-sur-Loing,45102,45,25,88,30,185,68,283,113
15866,Corbeilles,45103,45,184,370,120,524,280,924,554
15867,Corquilleroy,45104,45,244,754,175,980,540,1695,998
15868,Cortrat,45105,45,10,10,5,46,5,56,20
15869,Coudroy,45107,45,46,62,18,95,60,173,108
15870,Coullons,45108,45,394,584,203,792,429,1424,978
15871,Coulmiers,45109,45,64,132,40,224,108,372,196
15872,Courcelles,45110,45,28,68,34,107,48,189,96
15873,Courcy-aux-Loges,45111,45,49,100,29,130,75,234,149
15874,La Cour-Marigny,45112,45,44,92,44,68,80,192,136
15875,Courtemaux,45113,45,55,45,10,115,35,160,100
15876,Courtempierre,45114,45,30,60,5,105,45,155,90
15877,Courtenay,45115,45,790,875,290,1370,625,2285,1665
15878,Cravant,45116,45,90,280,70,280,240,590,370
15879,Crottes-en-Pithiverais,45118,45,21,87,17,110,71,198,108
15880,Dadonville,45119,45,250,652,215,886,402,1503,902
15881,Dammarie-en-Puisaye,45120,45,30,35,20,55,25,100,65
15882,Dammarie-sur-Loing,45121,45,66,111,17,174,68,259,177
15883,Dampierre-en-Burly,45122,45,107,379,130,431,294,855,486
15884,Darvoy,45123,45,236,452,152,660,356,1168,688
15885,Desmonts,45124,45,16,56,12,64,32,108,72
15886,Dimancheville,45125,45,0,15,10,45,30,85,15
15887,Donnery,45126,45,217,727,147,926,601,1674,944
15888,Dordives,45127,45,464,781,284,992,614,1890,1245
15889,Douchy-Montcorbon,45129,45,250,341,128,548,228,904,591
15890,Dry,45130,45,90,335,50,460,260,770,425
15891,Échilleuses,45131,45,45,100,12,106,71,189,145
15892,Égry,45132,45,28,96,56,84,92,232,124
15893,Engenville,45133,45,44,178,28,152,150,330,222
15894,Épieds-en-Beauce,45134,45,140,428,129,378,398,905,568
15895,Erceville,45135,45,31,72,15,122,72,209,103
15896,Ervauville,45136,45,75,120,30,225,95,350,195
15897,Escrennes,45137,45,124,196,60,212,132,404,320
15898,Escrignelles,45138,45,0,6,3,22,9,34,6
15899,Estouy,45139,45,35,100,65,217,104,386,135
15900,Faverelles,45141,45,8,36,28,72,24,124,44
15901,Fay-aux-Loges,45142,45,391,939,338,1047,848,2233,1330
15902,Feins-en-Gâtinais,45143,45,3,7,6,12,3,21,10
15903,Férolles,45144,45,110,301,100,446,212,758,411
15904,Ferrières-en-Gâtinais,45145,45,586,802,330,1223,581,2134,1388
15905,La Ferté-Saint-Aubin,45146,45,786,1813,668,2496,1259,4423,2599
15906,Fleury-les-Aubrais,45147,45,2325,5570,2572,6022,3885,12479,7895
15907,Fontenay-sur-Loing,45148,45,220,472,145,565,325,1035,692
15908,Foucherolles,45149,45,60,76,24,68,68,160,136
15909,Fréville-du-Gâtinais,45150,45,28,44,12,56,32,100,72
15910,Gaubertin,45151,45,20,76,20,84,64,168,96
15911,Gémigny,45152,45,25,50,20,45,60,125,75
15912,Germigny-des-Prés,45153,45,68,252,36,196,212,444,320
15913,Gidy,45154,45,180,519,141,506,429,1076,699
15914,Gien,45155,45,1900,3644,1601,4173,2432,8206,5544
15915,Girolles,45156,45,80,145,50,250,95,395,225
15916,Givraines,45157,45,60,108,36,136,84,256,168
15917,Gondreville,45158,45,34,55,30,112,64,206,89
15918,Grangermont,45159,45,35,45,20,65,25,110,80
15919,Greneville-en-Beauce,45160,45,83,158,51,163,112,326,241
15920,Griselles,45161,45,112,192,52,292,164,508,304
15921,Guigneville,45162,45,55,155,30,155,140,325,210
15922,Guilly,45164,45,60,180,50,185,160,395,240
15923,Gy-les-Nonains,45165,45,120,130,70,230,85,385,250
15924,Huêtre,45166,45,10,65,40,90,65,195,75
15925,Huisseau-sur-Mauves,45167,45,201,336,108,552,288,948,537
15926,Ingrannes,45168,45,55,155,45,135,125,305,210
15927,Ingré,45169,45,826,2314,709,2796,1555,5060,3140
15928,Intville-la-Guétard,45170,45,0,35,10,55,15,80,35
15929,Isdes,45171,45,61,149,16,141,130,287,210
15930,Jargeau,45173,45,582,1118,461,1340,910,2711,1700
15931,Jouy-en-Pithiverais,45174,45,22,62,34,63,40,137,84
15932,Jouy-le-Potier,45175,45,139,323,121,415,293,829,462
15933,Juranville,45176,45,71,82,41,146,60,247,153
15934,Laas,45177,45,44,52,20,80,20,120,96
15935,Ladon,45178,45,263,338,142,386,218,746,601
15936,Lailly-en-Val,45179,45,281,844,235,743,685,1663,1125
15937,Langesse,45180,45,3,9,0,36,6,42,12
15938,Léouville,45181,45,4,28,8,12,24,44,32
15939,Ligny-le-Ribault,45182,45,170,247,115,515,205,835,417
15940,Lion-en-Beauce,45183,45,0,60,10,35,40,85,60
15941,Lion-en-Sullias,45184,45,28,87,39,145,69,253,115
15942,Lombreuil,45185,45,9,75,21,93,54,168,84
15943,Lorcy,45186,45,90,135,15,120,130,265,225
15944,Lorris,45187,45,627,646,160,898,456,1514,1273
15945,Loury,45188,45,155,708,234,740,607,1581,863
15946,Louzouer,45189,45,32,52,20,124,48,192,84
15947,Le Malesherbois,45191,45,829,2072,817,2599,1579,4995,2901
15948,Marcilly-en-Villette,45193,45,253,470,156,717,366,1239,723
15949,Mardié,45194,45,209,657,259,917,489,1665,866
15950,Mareau-aux-Bois,45195,45,29,156,30,175,133,338,185
15951,Mareau-aux-Prés,45196,45,134,255,105,509,240,854,389
15952,Marigny-les-Usages,45197,45,107,334,110,479,219,808,441
15953,Marsainvilliers,45198,45,10,80,40,100,70,210,90
15954,Melleroy,45199,45,48,117,36,185,83,304,165
15955,Ménestreau-en-Villette,45200,45,145,410,145,515,270,930,555
15956,Mérinville,45201,45,15,40,5,89,35,129,55
15957,Messas,45202,45,55,200,105,360,140,605,255
15958,Meung-sur-Loire,45203,45,766,1494,686,1878,1082,3646,2260
15959,Mézières-lez-Cléry,45204,45,65,259,40,269,180,489,324
15960,Mézières-en-Gâtinais,45205,45,25,40,21,97,33,151,65
15961,Mignères,45206,45,60,68,20,108,40,168,128
15962,Mignerette,45207,45,30,95,33,138,66,237,125
15963,Montargis,45208,45,2029,3215,1812,3861,2587,8260,5244
15964,Montbarrois,45209,45,13,64,20,107,52,179,77
15965,Montbouy,45210,45,84,168,60,296,144,500,252
15966,Montcresson,45212,45,137,285,97,480,217,794,422
15967,Montereau,45213,45,105,120,55,234,95,384,225
15968,Montigny,45214,45,40,70,5,60,60,125,110
15969,Montliard,45215,45,45,58,6,36,41,83,103
15970,Mormant-sur-Vernisson,45216,45,13,19,6,25,16,47,32
15971,Morville-en-Beauce,45217,45,30,45,10,60,20,90,75
15972,Le Moulinet-sur-Solin,45218,45,9,15,9,35,34,78,24
15973,Moulon,45219,45,16,64,16,52,52,120,80
15974,Nancray-sur-Rimarde,45220,45,115,165,28,150,125,303,280
15975,Nargis,45222,45,144,406,88,481,298,867,550
15976,Nesploy,45223,45,71,100,25,120,55,200,171
15977,Neuville-aux-Bois,45224,45,545,1064,442,1178,876,2496,1609
15978,La Neuville-sur-Essonne,45225,45,58,110,20,109,90,219,168
15979,Neuvy-en-Sullias,45226,45,90,400,125,390,290,805,490
15980,Nevoy,45227,45,87,270,111,395,221,727,357
15981,Nibelle,45228,45,148,291,70,329,219,618,439
15982,Nogent-sur-Vernisson,45229,45,375,586,235,829,405,1469,961
15983,Noyers,45230,45,135,145,71,229,112,412,280
15984,Oison,45231,45,25,45,5,40,25,70,70
15985,Olivet,45232,45,2437,4846,2912,6666,3519,13097,7283
15986,Ondreville-sur-Essonne,45233,45,25,74,30,161,62,253,99
15987,Orléans,45234,45,11573,27504,20453,29398,22336,72187,39077
15988,Ormes,45235,45,239,1156,359,1210,838,2407,1395
15989,Orville,45237,45,15,15,15,45,20,80,30
15990,Ousson-sur-Loire,45238,45,134,172,12,218,137,367,306
15991,Oussoy-en-Gâtinais,45239,45,50,120,45,140,95,280,170
15992,Outarville,45240,45,205,279,120,431,251,802,484
15993,Ouvrouer-les-Champs,45241,45,16,148,60,196,132,388,164
15994,Ouzouer-des-Champs,45242,45,55,40,5,75,45,125,95
15995,Ouzouer-sous-Bellegarde,45243,45,25,75,15,145,55,215,100
15996,Ouzouer-sur-Loire,45244,45,265,685,305,980,480,1765,950
15997,Ouzouer-sur-Trézée,45245,45,198,248,91,356,207,654,446
15998,Pannecières,45246,45,4,27,8,45,34,87,31
15999,Pannes,45247,45,496,928,364,1114,736,2214,1424
16000,Patay,45248,45,162,554,229,635,376,1240,716
16001,Paucourt,45249,45,132,228,48,360,156,564,360
16002,Pers-en-Gâtinais,45250,45,25,43,4,78,50,132,68
16003,Pierrefitte-ès-Bois,45251,45,71,42,20,77,30,127,113
16004,Pithiviers,45252,45,1377,2298,1257,2238,1608,5103,3675
16005,Pithiviers-le-Vieil,45253,45,195,440,120,720,310,1150,635
16006,Poilly-lez-Gien,45254,45,437,455,154,770,444,1368,892
16007,Préfontaines,45255,45,100,80,35,160,60,255,180
16008,Presnoy,45256,45,21,58,29,77,39,145,79
16009,Pressigny-les-Pins,45257,45,30,155,35,200,100,335,185
16010,Puiseaux,45258,45,378,792,382,1013,679,2074,1170
16011,Quiers-sur-Bézonde,45259,45,188,280,96,372,204,672,468
16012,Ramoulu,45260,45,20,70,30,80,60,170,90
16013,Rebréchien,45261,45,91,348,67,462,319,848,439
16014,Rouvray-Sainte-Croix,45262,45,8,25,13,33,38,84,33
16015,Rouvres-Saint-Jean,45263,45,15,85,20,108,75,203,100
16016,Rozières-en-Beauce,45264,45,12,64,12,64,52,128,76
16017,Rozoy-le-Vieil,45265,45,25,95,0,192,108,300,120
16018,Ruan,45266,45,10,55,10,70,69,149,65
16019,Saint-Aignan-des-Gués,45267,45,30,75,30,150,55,235,105
16020,Saint-Aignan-le-Jaillard,45268,45,76,120,68,212,128,408,196
16021,Saint-Ay,45269,45,387,805,246,1050,746,2042,1192
16022,Saint-Benoît-sur-Loire,45270,45,292,432,184,648,416,1248,724
16023,Saint-Brisson-sur-Loire,45271,45,120,205,40,480,170,690,325
16024,Saint-Cyr-en-Val,45272,45,450,609,263,1402,468,2133,1059
16025,Saint-Denis-de-l'Hôtel,45273,45,331,779,222,970,580,1772,1110
16026,Saint-Denis-en-Val,45274,45,1005,1783,557,2636,1192,4385,2788
16027,Saint-Firmin-des-Bois,45275,45,60,105,25,175,100,300,165
16028,Saint-Firmin-sur-Loire,45276,45,72,124,12,176,156,344,196
16029,Saint-Florent,20298,2B,77,72,16,148,78,242,149
16030,Sainte-Geneviève-des-Bois,45278,45,175,240,110,365,175,650,415
16031,Saint-Germain-des-Prés,45279,45,235,428,170,656,302,1128,663
16032,Saint-Gondon,45280,45,160,265,65,365,255,685,425
16033,Saint-Hilaire-les-Andrésis,45281,45,110,237,74,344,149,567,347
16034,Saint-Hilaire-Saint-Mesmin,45282,45,306,700,277,1042,530,1849,1006
16035,Saint-Hilaire-sur-Puiseaux,45283,45,24,25,26,54,21,101,49
16036,Saint-Jean-de-Braye,45284,45,1948,5329,2422,5849,3941,12212,7277
16037,Saint-Jean-de-la-Ruelle,45285,45,1905,4246,1979,4956,3073,10008,6151
16038,Saint-Jean-le-Blanc,45286,45,1042,1795,1111,2775,1329,5215,2837
16039,Saint-Loup-de-Gonois,45287,45,20,20,5,20,15,40,40
16040,Saint-Loup-des-Vignes,45288,45,98,95,35,95,75,205,193
16041,Saint-Lyé-la-Forêt,45289,45,94,320,80,353,270,703,414
16042,Saint-Martin-d'Abbat,45290,45,112,491,128,520,439,1087,603
16043,Saint-Martin-sur-Ocre,45291,45,195,260,65,495,215,775,455
16044,Saint-Maurice-sur-Aveyron,45292,45,102,231,44,249,161,454,333
16045,Saint-Maurice-sur-Fessard,45293,45,170,320,120,350,225,695,490
16046,Saint-Michel,45294,45,45,0,25,50,0,75,45
16047,Saint-Péravy-la-Colombe,45296,45,57,240,46,160,186,392,297
16048,Saint-Père-sur-Loire,45297,45,185,257,40,353,182,575,442
16049,Saint-Pryvé-Saint-Mesmin,45298,45,666,1186,514,2039,836,3389,1852
16050,Saint-Sigismond,45299,45,15,65,40,100,45,185,80
16051,Sandillon,45300,45,300,995,305,1645,660,2610,1295
16052,Santeau,45301,45,53,115,13,103,93,209,168
16053,Saran,45302,45,1601,4277,1498,5059,2820,9377,5878
16054,Sceaux-du-Gâtinais,45303,45,45,170,45,255,115,415,215
16055,Seichebrières,45305,45,4,41,25,45,41,111,45
16056,La Selle-en-Hermoy,45306,45,88,182,57,259,135,451,270
16057,La Selle-sur-le-Bied,45307,45,128,304,92,276,248,616,432
16058,Semoy,45308,45,301,829,312,1232,552,2096,1130
16059,Sennely,45309,45,76,182,38,196,158,392,258
16060,Sermaises,45310,45,195,384,161,486,277,924,579
16061,Sigloy,45311,45,60,215,45,205,120,370,275
16062,Solterre,45312,45,74,118,43,213,59,315,192
16063,Sougy,45313,45,84,192,108,308,160,576,276
16064,Sully-la-Chapelle,45314,45,45,105,35,118,115,268,150
16065,Sully-sur-Loire,45315,45,860,1310,575,1475,930,2980,2170
16066,Sury-aux-Bois,45316,45,91,218,61,226,156,443,309
16067,Tavers,45317,45,185,320,75,520,225,820,505
16068,Thignonville,45320,45,32,112,16,100,88,204,144
16069,Thimory,45321,45,45,235,50,230,170,450,280
16070,Thorailles,45322,45,20,56,20,28,40,88,76
16071,Thou,45323,45,36,44,20,80,40,140,80
16072,Tigy,45324,45,237,554,209,753,457,1419,791
16073,Tivernon,45325,45,24,73,16,76,58,150,97
16074,Tournoisis,45326,45,40,158,0,119,90,209,198
16075,Traînou,45327,45,180,967,280,1066,706,2052,1147
16076,Treilles-en-Gâtinais,45328,45,31,58,16,121,19,156,89
16077,Triguères,45329,45,208,316,52,472,292,816,524
16078,Trinay,45330,45,20,60,20,104,40,164,80
16079,Vannes-sur-Cosson,45331,45,56,140,80,184,108,372,196
16080,Varennes-Changy,45332,45,245,330,115,519,260,894,575
16081,Vennecy,45333,45,116,453,128,501,342,971,569
16082,Vieilles-Maisons-sur-Joudry,45334,45,52,202,28,152,190,370,254
16083,Vienne-en-Val,45335,45,180,540,180,640,400,1220,720
16084,Viglain,45336,45,100,232,60,304,180,544,332
16085,Villamblain,45337,45,18,68,24,79,61,164,86
16086,Villemandeur,45338,45,1258,1549,616,2247,945,3808,2807
16087,Villemoutiers,45339,45,78,112,22,125,86,233,190
16088,Villemurlin,45340,45,60,161,55,195,120,370,221
16089,Villeneuve-sur-Conie,45341,45,8,43,21,50,46,117,51
16090,Villereau,45342,45,10,120,20,120,110,250,130
16091,Villevoques,45343,45,24,48,25,48,31,104,72
16092,Villorceau,45344,45,105,280,85,425,230,740,385
16093,Vimory,45345,45,140,350,140,345,235,720,490
16094,Vitry-aux-Loges,45346,45,359,451,183,589,381,1153,810
16095,Vrigny,45347,45,88,248,44,236,208,488,336
16096,Yèvre-la-Ville,45348,45,100,141,40,245,114,399,241
16097,Albas,46001,46,77,61,29,230,60,319,138
16098,Albiac,46002,46,10,20,5,16,25,46,30
16099,Alvignac,46003,46,105,160,93,258,125,476,265
16100,Anglars,46004,46,36,32,28,80,24,132,68
16101,Anglars-Juillac,46005,46,58,60,15,145,53,213,118
16102,Anglars-Nozac,46006,46,56,64,24,96,80,200,120
16103,Arcambal,46007,46,115,240,50,340,215,605,355
16104,Les Arques,46008,46,65,30,0,85,25,110,95
16105,Assier,46009,46,110,140,20,227,95,342,250
16106,Aujols,46010,46,55,105,30,85,65,180,160
16107,Autoire,46011,46,46,54,8,161,41,210,100
16108,Aynac,46012,46,75,120,45,195,125,365,195
16109,Bach,46013,46,42,30,12,64,16,92,72
16110,Bagat-en-Quercy,46014,46,60,25,10,55,30,95,85
16111,Bagnac-sur-Célé,46015,46,212,320,131,513,237,881,532
16112,Baladou,46016,46,70,125,20,145,55,220,195
16113,Bannes,46017,46,33,6,0,49,15,64,39
16114,Le Bastit,46018,46,16,28,24,56,36,116,44
16115,Beauregard,46020,46,45,40,15,85,40,140,85
16116,Béduer,46021,46,76,164,32,288,164,484,240
16117,Bélaye,46022,46,70,24,10,121,15,146,94
16118,Belfort-du-Quercy,46023,46,67,96,6,175,86,267,163
16119,Belmont-Bretenoux,46024,46,39,97,12,148,72,232,136
16120,Belmont-Sainte-Foi,46026,46,45,5,0,35,10,45,50
16121,Berganty,46027,46,20,24,0,37,12,49,44
16122,Bétaille,46028,46,204,170,65,442,124,631,374
16123,Biars-sur-Cère,46029,46,360,417,173,688,294,1155,777
16124,Bio,46030,46,72,100,12,92,84,188,172
16125,Blars,46031,46,28,16,8,68,20,96,44
16126,Boissières,46032,46,84,80,28,108,76,212,164
16127,Le Boulvé,46033,46,4,27,4,112,13,129,31
16128,Le Bourg,46034,46,54,63,25,104,30,159,117
16129,Boussac,46035,46,23,34,12,54,38,104,57
16130,Le Bouyssou,46036,46,20,5,20,70,10,100,25
16131,Bouziès,46037,46,15,10,5,40,10,55,25
16132,Bretenoux,46038,46,272,276,80,396,268,744,548
16133,Brengues,46039,46,21,50,4,57,51,112,71
16134,Cabrerets,46040,46,44,60,0,88,36,124,104
16135,Cadrieu,46041,46,28,40,24,52,44,120,68
16136,Cahors,46042,46,3454,3933,1930,6356,3207,11493,7387
16137,Cahus,46043,46,17,52,12,62,35,109,69
16138,Caillac,46044,46,132,144,44,172,80,296,276
16139,Cajarc,46045,46,240,165,75,469,130,674,405
16140,Calamane,46046,46,79,125,35,140,95,270,204
16141,Calès,46047,46,40,25,5,50,30,85,65
16142,Calvignac,46049,46,40,35,5,105,30,140,75
16143,Cambayrac,46050,46,17,30,0,47,31,78,47
16144,Cambes,46051,46,56,57,29,102,62,193,113
16145,Camboulit,46052,46,30,60,5,130,40,175,90
16146,Camburat,46053,46,39,98,18,87,109,214,137
16147,Caniac-du-Causse,46054,46,41,71,26,89,61,176,112
16148,Capdenac,46055,46,196,224,76,392,176,644,420
16149,Carayac,46056,46,4,16,4,24,29,57,20
16150,Cardaillac,46057,46,90,123,24,197,87,308,213
16151,Carennac,46058,46,80,44,16,204,64,284,124
16152,Carlucet,46059,46,40,45,0,100,35,135,85
16153,Carnac-Rouffiac,46060,46,45,25,10,80,44,134,70
16154,Cassagnes,46061,46,24,40,8,76,44,128,64
16155,Castelfranc,46062,46,53,77,47,98,79,224,130
16156,Castelnau-Montratier,46063,46,379,325,95,705,240,1040,704
16157,Catus,46064,46,145,165,70,255,165,490,310
16158,Cavagnac,46065,46,70,120,40,120,105,265,190
16159,Cazals,46066,46,144,63,16,219,63,298,207
16160,Cazillac,46067,46,60,85,5,195,65,265,145
16161,Cénevières,46068,46,36,28,20,72,8,100,64
16162,Cézac,46069,46,10,31,15,87,20,122,41
16163,Cieurac,46070,46,35,145,55,165,105,325,180
16164,Concorès,46072,46,60,60,5,145,60,210,120
16165,Concots,46073,46,74,80,30,155,75,260,154
16166,Condat,46074,46,35,75,21,119,63,203,110
16167,Corn,46075,46,44,44,12,72,24,108,88
16168,Cornac,46076,46,40,80,20,136,80,236,120
16169,Cours,46077,46,70,90,5,95,50,150,160
16170,Couzou,46078,46,20,10,5,45,5,55,30
16171,Cras,46079,46,20,24,0,44,16,60,44
16172,Crayssac,46080,46,88,220,44,196,216,456,308
16173,Crégols,46081,46,20,4,0,28,12,40,24
16174,Cremps,46082,46,52,64,12,148,76,236,116
16175,Cressensac,46083,46,85,120,50,267,85,402,205
16176,Creysse,46084,46,53,32,9,106,41,156,85
16177,Cuzac,46085,46,50,60,5,90,50,145,110
16178,Cuzance,46086,46,75,135,35,210,105,350,210
16179,Dégagnac,46087,46,190,110,40,218,75,333,300
16180,Douelle,46088,46,80,205,30,335,215,580,285
16181,Duravel,46089,46,216,196,72,340,144,556,412
16182,Durbans,46090,46,25,21,12,50,16,78,46
16183,Escamps,46091,46,24,36,20,88,28,136,60
16184,Esclauzels,46092,46,50,40,15,95,30,140,90
16185,Espagnac-Sainte-Eulalie,46093,46,32,12,0,28,16,44,44
16186,Espédaillac,46094,46,47,26,9,96,22,127,73
16187,Espère,46095,46,105,231,61,383,137,581,336
16188,Espeyroux,46096,46,20,20,16,32,16,64,40
16189,Estal,46097,46,20,28,8,48,8,64,48
16190,Fajoles,46098,46,77,39,8,85,44,137,116
16191,Fargues,46099,46,27,27,6,50,16,72,54
16192,Faycelles,46100,46,124,124,9,219,112,340,248
16193,Felzins,46101,46,64,112,28,116,100,244,176
16194,Figeac,46102,46,1725,1980,1265,3085,1365,5715,3705
16195,Saint-Paul-Flaugnac,46103,46,152,187,82,371,151,604,339
16196,Flaujac-Gare,46104,46,16,24,0,24,32,56,40
16197,Flaujac-Poujols,46105,46,60,156,48,344,108,500,216
16198,Floirac,46106,46,60,45,30,103,40,173,105
16199,Floressas,46107,46,25,20,15,70,25,110,45
16200,Fons,46108,46,91,60,17,103,80,200,151
16201,Fontanes,46109,46,80,95,25,165,85,275,175
16202,Fourmagnac,46111,46,13,27,6,57,19,82,40
16203,Francoulès,46112,46,34,34,16,57,36,109,68
16204,Frayssinet,46113,46,70,65,15,100,50,165,135
16205,Frayssinet-le-Gélat,46114,46,61,35,12,169,32,213,96
16206,Frayssinhes,46115,46,19,25,6,73,19,98,44
16207,Frontenac,46116,46,12,12,0,24,16,40,24
16208,Gagnac-sur-Cère,46117,46,100,144,24,212,196,432,244
16209,Gignac,46118,46,116,144,16,228,148,392,260
16210,Gigouzac,46119,46,36,52,8,92,40,140,88
16211,Gindou,46120,46,60,45,25,160,20,205,105
16212,Ginouillac,46121,46,15,15,25,85,10,120,30
16213,Gintrac,46122,46,6,24,12,27,26,65,30
16214,Girac,46123,46,76,53,8,122,53,183,129
16215,Glanes,46124,46,17,72,20,91,45,156,89
16216,Gorses,46125,46,72,56,13,75,56,144,128
16217,Goujounac,46126,46,20,35,30,85,40,155,55
16218,Gourdon,46127,46,1000,670,298,1504,502,2304,1670
16219,Gramat,46128,46,712,596,336,1168,508,2012,1308
16220,Gréalou,46129,46,52,60,12,100,60,172,112
16221,Grézels,46130,46,69,15,41,99,5,145,84
16222,Grèzes,46131,46,25,40,13,59,26,98,65
16223,Issendolus,46132,46,43,128,20,161,104,285,171
16224,Issepts,46133,46,10,45,15,90,55,160,55
16225,Les Junies,46134,46,29,48,4,111,37,152,77
16226,Labastide-du-Haut-Mont,46135,46,0,20,10,20,15,45,20
16227,Labastide-du-Vert,46136,46,32,60,16,88,52,156,92
16228,Labastide-Marnhac,46137,46,145,290,85,415,275,775,435
16229,Coeur de Causse,46138,46,211,180,65,412,105,582,391
16230,Labathude,46139,46,45,75,5,60,40,105,120
16231,Laburgade,46140,46,28,108,12,116,76,204,136
16232,Lacapelle-Cabanac,46142,46,35,35,5,45,40,90,70
16233,Lacapelle-Marival,46143,46,277,160,115,410,125,650,437
16234,Lacave,46144,46,29,52,6,110,40,156,81
16235,Lachapelle-Auzac,46145,46,163,140,43,214,169,426,303
16236,Ladirat,46146,46,40,15,5,45,10,60,55
16237,Lagardelle,46147,46,32,21,0,28,12,40,53
16238,Lalbenque,46148,46,265,340,120,620,310,1050,605
16239,Lamagdelaine,46149,46,120,160,35,285,100,420,280
16240,Lamothe-Cassel,46151,46,23,45,10,75,10,95,68
16241,Lamothe-Fénelon,46152,46,66,25,22,100,22,144,91
16242,Lanzac,46153,46,80,120,40,230,125,395,200
16243,Laramière,46154,46,43,76,40,82,69,191,119
16244,Larnagol,46155,46,28,9,6,58,9,73,37
16245,Laroque-des-Arcs,46156,46,55,125,45,185,105,335,180
16246,Larroque-Toirac,46157,46,20,35,10,55,30,95,55
16247,Lascabanes,46158,46,40,40,36,68,24,128,80
16248,Latouille-Lentillac,46159,46,15,40,20,95,40,155,55
16249,Latronquière,46160,46,108,65,50,123,34,207,173
16250,Lauresses,46161,46,64,45,5,99,55,159,109
16251,Lauzès,46162,46,40,40,12,64,28,104,80
16252,Laval-de-Cère,46163,46,41,58,23,92,52,167,99
16253,Lavercantière,46164,46,24,52,20,96,40,156,76
16254,Lavergne,46165,46,57,94,47,141,68,256,151
16255,Lentillac-du-Causse,46167,46,30,0,5,55,5,65,30
16256,Lentillac-Saint-Blaise,46168,46,12,24,3,66,22,91,36
16257,Léobard,46169,46,40,40,12,72,36,120,80
16258,Leyme,46170,46,105,130,35,315,135,485,235
16259,Lherm,46171,46,40,25,20,115,25,160,65
16260,Lhospitalet,46172,46,44,108,32,164,96,292,152
16261,Limogne-en-Quercy,46173,46,185,140,35,285,104,424,325
16262,Linac,46174,46,45,25,25,110,20,155,70
16263,Lissac-et-Mouret,46175,46,119,215,45,435,105,585,334
16264,Livernon,46176,46,73,162,79,203,94,376,235
16265,Loubressac,46177,46,70,115,60,190,85,335,185
16266,Loupiac,46178,46,56,36,32,112,16,160,92
16267,Lugagnac,46179,46,12,12,12,60,16,88,24
16268,Lunan,46180,46,40,128,33,222,82,337,168
16269,Lunegarde,46181,46,20,15,10,20,25,55,35
16270,Luzech,46182,46,401,237,92,550,203,845,638
16271,Marcilhac-sur-Célé,46183,46,52,12,16,96,4,116,64
16272,Marminiac,46184,46,48,68,32,164,52,248,116
16273,Martel,46185,46,330,275,115,545,210,870,605
16274,Masclat,46186,46,42,65,21,109,55,185,107
16275,Mauroux,46187,46,68,108,28,260,68,356,176
16276,Maxou,46188,46,20,90,5,135,60,200,110
16277,Mayrinhac-Lentour,46189,46,45,100,40,195,120,355,145
16278,Mechmont,46190,46,25,10,10,55,10,75,35
16279,Mercuès,46191,46,168,234,111,272,188,571,402
16280,Meyronne,46192,46,60,56,16,98,19,133,116
16281,Miers,46193,46,54,92,43,152,63,258,146
16282,Milhac,46194,46,25,40,0,95,25,120,65
16283,Molières,46195,46,84,68,48,116,56,220,152
16284,Montamel,46196,46,26,0,8,46,0,54,26
16285,Le Montat,46197,46,110,240,55,440,165,660,350
16286,Montbrun,46198,46,15,15,10,50,5,65,30
16287,Montcabrier,46199,46,119,29,21,110,29,160,148
16288,Montcléra,46200,46,76,36,20,112,28,160,112
16289,Montcuq-en-Quercy-Blanc,46201,46,441,312,121,521,216,858,753
16290,Montdoumerc,46202,46,88,110,37,122,103,262,198
16291,Montet-et-Bouxal,46203,46,40,75,10,80,30,120,115
16292,Montfaucon,46204,46,105,95,25,135,70,230,200
16293,Montgesty,46205,46,85,53,8,102,57,167,138
16294,Montlauzun,46206,46,20,30,10,40,20,70,50
16295,Montredon,46207,46,20,47,4,95,33,132,67
16296,Montvalent,46208,46,25,30,40,130,45,215,55
16297,Nadaillac-de-Rouge,46209,46,9,19,3,92,12,107,28
16298,Nadillac,46210,46,10,5,0,25,10,35,15
16299,Nuzéjouls,46211,46,25,85,45,140,75,260,110
16300,Orniac,46212,46,5,10,5,45,10,60,15
16301,Padirac,46213,46,51,20,5,60,10,75,71
16302,Parnac,46214,46,75,75,20,130,85,235,150
16303,Payrac,46215,46,155,80,45,255,95,395,235
16304,Payrignac,46216,46,130,145,45,210,145,400,275
16305,Pern,46217,46,95,110,30,125,85,240,205
16306,Pescadoires,46218,46,16,64,28,28,44,100,80
16307,Peyrilles,46219,46,64,76,32,140,72,244,140
16308,Pinsac,46220,46,158,138,17,227,153,397,296
16309,Planioles,46221,46,80,100,72,156,84,312,180
16310,Pomarède,46222,46,12,34,6,54,31,91,46
16311,Pontcirq,46223,46,35,15,5,90,10,105,50
16312,Pradines,46224,46,529,825,173,1170,668,2011,1354
16313,Prayssac,46225,46,678,372,145,920,241,1306,1050
16314,Prendeignes,46226,46,45,30,15,95,35,145,75
16315,Promilhanes,46227,46,74,25,9,62,24,95,99
16316,Prudhomat,46228,46,135,130,55,290,120,465,265
16317,Puybrun,46229,46,188,184,68,280,176,524,372
16318,Puyjourdes,46230,46,20,15,0,20,20,40,35
16319,Puy-l'Évêque,46231,46,452,386,74,649,343,1066,838
16320,Les Quatre-Routes-du-Lot,46232,46,130,132,44,146,100,290,262
16321,Quissac,46233,46,25,45,0,45,15,60,70
16322,Rampoux,46234,46,6,10,0,33,24,57,16
16323,Reilhac,46235,46,24,48,20,56,36,112,72
16324,Reilhaguet,46236,46,26,18,8,65,4,77,44
16325,Reyrevignes,46237,46,43,75,18,126,52,196,118
16326,Rignac,46238,46,40,50,5,155,25,185,90
16327,Le Roc,46239,46,50,25,5,70,45,120,75
16328,Rocamadour,46240,46,140,116,28,224,84,336,256
16329,Rouffilhac,46241,46,16,32,0,88,40,128,48
16330,Rudelle,46242,46,42,23,3,58,20,81,65
16331,Rueyres,46243,46,37,49,15,43,30,88,86
16332,Sabadel-Latronquière,46244,46,21,9,4,28,8,40,30
16333,Sabadel-Lauzès,46245,46,25,0,0,45,10,55,25
16334,Saignes,46246,46,10,20,20,30,5,55,30
16335,Saillac,46247,46,20,40,20,60,24,104,60
16336,Sainte-Alauzie,46248,46,25,12,0,39,9,48,37
16337,Saint-Bressou,46249,46,10,40,0,50,25,75,50
16338,Saint-Caprais,46250,46,25,0,3,16,7,26,25
16339,Saint-Céré,46251,46,688,611,325,1227,445,1997,1299
16340,Les Pechs du Vers,46252,46,54,10,24,131,12,167,64
16341,Saint-Chamarand,46253,46,56,32,12,72,24,108,88
16342,Saint-Chels,46254,46,40,4,4,72,12,88,44
16343,Saint-Cirgues,46255,46,59,65,25,165,35,225,124
16344,Saint-Cirq-Lapopie,46256,46,35,30,15,70,50,135,65
16345,Saint-Cirq-Madelon,46257,46,5,25,25,65,10,100,30
16346,Saint-Cirq-Souillaguet,46258,46,25,15,10,103,10,123,40
16347,Saint-Clair,46259,46,20,24,16,76,24,116,44
16348,Sainte-Colombe,46260,46,29,34,20,24,65,109,63
16349,Saint-Cyprien,46262,46,40,50,20,115,30,165,90
16350,Saint-Daunès,46263,46,46,43,12,58,33,103,89
16351,Saint-Denis-Catus,46264,46,5,35,5,84,40,129,40
16352,Saint-Denis-lès-Martel,46265,46,45,60,12,116,43,171,105
16353,Saint-Félix,46266,46,24,148,40,144,128,312,172
16354,Saint-Germain-du-Bel-Air,46267,46,88,88,60,229,56,345,176
16355,Saint-Géry,46268,46,79,69,16,161,63,240,148
16356,Saint-Hilaire,46269,46,16,8,12,32,16,60,24
16357,Saint-Jean-de-Laur,46270,46,20,52,16,112,40,168,72
16358,Saint-Jean-Lespinasse,46271,46,30,85,20,195,79,294,115
16359,Saint-Jean-Mirabel,46272,46,15,25,34,128,25,187,40
16360,Saint-Laurent-les-Tours,46273,46,185,155,85,375,105,565,340
16361,Saint-Laurent-Lolmie,46274,46,30,30,0,91,25,116,60
16362,Saint-Martin-Labouval,46276,46,24,19,6,82,12,100,43
16363,Saint-Martin-le-Redon,46277,46,40,42,0,75,29,104,82
16364,Saint-Matré,46278,46,8,24,8,48,12,68,32
16365,Saint-Maurice-en-Quercy,46279,46,60,20,30,75,25,130,80
16366,Saint-Médard,46280,46,24,28,20,80,4,104,52
16367,Saint-Médard-de-Presque,46281,46,36,32,20,64,32,116,68
16368,Saint-Médard-Nicourby,46282,46,6,16,3,28,13,44,22
16369,Saint-Michel-de-Bannières,46283,46,40,72,60,108,48,216,112
16370,Saint-Michel-Loubéjou,46284,46,60,60,29,131,65,225,120
16371,Saint-Pantaléon,46285,46,12,52,28,104,60,192,64
16372,Saint-Paul-de-Vern,46286,46,45,40,0,90,15,105,85
16373,Saint-Perdoux,46288,46,48,28,16,80,16,112,76
16374,Saint-Pierre-Toirac,46289,46,24,28,4,68,8,80,52
16375,Saint-Projet,46290,46,86,51,22,97,40,159,137
16376,Saint-Simon,46292,46,25,39,16,37,27,80,64
16377,Saint-Sozy,46293,46,113,65,15,215,65,295,178
16378,Saint-Sulpice,46294,46,36,28,0,44,20,64,64
16379,Saint-Vincent-du-Pendit,46295,46,16,21,25,63,23,111,37
16380,Saint-Vincent-Rive-d'Olt,46296,46,48,48,38,195,57,290,96
16381,Salviac,46297,46,228,228,48,496,144,688,456
16382,Sarrazac,46298,46,136,65,34,174,80,288,201
16383,Sauliac-sur-Célé,46299,46,24,8,12,64,8,84,32
16384,Saux,46300,46,18,19,3,35,22,60,37
16385,Sauzet,46301,46,96,148,24,164,76,264,244
16386,Sénaillac-Latronquière,46302,46,45,25,0,40,30,70,70
16387,Sénaillac-Lauzès,46303,46,39,13,8,33,16,57,52
16388,Séniergues,46304,46,12,16,15,45,9,69,28
16389,Sérignac,46305,46,60,50,15,150,35,200,110
16390,Sonac,46306,46,21,9,0,24,8,32,30
16391,Soturac,46307,46,100,124,32,172,115,319,224
16392,Soucirac,46308,46,17,3,9,48,0,57,20
16393,Souillac,46309,46,742,582,283,1092,502,1877,1324
16394,Soulomès,46310,46,16,20,20,36,20,76,36
16395,Sousceyrac-en-Quercy,46311,46,340,166,120,472,111,703,506
16396,Strenquels,46312,46,43,52,20,48,67,135,95
16397,Tauriac,46313,46,52,71,8,133,85,226,123
16398,Terrou,46314,46,35,20,15,85,15,115,55
16399,Teyssieu,46315,46,55,20,5,60,40,105,75
16400,Thédirac,46316,46,92,64,12,88,56,156,156
16401,Thégra,46317,46,35,95,35,210,104,349,130
16402,Thémines,46318,46,35,30,10,110,15,135,65
16403,Théminettes,46319,46,8,47,12,37,43,92,55
16404,Tour-de-Faure,46320,46,103,60,25,133,35,193,163
16405,Touzac,46321,46,56,88,20,124,80,224,144
16406,Trespoux-Rassiels,46322,46,56,212,44,336,136,516,268
16407,Ussel,46323,46,13,6,3,19,19,41,19
16408,Uzech,46324,46,36,20,16,120,24,160,56
16409,Valroufié,46327,46,32,69,22,212,47,281,101
16410,Varaire,46328,46,72,58,12,79,53,144,130
16411,Vaylats,46329,46,29,65,16,96,37,149,94
16412,Vayrac,46330,46,276,212,80,464,160,704,488
16413,Vers,46331,46,56,80,24,172,84,280,136
16414,Viazac,46332,46,66,54,12,96,48,156,120
16415,Vidaillac,46333,46,48,16,4,80,4,88,64
16416,Le Vigan,46334,46,308,355,42,543,248,833,663
16417,Villesèque,46335,46,50,94,23,120,61,204,144
16418,Vire-sur-Lot,46336,46,29,57,22,161,34,217,86
16419,Mayrac,46337,46,41,60,23,76,39,138,101
16420,Bessonies,46338,46,20,10,0,30,10,40,30
16421,Saint-Jean-Lagineste,46339,46,45,80,10,125,70,205,125
16422,Saint-Pierre-Lafeuille,46340,46,36,88,8,128,108,244,124
16423,Agen,47001,47,4409,7090,5275,8983,6049,20307,11499
16424,Agmé,47002,47,35,20,5,35,20,60,55
16425,Agnac,47003,47,124,60,10,168,70,248,184
16426,Aiguillon,47004,47,732,954,302,1309,653,2264,1686
16427,Allemans-du-Dropt,47005,47,120,105,35,180,50,265,225
16428,Allez-et-Cazeneuve,47006,47,50,121,40,288,80,408,171
16429,Allons,47007,47,25,45,0,90,20,110,70
16430,Ambrus,47008,47,25,21,4,36,4,44,46
16431,Andiran,47009,47,45,53,12,45,51,108,98
16432,Antagnac,47010,47,64,60,8,56,60,124,124
16433,Anthé,47011,47,60,20,15,83,10,108,80
16434,Anzex,47012,47,44,60,16,117,52,185,104
16435,Argenton,47013,47,40,60,15,170,20,205,100
16436,Armillac,47014,47,50,44,9,54,40,103,94
16437,Astaffort,47015,47,304,464,140,716,316,1172,768
16438,Aubiac,47016,47,76,252,64,416,212,692,328
16439,Auradou,47017,47,64,80,28,116,80,224,144
16440,Auriac-sur-Dropt,47018,47,21,21,6,87,15,108,42
16441,Bajamont,47019,47,65,220,70,450,195,715,285
16442,Baleyssagues,47020,47,60,35,5,60,10,75,95
16443,Barbaste,47021,47,270,320,120,595,175,890,590
16444,Bazens,47022,47,64,101,27,177,67,271,165
16445,Beaugas,47023,47,57,58,30,118,47,195,115
16446,Beaupuy,47024,47,160,396,88,625,322,1035,556
16447,Beauville,47025,47,96,80,70,202,51,323,176
16448,Beauziac,47026,47,36,48,24,100,52,176,84
16449,Bias,47027,47,599,713,245,1088,448,1781,1312
16450,Birac-sur-Trec,47028,47,116,216,48,300,145,493,332
16451,Blanquefort-sur-Briolance,47029,47,95,90,25,200,65,290,185
16452,Blaymont,47030,47,25,35,0,95,35,130,60
16453,Boé,47031,47,687,1394,491,1735,1004,3230,2081
16454,Bon-Encontre,47032,47,994,1359,509,2267,937,3713,2353
16455,Boudy-de-Beauregard,47033,47,35,140,35,165,80,280,175
16456,Bouglon,47034,47,95,125,30,230,120,380,220
16457,Bourgougnague,47035,47,32,47,38,114,20,172,79
16458,Bourlens,47036,47,73,60,16,131,46,193,133
16459,Bournel,47037,47,38,45,25,100,35,160,83
16460,Bourran,47038,47,95,147,16,185,99,300,242
16461,Boussès,47039,47,0,5,0,30,5,35,5
16462,Brax,47040,47,292,472,200,656,384,1240,764
16463,Bruch,47041,47,110,230,40,225,160,425,340
16464,Brugnac,47042,47,39,42,15,19,40,74,81
16465,Buzet-sur-Baïse,47043,47,195,300,90,480,220,790,495
16466,Cahuzac,47044,47,33,57,8,137,39,184,90
16467,Calignac,47045,47,52,141,24,184,104,312,193
16468,Calonges,47046,47,80,159,26,215,104,345,239
16469,Cambes,47047,47,20,24,20,60,40,120,44
16470,Cancon,47048,47,236,296,72,436,228,736,532
16471,Casseneuil,47049,47,336,461,230,763,351,1344,797
16472,Cassignas,47050,47,31,26,8,33,17,58,57
16473,Castelculier,47051,47,265,581,132,792,457,1381,846
16474,Casteljaloux,47052,47,1138,711,344,1509,685,2538,1849
16475,Castella,47053,47,40,92,24,128,64,216,132
16476,Castelmoron-sur-Lot,47054,47,256,336,132,596,232,960,592
16477,Castelnaud-de-Gratecambe,47055,47,61,80,12,203,91,306,141
16478,Castelnau-sur-Gupie,47056,47,120,200,83,310,120,513,320
16479,Castillonnès,47057,47,299,300,115,396,205,716,599
16480,Caubeyres,47058,47,52,36,4,65,16,85,88
16481,Caubon-Saint-Sauveur,47059,47,24,44,16,124,32,172,68
16482,Caudecoste,47060,47,84,270,110,363,200,673,354
16483,Caumont-sur-Garonne,47061,47,68,176,64,188,152,404,244
16484,Cauzac,47062,47,85,98,40,95,103,238,183
16485,Cavarc,47063,47,16,29,28,56,20,104,45
16486,Cazideroque,47064,47,15,70,20,105,40,165,85
16487,Clairac,47065,47,354,555,214,883,435,1532,909
16488,Clermont-Dessous,47066,47,59,216,101,246,169,516,275
16489,Clermont-Soubiran,47067,47,60,94,25,148,50,223,154
16490,Cocumont,47068,47,208,260,100,344,196,640,468
16491,Colayrac-Saint-Cirq,47069,47,396,663,252,1016,508,1776,1059
16492,Condezaygues,47070,47,145,148,47,289,149,485,293
16493,Coulx,47071,47,50,25,35,85,20,140,75
16494,Courbiac,47072,47,20,20,8,64,4,76,40
16495,Cours,47073,47,40,50,0,75,35,110,90
16496,Couthures-sur-Garonne,47074,47,100,50,35,115,40,190,150
16497,La Croix-Blanche,47075,47,121,224,57,296,201,554,345
16498,Cuq,47076,47,20,55,5,135,50,190,75
16499,Cuzorn,47077,47,170,180,40,300,150,490,350
16500,Damazan,47078,47,194,223,141,398,204,743,417
16501,Dausse,47079,47,75,145,15,159,105,279,220
16502,Dévillac,47080,47,17,17,4,55,24,83,34
16503,Dolmayrac,47081,47,115,170,30,228,168,426,285
16504,Dondas,47082,47,43,15,22,86,19,127,58
16505,Doudrac,47083,47,18,15,0,40,20,60,33
16506,Douzains,47084,47,57,42,9,84,23,116,99
16507,Durance,47085,47,39,54,15,91,40,146,93
16508,Duras,47086,47,270,220,105,465,160,730,490
16509,Engayrac,47087,47,13,42,0,63,21,84,55
16510,Escassefort,47088,47,49,135,74,199,78,351,184
16511,Esclottes,47089,47,32,16,28,72,4,104,48
16512,Espiens,47090,47,50,87,43,105,44,192,137
16513,Estillac,47091,47,256,467,129,560,438,1127,723
16514,Fals,47092,47,30,110,15,170,60,245,140
16515,Fargues-sur-Ourbise,47093,47,25,75,5,170,75,250,100
16516,Fauguerolles,47094,47,31,202,84,226,166,476,233
16517,Fauillet,47095,47,175,180,39,239,141,419,355
16518,Ferrensac,47096,47,8,52,4,116,44,164,60
16519,Feugarolles,47097,47,129,190,90,334,160,584,319
16520,Fieux,47098,47,30,75,35,110,75,220,105
16521,Fongrave,47099,47,117,176,18,132,111,261,293
16522,Foulayronnes,47100,47,666,1252,321,1938,946,3205,1918
16523,Fourques-sur-Garonne,47101,47,176,280,96,500,224,820,456
16524,Francescas,47102,47,100,160,50,225,140,415,260
16525,Fréchou,47103,47,24,24,16,88,36,140,48
16526,Frégimont,47104,47,20,56,15,116,50,181,76
16527,Frespech,47105,47,33,60,22,81,57,160,93
16528,Fumel,47106,47,960,955,440,1781,633,2854,1915
16529,Galapian,47107,47,45,65,5,135,65,205,110
16530,Gaujac,47108,47,45,50,25,95,48,168,95
16531,Gavaudun,47109,47,35,35,10,156,49,215,70
16532,Gontaud-de-Nogaret,47110,47,252,382,76,534,322,932,634
16533,Granges-sur-Lot,47111,47,100,115,35,215,100,350,215
16534,Grateloup-Saint-Gayrand,47112,47,85,105,25,155,80,260,190
16535,Grayssas,47113,47,28,24,8,28,44,80,52
16536,Grézet-Cavagnan,47114,47,33,76,25,123,72,220,109
16537,Guérin,47115,47,75,55,15,90,20,125,130
16538,Hautefage-la-Tour,47117,47,51,242,64,248,246,558,293
16539,Hautesvignes,47118,47,12,47,0,46,43,89,59
16540,Houeillès,47119,47,102,112,18,210,90,318,214
16541,Jusix,47120,47,25,30,10,35,20,65,55
16542,Labastide-Castel-Amouroux,47121,47,50,65,30,105,45,180,115
16543,Labretonie,47122,47,25,50,10,65,40,115,75
16544,Lacapelle-Biron,47123,47,63,82,44,169,54,267,145
16545,Lacaussade,47124,47,36,60,20,36,56,112,96
16546,Lacépède,47125,47,84,68,32,108,36,176,152
16547,Lachapelle,47126,47,15,15,0,15,30,45,30
16548,Lafitte-sur-Lot,47127,47,84,216,52,292,144,488,300
16549,Lafox,47128,47,135,295,145,355,230,730,430
16550,Lagarrigue,47129,47,4,56,40,140,44,224,60
16551,Lagruère,47130,47,56,64,44,140,64,248,120
16552,Lagupie,47131,47,76,190,44,293,161,498,266
16553,Lalandusse,47132,47,28,48,16,76,40,132,76
16554,Lamontjoie,47133,47,57,117,16,162,98,276,174
16555,Lannes,47134,47,75,63,26,134,45,205,138
16556,Laparade,47135,47,30,80,25,170,70,265,110
16557,Laperche,47136,47,25,15,15,50,25,90,40
16558,Laplume,47137,47,196,372,140,404,336,880,568
16559,Laroque-Timbaut,47138,47,225,366,86,508,350,944,591
16560,Lasserre,47139,47,5,20,0,40,10,50,25
16561,Laugnac,47140,47,104,132,16,204,176,396,236
16562,Laussou,47141,47,60,50,10,125,40,175,110
16563,Lauzun,47142,47,137,113,26,311,61,398,250
16564,Lavardac,47143,47,487,433,172,756,313,1241,920
16565,Lavergne,47144,47,80,115,45,265,85,395,195
16566,Layrac,47145,47,470,674,425,1276,544,2245,1144
16567,Lédat,47146,47,86,339,103,548,230,881,425
16568,Lévignac-de-Guyenne,47147,47,118,99,53,201,107,361,217
16569,Leyritz-Moncassin,47148,47,35,35,5,90,40,135,70
16570,Longueville,47150,47,35,100,40,125,60,225,135
16571,Loubès-Bernac,47151,47,43,56,24,130,47,201,99
16572,Lougratte,47152,47,125,77,20,124,62,206,202
16573,Lusignan-Petit,47154,47,12,79,34,109,66,209,91
16574,Madaillan,47155,47,135,155,25,215,115,355,290
16575,Marcellus,47156,47,105,200,60,318,155,533,305
16576,Marmande,47157,47,3302,3506,1888,5873,2651,10412,6808
16577,Marmont-Pachas,47158,47,4,50,4,36,41,81,54
16578,Le Mas-d'Agenais,47159,47,195,309,110,530,254,894,504
16579,Masquières,47160,47,34,30,7,57,22,86,64
16580,Massels,47161,47,8,29,8,54,8,70,37
16581,Massoulès,47162,47,48,48,8,48,48,104,96
16582,Mauvezin-sur-Gupie,47163,47,54,113,44,252,78,374,167
16583,Mazières-Naresse,47164,47,40,25,0,65,20,85,65
16584,Meilhan-sur-Garonne,47165,47,258,274,71,383,234,688,532
16585,Mézin,47167,47,314,265,155,510,215,880,579
16586,Miramont-de-Guyenne,47168,47,770,472,213,1120,412,1745,1242
16587,Moirax,47169,47,105,285,80,455,245,780,390
16588,Monbahus,47170,47,110,125,45,255,75,375,235
16589,Monbalen,47171,47,45,108,16,138,79,233,153
16590,Moncaut,47172,47,30,180,45,185,170,400,210
16591,Monclar,47173,47,183,150,95,274,95,464,333
16592,Moncrabeau,47174,47,185,134,20,216,103,339,319
16593,Monflanquin,47175,47,471,395,190,859,335,1384,866
16594,Mongaillard,47176,47,40,45,5,65,25,95,85
16595,Monheurt,47177,47,40,40,30,75,25,130,80
16596,Monségur,47178,47,44,61,28,167,55,250,105
16597,Monsempron-Libos,47179,47,504,409,163,726,207,1096,913
16598,Montagnac-sur-Auvignon,47180,47,60,140,52,256,116,424,200
16599,Montagnac-sur-Lède,47181,47,84,28,28,76,24,128,112
16600,Montastruc,47182,47,64,56,12,108,48,168,120
16601,Montauriol,47183,47,65,15,15,50,15,80,80
16602,Montaut,47184,47,57,25,0,91,28,119,82
16603,Montayral,47185,47,567,505,156,1203,314,1673,1072
16604,Montesquieu,47186,47,104,180,76,220,180,476,284
16605,Monteton,47187,47,55,59,38,79,46,163,114
16606,Montignac-de-Lauzun,47188,47,51,46,12,86,40,138,97
16607,Montignac-Toupinerie,47189,47,20,24,4,45,20,69,44
16608,Montpezat,47190,47,92,124,48,224,76,348,216
16609,Montpouillan,47191,47,38,186,59,281,145,485,224
16610,Monviel,47192,47,25,10,10,20,10,40,35
16611,Moulinet,47193,47,24,29,4,92,21,117,53
16612,Moustier,47194,47,80,75,20,90,45,155,155
16613,Nérac,47195,47,1357,1238,680,2321,948,3949,2595
16614,Nicole,47196,47,36,96,25,100,46,171,132
16615,Nomdieu,47197,47,24,39,21,83,35,139,63
16616,Pailloles,47198,47,45,105,5,140,50,195,150
16617,Pardaillan,47199,47,50,70,30,115,35,180,120
16618,Parranquet,47200,47,25,5,5,90,0,95,30
16619,Le Passage,47201,47,1700,2101,836,3073,1584,5493,3801
16620,Paulhiac,47202,47,45,100,15,115,30,160,145
16621,Penne-d'Agenais,47203,47,302,408,172,761,350,1283,710
16622,Peyrière,47204,47,40,52,16,120,52,188,92
16623,Pindères,47205,47,25,35,15,145,5,165,60
16624,Pinel-Hauterive,47206,47,75,120,45,258,70,373,195
16625,Pompiey,47207,47,16,44,4,108,48,160,60
16626,Pompogne,47208,47,35,40,15,45,30,90,75
16627,Pont-du-Casse,47209,47,584,839,305,1541,747,2593,1423
16628,Port-Sainte-Marie,47210,47,275,418,210,639,303,1152,693
16629,Poudenas,47211,47,29,32,20,89,21,130,61
16630,Poussignac,47212,47,60,60,15,105,45,165,120
16631,Prayssas,47213,47,165,165,95,353,125,573,330
16632,Puch-d'Agenais,47214,47,105,165,35,275,110,420,270
16633,Pujols,47215,47,700,782,225,1326,563,2114,1482
16634,Puymiclan,47216,47,80,170,20,233,130,383,250
16635,Puymirol,47217,47,120,210,75,240,210,525,330
16636,Puysserampion,47218,47,48,60,8,126,36,170,108
16637,Rayet,47219,47,16,32,20,60,36,116,48
16638,Razimet,47220,47,36,91,44,86,64,194,127
16639,Réaup-Lisse,47221,47,135,133,16,150,129,295,268
16640,La Réunion,47222,47,60,122,16,181,105,302,182
16641,Rives,47223,47,55,40,5,75,45,125,95
16642,Romestaing,47224,47,55,25,5,50,30,85,80
16643,Roquefort,47225,47,295,455,85,620,380,1085,750
16644,Roumagne,47226,47,107,75,54,177,88,319,182
16645,Ruffiac,47227,47,36,28,12,60,32,104,64
16646,Saint-Antoine-de-Ficalba,47228,47,74,149,46,233,131,410,223
16647,Saint-Astier,47229,47,28,60,12,76,40,128,88
16648,Saint-Aubin,47230,47,96,88,40,152,60,252,184
16649,Saint-Avit,47231,47,40,35,20,65,15,100,75
16650,Saint-Barthélemy-d'Agenais,47232,47,136,80,40,152,80,272,216
16651,Sainte-Bazeille,47233,47,510,660,240,1105,510,1855,1170
16652,Saint-Caprais-de-Lerm,47234,47,55,155,45,240,135,420,210
16653,Saint-Colomb-de-Lauzun,47235,47,105,90,30,196,65,291,195
16654,Sainte-Colombe-de-Duras,47236,47,15,40,15,30,15,60,55
16655,Sainte-Colombe-de-Villeneuve,47237,47,76,101,28,209,65,302,177
16656,Sainte-Colombe-en-Bruilhois,47238,47,173,417,145,487,318,950,590
16657,Saint-Étienne-de-Fougères,47239,47,115,205,65,300,145,510,320
16658,Saint-Étienne-de-Villeréal,47240,47,45,70,15,130,35,180,115
16659,Saint-Eutrope-de-Born,47241,47,100,188,60,256,96,412,288
16660,Saint-Front-sur-Lémance,47242,47,92,98,16,182,93,291,190
16661,Sainte-Gemme-Martaillac,47244,47,50,85,60,120,70,250,135
16662,Saint-Géraud,47245,47,4,17,0,29,17,46,21
16663,Saint-Hilaire-de-Lusignan,47246,47,216,372,120,448,280,848,588
16664,Saint-Jean-de-Duras,47247,47,36,52,12,104,32,148,88
16665,Saint-Jean-de-Thurac,47248,47,56,104,25,214,76,315,160
16666,Saint-Laurent,47249,47,76,112,68,164,80,312,188
16667,Saint-Léger,47250,47,25,25,6,43,25,74,50
16668,Saint-Léon,47251,47,44,56,16,128,48,192,100
16669,Sainte-Livrade-sur-Lot,47252,47,1135,1336,585,1978,991,3554,2471
16670,Sainte-Marthe,47253,47,96,146,48,153,89,290,242
16671,Saint-Martin-Curton,47254,47,70,60,10,85,60,155,130
16672,Saint-Martin-de-Beauville,47255,47,29,20,12,55,16,83,49
16673,Saint-Martin-de-Villeréal,47256,47,10,10,5,80,5,90,20
16674,Saint-Martin-Petit,47257,47,68,136,48,160,100,308,204
16675,Sainte-Maure-de-Peyriac,47258,47,60,70,10,160,40,210,130
16676,Saint-Maurice-de-Lestapel,47259,47,24,20,12,40,4,56,44
16677,Saint-Maurin,47260,47,65,100,40,190,60,290,165
16678,Saint-Nicolas-de-la-Balerme,47262,47,46,86,30,112,76,218,132
16679,Saint-Pardoux-du-Breuil,47263,47,60,132,20,264,120,404,192
16680,Saint-Pardoux-Isaac,47264,47,391,170,90,400,115,605,561
16681,Saint-Pastour,47265,47,44,108,28,144,64,236,152
16682,Saint-Pé-Saint-Simon,47266,47,35,25,10,115,25,150,60
16683,Saint-Pierre-de-Buzet,47267,47,30,65,10,120,65,195,95
16684,Saint-Pierre-de-Clairac,47269,47,108,208,76,288,168,532,316
16685,Saint-Pierre-sur-Dropt,47271,47,60,48,32,104,40,176,108
16686,Saint-Quentin-du-Dropt,47272,47,56,40,4,40,32,76,96
16687,Saint-Robert,47273,47,45,39,5,59,44,108,84
16688,Saint-Romain-le-Noble,47274,47,24,96,52,172,80,304,120
16689,Saint-Salvy,47275,47,12,36,16,48,34,98,48
16690,Saint-Sardos,47276,47,31,71,10,91,42,143,102
16691,Saint-Sauveur-de-Meilhan,47277,47,35,85,10,115,75,200,120
16692,Saint-Sernin,47278,47,40,115,15,170,85,270,155
16693,Saint-Sixte,47279,47,70,84,40,122,70,232,154
16694,Saint-Sylvestre-sur-Lot,47280,47,501,481,165,750,322,1237,982
16695,Saint-Urcisse,47281,47,35,57,22,53,34,109,92
16696,Saint-Vincent-de-Lamontjoie,47282,47,68,52,20,72,44,136,120
16697,Saint-Vite,47283,47,200,275,115,410,180,705,475
16698,Salles,47284,47,56,56,4,108,48,160,112
16699,Samazan,47285,47,92,180,40,280,176,496,272
16700,Sauméjan,47286,47,0,16,8,32,20,60,16
16701,Saumont,47287,47,35,49,4,61,45,110,84
16702,Sauvagnas,47288,47,29,140,35,218,100,353,169
16703,La Sauvetat-de-Savères,47289,47,40,167,25,175,141,341,207
16704,La Sauvetat-du-Dropt,47290,47,125,105,30,180,75,285,230
16705,La Sauvetat-sur-Lède,47291,47,52,228,56,168,172,396,280
16706,Sauveterre-la-Lémance,47292,47,85,100,50,233,70,353,185
16707,Sauveterre-Saint-Denis,47293,47,60,136,28,160,64,252,196
16708,Savignac-de-Duras,47294,47,15,45,10,120,20,150,60
16709,Savignac-sur-Leyze,47295,47,48,56,32,109,60,201,104
16710,Ségalas,47296,47,45,20,0,65,15,80,65
16711,Sembas,47297,47,20,21,6,42,19,67,41
16712,Sénestis,47298,47,25,34,0,95,34,129,59
16713,Sérignac-Péboudou,47299,47,40,25,10,85,15,110,65
16714,Sérignac-sur-Garonne,47300,47,159,276,106,324,184,614,435
16715,Seyches,47301,47,208,196,84,348,156,588,404
16716,Sos,47302,47,135,110,30,294,65,389,245
16717,Soumensac,47303,47,45,30,10,95,35,140,75
16718,Taillebourg,47304,47,3,25,0,39,6,45,28
16719,Tayrac,47305,47,48,96,44,128,76,248,144
16720,Le Temple-sur-Lot,47306,47,190,185,85,380,140,605,375
16721,Thézac,47307,47,25,25,6,83,23,112,50
16722,Thouars-sur-Garonne,47308,47,23,32,32,73,12,117,55
16723,Tombeboeuf,47309,47,97,94,32,111,63,206,191
16724,Tonneins,47310,47,1743,1935,664,2961,1239,4864,3678
16725,Tourliac,47311,47,30,35,0,50,25,75,65
16726,Tournon-d'Agenais,47312,47,106,84,40,229,97,366,190
16727,Tourtrès,47313,47,35,35,20,35,30,85,70
16728,Trémons,47314,47,48,72,40,152,72,264,120
16729,Trentels,47315,47,102,164,70,240,157,467,266
16730,Varès,47316,47,89,156,36,228,89,353,245
16731,Verteuil-d'Agenais,47317,47,46,123,34,159,82,275,169
16732,Vianne,47318,47,181,194,42,381,151,574,375
16733,Villebramar,47319,47,20,30,0,15,40,55,50
16734,Villefranche-du-Queyran,47320,47,60,70,35,160,60,255,130
16735,Villeneuve-de-Duras,47321,47,55,65,25,110,50,185,120
16736,Villeneuve-sur-Lot,47323,47,4426,4863,2273,7474,3436,13183,9289
16737,Villeréal,47324,47,400,165,130,400,90,620,565
16738,Villeton,47325,47,71,56,36,174,61,271,127
16739,Virazeil,47326,47,275,349,74,606,345,1025,624
16740,Xaintrailles,47327,47,73,94,24,133,48,205,167
16741,Saint-Georges,47328,47,80,148,44,180,100,324,228
16742,Albaret-le-Comtal,48001,48,40,25,25,70,30,125,65
16743,Albaret-Sainte-Marie,48002,48,65,160,55,185,110,350,225
16744,Allenc,48003,48,49,44,3,55,35,93,93
16745,Altier,48004,48,50,25,10,95,20,125,75
16746,Antrenas,48005,48,45,70,15,90,50,155,115
16747,Arzenc-d'Apcher,48007,48,0,4,4,24,12,40,4
16748,Arzenc-de-Randon,48008,48,32,52,8,72,52,132,84
16749,Aumont-Aubrac,48009,48,190,195,89,287,181,557,385
16750,Auroux,48010,48,120,25,15,120,20,155,145
16751,Les Monts-Verts,48012,48,65,45,36,99,47,182,110
16752,Badaroux,48013,48,120,241,73,278,176,527,361
16753,Bagnols-les-Bains,48014,48,60,35,20,30,50,100,95
16754,Pied-de-Borne,48015,48,45,30,3,72,21,96,75
16755,Balsièges,48016,48,68,112,44,192,112,348,180
16756,Banassac-Canilhac,48017,48,100,250,115,340,230,685,350
16757,Barjac,48018,48,64,189,80,224,176,480,253
16758,Barre-des-Cévennes,48019,48,20,25,10,115,30,155,45
16759,Bassurels,48020,48,12,8,4,24,8,36,20
16760,La Bastide-Puylaurent,48021,48,25,20,21,95,5,121,45
16761,Belvezet,48023,48,10,15,10,30,15,55,25
16762,Les Bessons,48025,48,38,88,46,166,48,260,126
16763,Blavignac,48026,48,32,45,24,113,61,198,77
16764,Le Bleymard,48027,48,60,60,16,124,68,208,120
16765,Les Bondons,48028,48,25,9,12,49,12,73,34
16766,Le Born,48029,48,20,45,25,50,15,90,65
16767,Brenoux,48030,48,43,90,25,57,99,181,133
16768,Brion,48031,48,10,10,5,45,5,55,20
16769,Le Buisson,48032,48,32,84,12,80,32,124,116
16770,La Canourgue,48034,48,314,423,195,629,268,1092,737
16771,Cassagnas,48036,48,45,10,10,30,10,50,55
16772,Chadenet,48037,48,6,16,6,27,23,56,22
16773,Chambon-le-Château,48038,48,50,75,20,95,60,175,125
16774,Chanac,48039,48,150,395,115,480,300,895,545
16775,Chasseradès,48040,48,32,19,3,43,12,58,51
16776,Chastanier,48041,48,10,15,10,40,10,60,25
16777,Chastel-Nouvel,48042,48,101,219,52,249,164,465,320
16778,Châteauneuf-de-Randon,48043,48,96,95,30,118,70,218,191
16779,Chauchailles,48044,48,32,8,12,24,8,44,40
16780,Chaudeyrac,48045,48,10,40,25,144,30,199,50
16781,Chaulhac,48046,48,25,25,0,25,15,40,50
16782,La Chaze-de-Peyre,48047,48,36,72,28,125,44,197,108
16783,Cheylard-l'Évêque,48048,48,16,12,4,20,16,40,28
16784,Bédouès-Cocurès,48050,48,54,108,51,149,65,265,162
16785,Le Collet-de-Dèze,48051,48,105,144,60,330,88,478,249
16786,Cubières,48053,48,30,16,19,54,15,88,46
16787,Cubiérettes,48054,48,25,5,5,15,0,20,30
16788,Cultures,48055,48,5,50,10,70,30,110,55
16789,Esclanèdes,48056,48,25,103,25,74,93,192,128
16790,Estables,48057,48,25,30,25,50,45,120,55
16791,La Fage-Montivernoux,48058,48,40,10,15,70,15,100,50
16792,La Fage-Saint-Julien,48059,48,47,69,12,76,59,147,116
16793,Fau-de-Peyre,48060,48,25,40,20,45,60,125,65
16794,Florac Trois Rivières,48061,48,250,442,185,693,375,1253,692
16795,Fontans,48063,48,40,38,12,65,22,99,78
16796,Fournels,48064,48,50,70,15,115,66,196,120
16797,Fraissinet-de-Fourques,48065,48,9,0,0,35,3,38,9
16798,Gabriac,48067,48,25,20,0,35,20,55,45
16799,Gabrias,48068,48,26,26,3,35,26,64,52
16800,Gatuzières,48069,48,0,16,4,28,16,48,16
16801,Grandrieu,48070,48,96,100,37,290,85,412,196
16802,Grandvals,48071,48,25,0,5,30,15,50,25
16803,Grèzes,48072,48,24,48,12,56,44,112,72
16804,Les Hermaux,48073,48,21,16,3,44,6,53,37
16805,Hures-la-Parade,48074,48,16,76,4,108,56,168,92
16806,Ispagnac,48075,48,104,201,30,264,149,443,305
16807,Javols,48076,48,75,50,30,110,25,165,125
16808,Julianges,48077,48,30,0,0,25,0,25,30
16809,Lachamp,48078,48,30,40,10,45,40,95,70
16810,Lajo,48079,48,10,20,10,70,10,90,30
16811,Langogne,48080,48,440,565,270,1015,350,1635,1005
16812,Lanuéjols,48081,48,12,74,12,99,64,175,86
16813,Laubert,48082,48,5,10,15,45,15,75,15
16814,Les Laubies,48083,48,24,36,4,64,32,100,60
16815,Laval-Atger,48084,48,8,4,4,40,4,48,12
16816,Laval-du-Tarn,48085,48,32,16,4,24,20,48,48
16817,Luc,48086,48,15,36,12,59,36,107,51
16818,Malbouzon,48087,48,35,20,0,65,10,75,55
16819,La Malène,48088,48,28,28,6,43,26,75,56
16820,Le Malzieu-Forain,48089,48,64,104,40,152,100,292,168
16821,Le Malzieu-Ville,48090,48,82,109,36,309,114,459,191
16822,Marchastel,48091,48,0,10,10,20,10,40,10
16823,Marvejols,48092,48,745,899,472,1497,774,2743,1644
16824,Mas-d'Orcières,48093,48,20,0,15,45,15,75,20
16825,Le Massegros,48094,48,56,92,28,104,76,208,148
16826,Mende,48095,48,1326,2535,1591,3454,2016,7061,3861
16827,Meyrueis,48096,48,87,158,38,265,119,422,245
16828,Moissac-Vallée-Française,48097,48,44,36,16,92,32,140,80
16829,Molezon,48098,48,12,8,4,30,13,47,20
16830,Bourgs sur Colagne,48099,48,283,456,129,602,404,1135,739
16831,Montbel,48100,48,15,15,15,47,10,72,30
16832,Montbrun,48101,48,45,10,0,40,5,45,55
16833,Montrodat,48103,48,150,270,50,350,210,610,420
16834,Nasbinals,48104,48,75,110,75,159,70,304,185
16835,Naussac-Fontanes,48105,48,25,105,45,105,75,225,130
16836,Noalhac,48106,48,20,15,10,35,10,55,35
16837,Palhers,48107,48,3,32,27,31,37,95,35
16838,La Panouse,48108,48,15,3,12,30,3,45,18
16839,Paulhac-en-Margeride,48110,48,18,20,0,34,15,49,38
16840,Pelouse,48111,48,20,56,16,55,42,113,76
16841,Pierrefiche,48112,48,37,10,6,40,7,53,47
16842,Le Pompidou,48115,48,15,5,30,85,15,130,20
16843,Pont de Montvert - Sud Mont Lozère,48116,48,92,98,62,253,51,366,190
16844,Pourcharesses,48117,48,17,16,4,28,24,56,33
16845,Prévenchères,48119,48,45,60,25,60,40,125,105
16846,Prinsuéjols,48120,48,33,16,8,51,32,91,49
16847,Prunières,48121,48,30,80,0,105,50,155,110
16848,Quézac,48122,48,40,90,20,119,75,214,130
16849,Recoules-d'Aubrac,48123,48,20,10,15,105,15,135,30
16850,Recoules-de-Fumas,48124,48,29,8,0,36,8,44,37
16851,Le Recoux,48125,48,21,34,12,22,19,53,55
16852,Ribennes,48126,48,28,36,8,56,28,92,64
16853,Rieutort-de-Randon,48127,48,136,182,80,152,172,404,318
16854,Rimeize,48128,48,48,108,50,210,86,346,156
16855,Rocles,48129,48,24,68,12,80,48,140,92
16856,Rousses,48130,48,28,8,16,36,8,60,36
16857,Le Rozier,48131,48,38,13,3,44,22,69,51
16858,Saint-Alban-sur-Limagnole,48132,48,234,225,60,581,120,761,459
16859,Saint-Amans,48133,48,15,45,5,55,40,100,60
16860,Saint-André-Capcèze,48135,48,4,26,12,79,29,120,30
16861,Saint-André-de-Lancize,48136,48,25,20,15,50,15,80,45
16862,Saint-Bauzile,48137,48,75,152,50,271,91,412,227
16863,Saint-Bonnet-de-Chirac,48138,48,8,4,4,20,20,44,12
16864,Saint-Bonnet-de-Montauroux,48139,48,12,22,3,31,18,52,34
16865,Saint-Chély-d'Apcher,48140,48,680,738,499,1172,630,2301,1418
16866,Mas-Saint-Chély,48141,48,30,40,4,58,15,77,70
16867,Sainte-Colombe-de-Peyre,48142,48,25,40,0,80,40,120,65
16868,Sainte-Croix-Vallée-Française,48144,48,25,31,25,146,47,218,56
16869,Saint-Denis-en-Margeride,48145,48,70,30,0,40,25,65,100
16870,Sainte-Enimie,48146,48,82,70,25,213,73,311,152
16871,Saint-Étienne-du-Valdonnez,48147,48,65,185,65,170,165,400,250
16872,Saint-Étienne-Vallée-Française,48148,48,115,65,75,205,35,315,180
16873,Sainte-Eulalie,48149,48,20,10,0,10,5,15,30
16874,Saint-Flour-de-Mercoire,48150,48,4,67,4,45,52,101,71
16875,Saint-Frézal-d'Albuges,48151,48,20,12,0,4,18,22,32
16876,Ventalon en Cévennes,48152,48,21,41,25,74,37,136,62
16877,Saint-Gal,48153,48,4,28,8,28,28,64,32
16878,Saint-Georges-de-Lévéjac,48154,48,21,62,30,68,53,151,83
16879,Saint-Germain-de-Calberte,48155,48,100,70,42,183,65,290,170
16880,Saint-Germain-du-Teil,48156,48,127,151,91,196,90,377,278
16881,Sainte-Hélène,48157,48,0,32,0,28,24,52,32
16882,Saint-Hilaire-de-Lavit,48158,48,6,20,10,44,9,63,26
16883,Saint-Jean-la-Fouillouse,48160,48,30,30,10,65,30,105,60
16884,Saint-Juéry,48161,48,8,8,4,20,12,36,16
16885,Saint-Julien-des-Points,48163,48,35,4,4,28,12,44,39
16886,Saint-Julien-du-Tournel,48164,48,10,30,10,55,25,90,40
16887,Saint-Laurent-de-Muret,48165,48,32,56,8,56,56,120,88
16888,Cans et Cévennes,48166,48,24,74,24,94,34,152,98
16889,Saint-Laurent-de-Veyrès,48167,48,10,6,0,24,6,30,16
16890,Saint-Léger-de-Peyre,48168,48,12,25,16,52,28,96,37
16891,Saint-Léger-du-Malzieu,48169,48,42,45,0,60,37,97,87
16892,Saint-Martin-de-Boubaux,48170,48,20,29,19,68,20,107,49
16893,Saint-Martin-de-Lansuscle,48171,48,35,35,10,70,45,125,70
16894,Saint-Michel-de-Dèze,48173,48,50,40,5,100,35,140,90
16895,Saint-Paul-le-Froid,48174,48,16,15,6,58,12,76,31
16896,Saint-Pierre-de-Nogaret,48175,48,17,30,4,80,25,109,47
16897,Saint-Pierre-des-Tripiers,48176,48,6,18,6,27,9,42,24
16898,Saint-Pierre-le-Vieux,48177,48,40,76,24,108,56,188,116
16899,Saint-Privat-de-Vallongue,48178,48,39,38,3,96,35,134,77
16900,Saint-Privat-du-Fau,48179,48,44,24,0,48,12,60,68
16901,Saint-Rome-de-Dolan,48180,48,9,13,3,32,0,35,22
16902,Saint-Saturnin,48181,48,5,10,0,25,20,45,15
16903,Saint-Sauveur-de-Ginestoux,48182,48,8,4,4,24,0,28,12
16904,Saint-Sauveur-de-Peyre,48183,48,32,88,40,92,44,176,120
16905,Saint-Symphorien,48184,48,30,40,20,95,45,160,70
16906,Les Salelles,48185,48,9,33,12,36,51,99,42
16907,Les Salces,48187,48,4,20,16,36,20,72,24
16908,Serverette,48188,48,40,30,21,100,15,136,70
16909,Servières,48189,48,25,45,10,70,25,105,70
16910,Termes,48190,48,36,40,36,60,36,132,76
16911,La Tieule,48191,48,8,32,0,28,20,48,40
16912,Trélans,48192,48,15,7,10,41,3,54,22
16913,Vebron,48193,48,30,30,0,98,30,128,60
16914,Vialas,48194,48,90,65,10,135,75,220,155
16915,Les Vignes,48195,48,15,10,10,55,15,80,25
16916,La Villedieu,48197,48,6,6,0,9,6,15,12
16917,Villefort,48198,48,93,76,61,219,70,350,169
16918,Les Alleuds,49001,49,55,294,72,194,189,455,349
16919,Allonnes,49002,49,422,807,165,878,563,1606,1229
16920,Tuffalun,49003,49,234,495,144,495,375,1014,729
16921,Angers,49007,49,16497,35695,30577,36833,24645,92055,52192
16922,Angrie,49008,49,115,305,60,270,175,505,420
16923,Antoigné,49009,49,25,104,75,123,82,280,129
16924,Armaillé,49010,49,20,85,30,124,50,204,105
16925,Artannes-sur-Thouet,49011,49,20,83,31,170,65,266,103
16926,Aubigné-sur-Layon,49012,49,35,115,35,130,60,225,150
16927,Auverse,49013,49,65,120,60,145,65,270,185
16928,Aviré,49014,49,20,131,25,125,128,278,151
16929,Avrillé,49015,49,2259,2869,1328,4599,1938,7865,5128
16930,Baracé,49017,49,53,178,80,94,125,299,231
16931,Baugé-en-Anjou,49018,49,1636,2991,969,3606,2227,6802,4627
16932,Beaucouzé,49020,49,470,1193,448,2017,754,3219,1663
16933,Beaufort-en-Anjou,49021,49,771,2033,662,1850,1411,3923,2804
16934,Beaulieu-sur-Layon,49022,49,188,428,120,360,316,796,616
16935,Beaupréau-en-Mauges,49023,49,2487,6092,2268,6536,4577,13381,8579
16936,Bécon-les-Granits,49026,49,195,790,400,660,670,1730,985
16937,Bégrolles-en-Mauges,49027,49,164,600,200,512,468,1180,764
16938,Béhuard,49028,49,9,23,6,24,25,55,32
16939,Blaison-Saint-Sulpice,49029,49,155,294,58,462,165,685,449
16940,Blou,49030,49,70,315,90,285,235,610,385
16941,Bouchemaine,49035,49,732,1477,534,2551,985,4070,2209
16942,Bouillé-Ménard,49036,49,100,220,92,196,132,420,320
16943,Le Bourg-d'Iré,49037,49,80,295,100,215,210,525,375
16944,Bourg-l'Évêque,49038,49,12,52,33,92,24,149,64
16945,Brain-sur-Allonnes,49041,49,260,525,194,600,410,1204,785
16946,Breil,49044,49,40,40,20,121,40,181,80
16947,La Breille-les-Pins,49045,49,52,160,60,192,96,348,212
16948,Brézé,49046,49,116,352,140,444,224,808,468
16949,Brigné,49047,49,34,121,55,106,100,261,155
16950,Briollay,49048,49,276,722,200,1004,588,1792,998
16951,Brissac-Quincé,49050,49,319,812,298,827,655,1780,1131
16952,Brissarthe,49051,49,56,152,72,220,120,412,208
16953,Broc,49052,49,40,54,6,79,74,159,94
16954,Brossay,49053,49,45,110,15,89,120,224,155
16955,Candé,49054,49,523,695,200,871,437,1508,1218
16956,Cantenay-Épinard,49055,49,163,526,140,744,356,1240,689
16957,Carbay,49056,49,34,59,31,82,21,134,93
16958,Cernusson,49057,49,5,110,25,100,95,220,115
16959,Les Cerqueux,49058,49,108,315,68,181,212,461,423
16960,Chacé,49060,49,135,364,155,548,198,901,499
16961,Challain-la-Potherie,49061,49,116,224,64,260,164,488,340
16962,Chalonnes-sous-le-Lude,49062,49,5,35,15,40,25,80,40
16963,Chalonnes-sur-Loire,49063,49,854,1699,550,1940,1299,3789,2553
16964,Chambellay,49064,49,32,99,8,113,65,186,131
16965,Champigné,49065,49,192,566,208,558,443,1209,758
16966,Chenillé-Champteussé,49067,49,33,98,20,86,58,164,131
16967,Champtocé-sur-Loire,49068,49,244,501,176,440,424,1040,745
16968,Orée d'Anjou,49069,49,1486,4370,1604,4586,3670,9860,5856
16969,Chanteloup-les-Bois,49070,49,124,164,40,248,120,408,288
16970,La Chapelle-Hullin,49073,49,3,37,6,58,15,79,40
16971,La Chapelle-Saint-Laud,49076,49,25,229,64,206,159,429,254
16972,La Chapelle-sur-Oudon,49077,49,68,165,40,160,124,324,233
16973,Charcé-Saint-Ellier-sur-Aubance,49078,49,52,199,42,305,105,452,251
16974,Châteauneuf-sur-Sarthe,49080,49,425,959,229,799,644,1672,1384
16975,Châtelais,49081,49,104,188,56,172,140,368,292
16976,Chaudefonds-sur-Layon,49082,49,84,268,84,332,196,612,352
16977,Chavagnes,49086,49,73,395,97,314,335,746,468
16978,Chavaignes,49087,49,20,25,10,35,15,60,45
16979,Chazé-Henry,49088,49,107,231,30,333,142,505,338
16980,Chazé-sur-Argos,49089,49,88,340,92,296,240,628,428
16981,Cheffes,49090,49,61,273,105,339,139,583,334
16982,Chemellier,49091,49,59,225,130,208,180,518,284
16983,Chemillé-en-Anjou,49092,49,2357,5947,1991,5939,4289,12219,8304
16984,Cherré,49096,49,28,178,40,127,133,300,206
16985,Chigné,49098,49,35,75,35,95,60,190,110
16986,Cholet,49099,49,7359,12919,6105,16655,9417,32177,20278
16987,Cizay-la-Madeleine,49100,49,70,125,40,180,70,290,195
16988,Cléré-sur-Layon,49102,49,54,45,26,113,42,181,99
16989,Combrée,49103,49,485,725,256,836,440,1532,1210
16990,Concourson-sur-Layon,49104,49,64,136,28,148,130,306,200
16991,Contigné,49105,49,92,220,48,228,168,444,312
16992,Cornillé-les-Caves,49107,49,36,124,4,192,80,276,160
16993,La Cornuaille,49108,49,130,303,50,350,185,585,433
16994,Coron,49109,49,188,448,124,404,308,836,636
16995,Corzé,49110,49,207,513,136,524,328,988,720
16996,Le Coudray-Macouard,49112,49,130,196,58,283,162,503,326
16997,Courchamps,49113,49,80,124,28,132,108,268,204
16998,Courléon,49114,49,20,30,5,75,15,95,50
16999,Coutures,49115,49,50,140,55,160,120,335,190
17000,Daumeray,49119,49,164,428,168,424,320,912,592
17001,Denée,49120,49,119,367,94,496,267,857,486
17002,Dénezé-sous-Doué,49121,49,90,135,25,125,95,245,225
17003,Dénezé-sous-le-Lude,49122,49,44,73,12,77,50,139,117
17004,Distré,49123,49,149,455,145,559,357,1061,604
17005,Doué-la-Fontaine,49125,49,1193,1587,707,2508,1178,4393,2780
17006,Durtal,49127,49,525,900,225,1010,650,1885,1425
17007,Écouflant,49129,49,599,895,271,1364,588,2223,1494
17008,Écuillé,49130,49,18,180,47,178,127,352,198
17009,Épieds,49131,49,45,220,51,212,164,427,265
17010,Étriché,49132,49,124,484,168,388,364,920,608
17011,Feneu,49135,49,204,658,172,674,431,1277,862
17012,La Ferrière-de-Flée,49136,49,27,100,42,73,75,190,127
17013,Les Bois d'Anjou,49138,49,222,799,196,698,593,1487,1021
17014,Fontevraud-l'Abbaye,49140,49,114,286,126,358,164,648,400
17015,Forges,49141,49,15,95,30,50,105,185,110
17016,Freigné,49144,49,120,336,120,356,196,672,456
17017,Gennes-Val de Loire,49149,49,688,1346,300,1610,975,2885,2034
17018,Genneteil,49150,49,65,55,12,98,48,158,120
17019,Grez-Neuville,49155,49,95,425,146,437,255,838,520
17020,Grugé-l'Hôpital,49156,49,20,80,40,100,45,185,100
17021,L'Hôtellerie-de-Flée,49158,49,16,172,68,164,104,336,188
17022,Huillé,49159,49,48,180,48,144,112,304,228
17023,Ingrandes-Le Fresne sur Loire,49160,49,309,627,310,748,448,1506,936
17024,La Jaille-Yvon,49161,49,32,75,17,90,48,155,107
17025,Jarzé Villages,49163,49,266,728,276,778,616,1670,994
17026,Juigné-sur-Loire,49167,49,335,636,100,1038,405,1543,971
17027,Juvardeil,49170,49,88,185,55,277,149,481,273
17028,La Lande-Chasles,49171,49,12,31,0,54,12,66,43
17029,Lasse,49173,49,30,95,35,100,35,170,125
17030,Lézigné,49174,49,92,208,100,224,140,464,300
17031,Linières-Bouton,49175,49,16,20,4,12,12,28,36
17032,Le Lion-d'Angers,49176,49,513,1317,548,1146,964,2658,1830
17033,Loiré,49178,49,105,235,95,245,180,520,340
17034,Longué-Jumelles,49180,49,990,1660,560,2410,1105,4075,2650
17035,Louresse-Rochemenier,49182,49,76,228,124,220,164,508,304
17036,Le Louroux-Béconnais,49183,49,294,971,239,676,753,1668,1265
17037,Louvaines,49184,49,33,149,24,170,90,284,182
17038,Luigné,49186,49,15,80,20,90,60,170,95
17039,Marans,49187,49,16,163,55,140,117,312,179
17040,Marcé,49188,49,64,264,40,260,220,520,328
17041,Marigné,49189,49,64,208,72,208,128,408,272
17042,Martigné-Briand,49191,49,236,433,185,529,289,1003,669
17043,Maulévrier,49192,49,325,859,299,988,645,1932,1184
17044,Le May-sur-Èvre,49193,49,548,1070,300,1161,761,2222,1618
17045,Mazé-Milon,49194,49,553,1646,358,1633,1279,3270,2199
17046,Mazières-en-Mauges,49195,49,92,284,92,396,180,668,376
17047,Meigné-le-Vicomte,49197,49,33,83,51,68,48,167,116
17048,Meigné,49198,49,35,90,5,100,70,175,125
17049,Longuenée-en-Anjou,49200,49,414,1921,589,1925,1375,3889,2335
17050,La Ménitré,49201,49,260,512,212,680,392,1284,772
17051,Méon,49202,49,48,59,15,52,45,112,107
17052,Miré,49205,49,91,263,70,315,187,572,354
17053,Montfort,49207,49,35,5,0,41,15,56,40
17054,Montguillon,49208,49,24,72,8,80,44,132,96
17055,Montigné-lès-Rairies,49209,49,28,114,60,108,80,248,142
17056,Montilliers,49211,49,93,284,98,397,211,706,377
17057,Montreuil-Juigné,49214,49,755,2007,529,2671,1314,4514,2762
17058,Montreuil-Bellay,49215,49,591,903,404,1156,681,2241,1494
17059,Montreuil-sur-Loir,49216,49,31,150,29,162,140,331,181
17060,Montreuil-sur-Maine,49217,49,52,227,69,154,200,423,279
17061,Montrevault-sur-Èvre,49218,49,1759,4431,1327,5111,3117,9555,6190
17062,Montsoreau,49219,49,95,80,15,195,50,260,175
17063,Morannes-sur-Sarthe,49220,49,413,494,113,596,329,1038,907
17064,Mouliherne,49221,49,194,190,50,290,140,480,384
17065,Mozé-sur-Louet,49222,49,180,545,200,635,470,1305,725
17066,Mûrs-Erigné,49223,49,636,1119,642,1798,898,3338,1755
17067,Neuillé,49224,49,74,265,77,319,193,589,339
17068,Noëllet,49226,49,90,90,20,140,85,245,180
17069,Notre-Dame-d'Allençon,49227,49,29,210,92,184,141,417,239
17070,Noyant,49228,49,349,411,125,575,272,972,760
17071,Noyant-la-Gravoyère,49229,49,270,450,155,594,344,1093,720
17072,Nuaillé,49231,49,84,439,131,558,284,973,523
17073,Nyoiseau,49233,49,142,288,91,384,229,704,430
17074,Parçay-les-Pins,49234,49,184,183,60,361,82,503,367
17075,Parnay,49235,49,93,109,20,117,112,249,202
17076,Passavant-sur-Layon,49236,49,40,20,0,40,20,60,60
17077,La Pellerine,49237,49,23,24,6,55,19,80,47
17078,La Plaine,49240,49,104,312,92,312,200,604,416
17079,Le Plessis-Grammoire,49241,49,240,630,165,885,400,1450,870
17080,Mauges-sur-Loire,49244,49,2168,5077,1658,5220,3599,10477,7245
17081,Les Ponts-de-Cé,49246,49,1712,3053,1166,4024,1989,7179,4765
17082,La Possonnière,49247,49,284,574,212,787,429,1428,858
17083,Pouancé,49248,49,456,629,250,939,495,1684,1085
17084,La Prévière,49250,49,30,65,15,95,50,160,95
17085,Le Puy-Notre-Dame,49253,49,175,305,105,350,245,700,480
17086,Querré,49254,49,35,110,20,100,50,170,145
17087,Les Rairies,49257,49,99,204,70,339,198,607,303
17088,Rochefort-sur-Loire,49259,49,205,632,147,684,493,1324,837
17089,La Romagne,49260,49,130,460,195,670,355,1220,590
17090,Les Rosiers-sur-Loire,49261,49,390,585,175,705,435,1315,975
17091,Rou-Marson,49262,49,65,160,20,270,150,440,225
17092,Saint-Augustin-des-Bois,49266,49,52,417,136,341,266,743,469
17093,Saint-Barthélemy-d'Anjou,49267,49,1109,2107,955,3381,1410,5746,3216
17094,Saint-Christophe-du-Bois,49269,49,179,678,243,905,525,1673,857
17095,Saint-Clément-de-la-Place,49271,49,92,675,212,617,514,1343,767
17096,Saint-Clément-des-Levées,49272,49,185,225,75,420,170,665,410
17097,Saint-Cyr-en-Bourg,49274,49,155,200,80,345,130,555,355
17098,Sainte-Gemmes-d'Andigné,49277,49,171,341,133,532,138,803,512
17099,Sainte-Gemmes-sur-Loire,49278,49,497,702,342,1292,452,2086,1199
17100,Saint-Georges-sur-Layon,49282,49,60,250,55,250,155,460,310
17101,Saint-Georges-sur-Loire,49283,49,334,899,336,1029,687,2052,1233
17102,Saint-Germain-des-Prés,49284,49,138,384,122,329,337,788,522
17103,Saint-Jean-de-la-Croix,49288,49,9,45,36,74,28,138,54
17104,Saint-Jean-de-Linières,49289,49,105,495,96,641,344,1081,600
17105,Saint-Jean-des-Mauvrets,49290,49,132,464,112,648,384,1144,596
17106,Saint-Just-sur-Dive,49291,49,40,105,50,120,88,258,145
17107,Val-du-Layon,49292,49,194,986,320,962,744,2026,1180
17108,Saint-Lambert-la-Potherie,49294,49,130,737,182,900,516,1598,867
17109,Saint-Léger-des-Bois,49298,49,83,529,130,495,423,1048,612
17110,Saint-Léger-sous-Cholet,49299,49,168,733,228,984,478,1690,901
17111,Sèvremoine,49301,49,2409,7181,2494,7009,5572,15075,9590
17112,Saint-Macaire-du-Bois,49302,49,68,132,52,128,72,252,200
17113,Saint-Martin-de-la-Place,49304,49,120,359,103,375,220,698,479
17114,Saint-Martin-du-Bois,49305,49,91,278,104,214,161,479,369
17115,Saint-Martin-du-Fouilloux,49306,49,92,445,92,632,368,1092,537
17116,Loire-Authion,49307,49,1684,4273,1088,5219,2999,9306,5957
17117,Saint-Melaine-sur-Aubance,49308,49,150,557,130,798,322,1250,707
17118,Saint-Michel-et-Chanveaux,49309,49,40,90,65,135,65,265,130
17119,Saint-Paul-du-Bois,49310,49,75,135,50,245,80,375,210
17120,Saint-Philbert-du-Peuple,49311,49,112,352,96,472,232,800,464
17121,Saint-Rémy-la-Varenne,49317,49,119,240,48,316,174,538,359
17122,Saint-Saturnin-sur-Loire,49318,49,88,380,60,484,230,774,468
17123,Saint-Sauveur-de-Flée,49319,49,24,106,28,76,68,172,130
17124,Saint-Sigismond,49321,49,25,66,37,97,69,203,91
17125,Verrières-en-Anjou,49323,49,730,1812,733,2432,1057,4222,2542
17126,Sarrigné,49326,49,49,224,44,250,167,461,273
17127,Saulgé-l'Hôpital,49327,49,40,192,52,160,142,354,232
17128,Saumur,49328,49,4656,5829,3153,8353,4119,15625,10485
17129,Savennières,49329,49,110,400,75,485,225,785,510
17130,Sceaux-d'Anjou,49330,49,44,395,114,241,315,670,439
17131,Segré,49331,49,1007,1600,572,2160,1240,3972,2607
17132,La Séguinière,49332,49,407,1037,375,1389,692,2456,1444
17133,Seiches-sur-le-Loir,49333,49,318,817,272,891,526,1689,1135
17134,Sermaise,49334,49,8,104,36,60,92,188,112
17135,Soeurdres,49335,49,28,136,24,100,108,232,164
17136,Somloire,49336,49,125,232,52,223,168,443,357
17137,Soucelles,49337,49,230,808,165,848,507,1520,1038
17138,Soulaines-sur-Aubance,49338,49,88,387,92,383,303,778,475
17139,Soulaire-et-Bourg,49339,49,72,470,64,480,284,828,542
17140,Souzay-Champigny,49341,49,50,196,60,282,160,502,246
17141,La Tessoualle,49343,49,312,808,227,1024,620,1871,1120
17142,Thorigné-d'Anjou,49344,49,52,400,120,296,308,724,452
17143,Bellevigne-en-Layon,49345,49,675,1623,419,1685,1278,3382,2298
17144,Tiercé,49347,49,603,1112,384,1418,706,2508,1715
17145,Toutlemonde,49352,49,78,365,101,453,235,789,443
17146,Trélazé,49353,49,1372,3887,1410,3863,2789,8062,5259
17147,Le Tremblay,49354,49,25,77,45,72,90,207,102
17148,Trémentines,49355,49,346,783,235,802,579,1616,1129
17149,Turquant,49358,49,84,139,39,109,136,284,223
17150,Les Ulmes,49359,49,58,161,35,145,136,316,219
17151,Varennes-sur-Loire,49361,49,322,454,85,631,306,1022,776
17152,Varrains,49362,49,180,280,80,510,190,780,460
17153,Vauchrétien,49363,49,130,444,105,498,309,912,574
17154,Vaudelnay,49364,49,118,314,95,350,254,699,432
17155,Les Verchers-sur-Layon,49365,49,125,190,75,325,135,535,315
17156,Vergonnes,49366,49,56,76,24,108,52,184,132
17157,Erdre-en-Anjou,49367,49,416,1905,585,1354,1359,3298,2321
17158,Vernantes,49368,49,342,435,168,472,309,949,777
17159,Vernoil-le-Fourrier,49369,49,196,292,92,460,208,760,488
17160,Verrie,49370,49,20,101,21,210,61,292,121
17161,Vezins,49371,49,150,466,165,560,320,1045,616
17162,Lys-Haut-Layon,49373,49,1117,1989,647,2491,1341,4479,3106
17163,Villebernier,49374,49,195,410,125,455,250,830,605
17164,Villemoisan,49376,49,64,198,46,105,170,321,262
17165,Villevêque,49377,49,319,776,203,922,548,1673,1095
17166,Vivy,49378,49,298,725,335,699,460,1494,1023
17167,Yzernay,49381,49,204,520,155,525,438,1118,724
17168,Acqueville,50001,50,28,192,76,252,108,436,220
17169,Agneaux,50002,50,785,745,370,1570,460,2400,1530
17170,Agon-Coutainville,50003,50,735,370,100,1185,355,1640,1105
17171,Airel,50004,50,75,125,62,151,72,285,200
17172,Amigny,50006,50,0,35,10,50,40,100,35
17173,Ancteville,50007,50,60,65,10,75,40,125,125
17174,Anctoville-sur-Boscq,50008,50,35,140,40,185,80,305,175
17175,Anneville-en-Saire,50013,50,104,78,32,116,58,206,182
17176,Anneville-sur-Mer,50014,50,85,20,20,85,35,140,105
17177,Annoville,50015,50,107,132,20,217,97,334,239
17178,Appeville,50016,50,24,16,6,85,15,106,40
17179,Argouges,50018,50,64,132,40,180,112,332,196
17180,Aucey-la-Plaine,50019,50,36,96,60,148,96,304,132
17181,Auderville,50020,50,50,65,25,75,30,130,115
17182,Audouville-la-Hubert,50021,50,15,10,10,30,10,50,25
17183,Aumeville-Lestre,50022,50,10,22,6,49,15,70,32
17184,Auvers,50023,50,82,161,69,187,90,346,243
17185,Auxais,50024,50,21,45,21,52,12,85,66
17186,Avranches,50025,50,1358,1378,941,2315,1087,4343,2736
17187,Azeville,50026,50,12,20,4,20,24,48,32
17188,Bacilly,50027,50,152,223,60,248,210,518,375
17189,La Baleine,50028,50,0,25,10,50,25,85,25
17190,Barenton,50029,50,280,204,100,380,140,620,484
17191,Barfleur,50030,50,142,75,30,211,50,291,217
17192,Barneville-Carteret,50031,50,432,365,154,837,319,1310,797
17193,La Barre-de-Semilly,50032,50,75,260,50,410,190,650,335
17194,Baubigny,50033,50,25,20,10,80,10,100,45
17195,Baudre,50034,50,40,156,44,200,96,340,196
17196,Baupte,50036,50,90,105,65,110,70,245,195
17197,La Bazoge,50037,50,30,35,0,35,30,65,65
17198,Beauchamps,50038,50,71,91,28,104,52,184,162
17199,Beaucoudray,50039,50,20,10,5,45,45,95,30
17200,Beauficel,50040,50,28,28,16,60,24,100,56
17201,Beaumont-Hague,50041,50,125,355,205,475,230,910,480
17202,Beauvoir,50042,50,89,84,33,145,60,238,173
17203,Bellefontaine,50043,50,20,30,0,55,20,75,50
17204,Belval,50044,50,29,79,37,89,49,175,108
17205,Benoîtville,50045,50,20,185,55,230,115,400,205
17206,Bérigny,50046,50,42,82,35,119,82,236,124
17207,Beslon,50048,50,65,130,70,195,90,355,195
17208,Besneville,50049,50,95,160,85,220,120,425,255
17209,Beuvrigny,50050,50,0,28,8,39,54,101,28
17210,Beuzeville-la-Bastille,50052,50,15,36,0,55,45,100,51
17211,Biéville,50054,50,8,52,20,56,56,132,60
17212,Biniville,50055,50,8,24,20,36,20,76,32
17213,Biville,50057,50,35,150,30,190,120,340,185
17214,Blainville-sur-Mer,50058,50,315,323,112,553,231,896,638
17215,Blosville,50059,50,32,80,40,88,68,196,112
17216,La Bloutière,50060,50,60,80,16,168,84,268,140
17217,Boisyvon,50062,50,20,21,0,26,17,43,41
17218,La Bonneville,50064,50,12,72,20,56,52,128,84
17219,Jullouville,50066,50,530,430,125,881,295,1301,960
17220,Bourguenolles,50069,50,45,80,25,145,55,225,125
17221,Boutteville,50070,50,12,8,0,24,8,32,20
17222,Brainville,50072,50,24,88,8,60,56,124,112
17223,Branville-Hague,50073,50,9,67,3,38,30,71,76
17224,Brécey,50074,50,513,375,137,700,273,1110,888
17225,Bréhal,50076,50,655,606,220,1213,377,1810,1261
17226,Bretteville,50077,50,115,263,65,489,153,707,378
17227,Bretteville-sur-Ay,50078,50,50,60,15,215,55,285,110
17228,Breuville,50079,50,53,103,20,119,77,216,156
17229,Brévands,50080,50,38,62,17,112,47,176,100
17230,Bréville-sur-Mer,50081,50,75,155,35,355,150,540,230
17231,Bricquebec-en-Cotentin,50082,50,940,1456,484,1903,1113,3500,2396
17232,Bricquebosq,50083,50,16,155,40,181,170,391,171
17233,Bricqueville-la-Blouette,50084,50,92,132,24,208,108,340,224
17234,Bricqueville-sur-Mer,50085,50,156,252,104,444,228,776,408
17235,Brillevast,50086,50,45,65,20,130,65,215,110
17236,Brix,50087,50,216,512,117,827,383,1327,728
17237,Brouains,50088,50,35,20,15,80,5,100,55
17238,Brucheville,50089,50,20,35,10,80,25,115,55
17239,Buais-Les-Monts,50090,50,122,102,24,223,98,345,224
17240,Cambernon,50092,50,60,172,72,284,108,464,232
17241,Cametours,50093,50,65,110,45,125,80,250,175
17242,Camprond,50094,50,60,117,60,116,76,252,177
17243,Canisy,50095,50,138,268,80,277,177,534,406
17244,Canteloup,50096,50,24,48,12,100,32,144,72
17245,Canville-la-Rocque,50097,50,30,45,0,50,25,75,75
17246,Carantilly,50098,50,76,193,72,176,152,400,269
17247,Carentan les Marais,50099,50,1221,1434,709,1917,1024,3650,2655
17248,Carnet,50100,50,60,108,68,168,72,308,168
17249,Carneville,50101,50,30,55,10,100,25,135,85
17250,Carolles,50102,50,206,95,40,371,45,456,301
17251,Carquebut,50103,50,40,72,20,88,60,168,112
17252,Catteville,50105,50,4,32,8,44,20,72,36
17253,Cavigny,50106,50,24,49,34,77,26,137,73
17254,Catz,50107,50,12,36,16,36,32,84,48
17255,Céaux,50108,50,48,104,24,144,108,276,152
17256,Cérences,50109,50,368,440,148,596,272,1016,808
17257,Cerisy-la-Forêt,50110,50,144,220,84,284,148,516,364
17258,Cerisy-la-Salle,50111,50,224,265,105,300,160,565,489
17259,La Chaise-Baudouin,50112,50,96,132,32,124,116,272,228
17260,Le Grippon,50115,50,37,110,49,110,60,219,147
17261,Champeaux,50117,50,118,60,25,132,30,187,178
17262,Champrepus,50118,50,34,73,47,68,61,176,107
17263,Les Champs-de-Losque,50119,50,37,33,12,48,24,84,70
17264,Chanteloup,50120,50,30,105,25,125,75,225,135
17265,La Chapelle-Cécelin,50121,50,36,48,32,72,40,144,84
17266,La Chapelle-Urée,50124,50,28,16,16,60,8,84,44
17267,Chasseguey,50125,50,25,38,4,12,16,32,63
17268,Chavoy,50126,50,6,41,3,27,34,64,47
17269,Cherbourg-en-Cotentin,50129,50,9696,19005,9832,26192,14033,50057,28701
17270,Chérencé-le-Héron,50130,50,80,64,60,132,52,244,144
17271,Chérencé-le-Roussel,50131,50,65,70,20,110,55,185,135
17272,Clitourps,50135,50,35,70,5,45,55,105,105
17273,La Colombe,50137,50,92,144,32,196,140,368,236
17274,Colomby,50138,50,44,128,76,140,116,332,172
17275,Condé-sur-Vire,50139,50,520,902,360,1190,748,2298,1422
17276,Contrières,50140,50,12,108,68,108,72,248,120
17277,Vicq-sur-Mer,50142,50,156,204,80,370,159,609,360
17278,Coudeville-sur-Mer,50143,50,100,220,40,305,195,540,320
17279,Coulouvray-Boisbenâtre,50144,50,77,79,56,180,80,316,156
17280,Courcy,50145,50,60,171,61,192,124,377,231
17281,Courtils,50146,50,36,40,12,88,44,144,76
17282,Coutances,50147,50,1313,1792,800,2531,1298,4629,3105
17283,Couvains,50148,50,40,115,65,120,115,300,155
17284,Couville,50149,50,68,291,56,409,222,687,359
17285,Crasville,50150,50,36,76,24,88,44,156,112
17286,Créances,50151,50,313,528,159,768,350,1277,841
17287,Les Cresnays,50152,50,30,55,20,110,35,165,85
17288,La Croix-Avranchin,50154,50,70,130,50,120,90,260,200
17289,Crollon,50155,50,27,89,44,59,46,149,116
17290,Crosville-sur-Douve,50156,50,4,4,9,24,0,33,8
17291,Cuves,50158,50,51,50,6,115,29,150,101
17292,Dangy,50159,50,56,139,59,189,93,341,195
17293,Denneville,50160,50,136,100,32,228,80,340,236
17294,Le Dézert,50161,50,100,136,52,102,90,244,236
17295,Digosville,50162,50,65,370,135,690,305,1130,435
17296,Digulleville,50163,50,55,60,10,95,65,170,115
17297,Domjean,50164,50,120,285,68,372,228,668,405
17298,Donville-les-Bains,50165,50,661,480,310,1362,350,2022,1141
17299,Doville,50166,50,35,80,50,90,60,200,115
17300,Dragey-Ronthon,50167,50,99,186,57,244,173,474,285
17301,Ducey-Les Chéris,50168,50,510,589,214,778,527,1519,1099
17302,Écausseville,50169,50,15,35,0,30,20,50,50
17303,Éculleville,50171,50,0,10,10,10,15,35,10
17304,Émondeville,50172,50,50,110,5,120,80,205,160
17305,Équilly,50174,50,16,52,0,72,40,112,68
17306,Éroudeville,50175,50,39,65,5,80,45,130,104
17307,L'Étang-Bertrand,50176,50,30,95,15,145,55,215,125
17308,Étienville,50177,50,61,45,27,134,60,221,106
17309,Fermanville,50178,50,245,235,45,610,178,833,480
17310,Feugères,50181,50,30,115,35,125,50,210,145
17311,La Feuillie,50182,50,60,50,35,85,40,160,110
17312,Fierville-les-Mines,50183,50,64,58,17,92,43,152,122
17313,Flamanville,50184,50,255,385,202,483,272,957,640
17314,Fleury,50185,50,129,293,105,264,227,596,422
17315,Flottemanville,50186,50,10,50,45,20,55,120,60
17316,Flottemanville-Hague,50187,50,48,276,84,256,232,572,324
17317,Folligny,50188,50,96,320,100,320,236,656,416
17318,Fontenay-sur-Mer,50190,50,35,21,20,60,12,92,56
17319,Fourneaux,50192,50,35,35,10,30,30,70,70
17320,Le Fresne-Poret,50193,50,18,26,15,80,37,132,44
17321,Fresville,50194,50,30,85,47,188,35,270,115
17322,Gathemo,50195,50,35,60,25,85,45,155,95
17323,Gatteville-le-Phare,50196,50,157,57,13,173,45,231,214
17324,Gavray,50197,50,321,288,116,520,196,832,609
17325,Geffosses,50198,50,76,89,20,129,71,220,165
17326,Genêts,50199,50,95,77,8,131,75,214,172
17327,Ger,50200,50,168,125,44,291,119,454,293
17328,La Godefroy,50205,50,12,73,8,64,76,148,85
17329,La Gohannière,50206,50,29,45,5,15,40,60,74
17330,Golleville,50207,50,25,15,25,60,40,125,40
17331,Gonfreville,50208,50,15,35,10,50,25,85,50
17332,Gonneville-Le Theil,50209,50,103,394,151,578,317,1046,497
17333,Gorges,50210,50,51,74,10,110,47,167,125
17334,Gouvets,50214,50,35,70,20,115,40,175,105
17335,Gouville sur Mer,50215,50,519,395,100,848,297,1245,914
17336,Graignes-Mesnil-Angot,50216,50,115,215,75,225,125,425,330
17337,Le Grand-Celland,50217,50,90,159,65,173,105,343,249
17338,Granville,50218,50,2811,2293,1148,4367,1761,7276,5104
17339,Gratot,50219,50,30,135,62,272,88,422,165
17340,Gréville-Hague,50220,50,90,175,20,250,165,435,265
17341,Grimesnil,50221,50,0,13,4,16,12,32,13
17342,Grosville,50222,50,50,200,80,270,170,520,250
17343,Guéhébert,50223,50,16,28,4,16,20,40,44
17344,Le Guislain,50225,50,12,32,36,28,16,80,44
17345,Le Ham,50227,50,25,71,10,150,70,230,96
17346,Hambye,50228,50,260,220,145,400,135,680,480
17347,Hamelin,50229,50,10,20,0,45,20,65,30
17348,Hardinvast,50230,50,125,225,70,315,125,510,350
17349,Hauteville-sur-Mer,50231,50,173,109,12,234,114,360,282
17350,Hauteville-la-Guichard,50232,50,48,141,32,124,104,260,189
17351,Hautteville-Bocage,50233,50,15,25,20,58,15,93,40
17352,La Haye-Bellefond,50234,50,16,20,4,20,20,44,36
17353,La Haye-d'Ectot,50235,50,38,34,12,79,29,120,72
17354,La Haye,50236,50,839,723,337,1486,536,2359,1562
17355,La Haye-Pesnel,50237,50,313,255,115,411,183,709,568
17356,Héauville,50238,50,55,90,30,135,60,225,145
17357,Thèreval,50239,50,204,478,166,486,391,1043,682
17358,Helleville,50240,50,37,148,59,130,91,280,185
17359,Hémevez,50241,50,20,40,15,65,40,120,60
17360,Herqueville,50242,50,15,35,25,65,25,115,50
17361,Heugueville-sur-Sienne,50243,50,115,105,35,195,85,315,220
17362,Hérenguerville,50244,50,16,48,12,92,32,136,64
17363,Hiesville,50246,50,15,15,10,20,10,40,30
17364,Hocquigny,50247,50,12,44,12,84,24,120,56
17365,Le Hommet-d'Arthenay,50248,50,32,92,36,132,52,220,124
17366,Huberville,50251,50,24,140,24,116,76,216,164
17367,Hudimesnil,50252,50,62,239,60,263,209,532,301
17368,Huisnes-sur-Mer,50253,50,45,30,15,90,15,120,75
17369,Isigny-le-Buat,50256,50,555,820,310,990,610,1910,1375
17370,Jobourg,50257,50,64,152,52,124,84,260,216
17371,Joganville,50258,50,5,30,10,35,30,75,35
17372,Juilley,50259,50,96,212,40,164,168,372,308
17373,Juvigny-le-Tertre,50260,50,120,110,60,200,75,335,230
17374,Lamberville,50261,50,30,60,15,40,45,100,90
17375,La Lande-d'Airou,50262,50,50,105,50,225,75,350,155
17376,Lapenty,50263,50,51,79,20,170,57,247,130
17377,Laulne,50265,50,20,32,28,41,32,101,52
17378,Lengronne,50266,50,25,100,35,170,90,295,125
17379,Lessay,50267,50,250,506,170,813,309,1292,756
17380,Lestre,50268,50,25,61,10,127,31,168,86
17381,Liesville-sur-Douve,50269,50,29,49,13,49,33,95,78
17382,Lieusaint,50270,50,55,124,49,125,74,248,179
17383,Lingeard,50271,50,15,10,0,30,15,45,25
17384,Lingreville,50272,50,196,157,57,377,141,575,353
17385,Montsenelle,50273,50,267,276,98,404,225,727,543
17386,Les Loges-Marchis,50274,50,130,220,59,380,170,609,350
17387,Les Loges-sur-Brécey,50275,50,24,24,12,64,16,92,48
17388,Lolif,50276,50,75,110,85,145,130,360,185
17389,Longueville,50277,50,102,127,15,218,88,321,229
17390,Le Loreur,50278,50,30,87,21,46,62,129,117
17391,Le Lorey,50279,50,68,192,48,192,120,360,260
17392,La Lucerne-d'Outremer,50281,50,120,228,76,252,180,508,348
17393,Le Luot,50282,50,40,52,44,52,48,144,92
17394,La Luzerne,50283,50,8,13,4,28,8,40,21
17395,Magneville,50285,50,25,85,10,104,90,204,110
17396,Marcey-les-Grèves,50288,50,120,294,93,458,240,791,414
17397,Marchésieux,50289,50,128,204,80,168,156,404,332
17398,Marcilly,50290,50,70,91,35,120,40,195,161
17399,Margueray,50291,50,20,35,25,30,25,80,55
17400,Marigny-Le-Lozon,50292,50,329,640,206,754,522,1482,969
17401,Martinvast,50294,50,118,278,71,425,200,696,396
17402,Maupertuis,50295,50,12,28,16,36,40,92,40
17403,Maupertus-sur-Mer,50296,50,32,47,12,85,23,120,79
17404,La Meauffe,50297,50,144,272,116,392,156,664,416
17405,Méautis,50298,50,65,165,45,230,125,400,230
17406,Le Mesnil,50299,50,20,68,20,60,52,132,88
17407,Le Mesnil-Adelée,50300,50,30,40,10,70,10,90,70
17408,Le Mesnil-Amand,50301,50,41,29,6,42,29,77,70
17409,Le Mesnil-Amey,50302,50,34,70,20,90,50,160,104
17410,Le Mesnil-Aubert,50304,50,24,60,12,52,25,89,84
17411,Le Mesnil-au-Val,50305,50,48,229,24,228,180,432,277
17412,Le Mesnilbus,50308,50,15,90,40,120,55,215,105
17413,Le Mesnil-Eury,50310,50,24,60,12,40,40,92,84
17414,Le Mesnil-Garnier,50311,50,52,48,9,47,37,93,100
17415,Le Mesnil-Gilbert,50312,50,37,26,22,3,36,61,63
17416,Le Mesnil-Herman,50313,50,5,60,5,50,30,85,65
17417,Le Mesnillard,50315,50,56,52,12,104,44,160,108
17418,Le Mesnil-Ozenne,50317,50,32,80,0,60,68,128,112
17419,Le Mesnil-Rainfray,50318,50,35,25,50,95,20,165,60
17420,Le Mesnil-Rogues,50320,50,5,50,10,55,45,110,55
17421,Le Mesnil-Rouxelin,50321,50,35,135,20,230,85,335,170
17422,Le Mesnil-Tôve,50323,50,45,75,10,80,30,120,120
17423,Le Mesnil-Véneron,50324,50,5,35,5,60,10,75,40
17424,Le Mesnil-Vigot,50325,50,55,40,25,75,15,115,95
17425,Le Mesnil-Villeman,50326,50,48,40,8,96,32,136,88
17426,La Meurdraquière,50327,50,20,36,16,48,20,84,56
17427,Millières,50328,50,57,228,113,188,145,446,285
17428,Les Moitiers-d'Allonne,50332,50,112,144,46,196,100,342,256
17429,Les Moitiers-en-Bauptois,50333,50,76,72,32,88,64,184,148
17430,Montabot,50334,50,22,70,16,60,55,131,92
17431,Montaigu-la-Brisette,50335,50,17,135,26,171,123,320,152
17432,Montaigu-les-Bois,50336,50,40,45,30,75,35,140,85
17433,Montanel,50337,50,68,80,44,120,64,228,148
17434,Montbray,50338,50,127,69,32,96,48,176,196
17435,Montcuit,50340,50,25,40,15,65,35,115,65
17436,Montebourg,50341,50,325,485,195,660,295,1150,810
17437,Montfarville,50342,50,110,155,53,315,95,463,265
17438,Monthuchon,50345,50,86,147,30,225,102,357,233
17439,Montjoie-Saint-Martin,50347,50,40,55,10,60,85,155,95
17440,Montmartin-en-Graignes,50348,50,96,116,52,168,124,344,212
17441,Montmartin-sur-Mer,50349,50,281,212,100,486,152,738,493
17442,Montpinchon,50350,50,50,135,90,155,100,345,185
17443,Montrabot,50351,50,9,11,3,32,0,35,20
17444,Montreuil-sur-Lozon,50352,50,30,100,69,70,60,199,130
17445,Le Mont-Saint-Michel,50353,50,0,12,0,18,0,18,12
17446,Montsurvent,50354,50,56,99,28,114,78,220,155
17447,Moon-sur-Elle,50356,50,95,215,72,307,122,501,310
17448,Morigny,50357,50,25,5,0,35,15,50,30
17449,Morsalines,50358,50,35,50,20,105,10,135,85
17450,Mortain-Bocage,50359,50,504,528,223,1292,331,1846,1032
17451,Morville,50360,50,25,47,18,91,27,136,72
17452,La Mouche,50361,50,28,88,12,48,64,124,116
17453,Moulines,50362,50,44,72,24,108,52,184,116
17454,Moyon Villages,50363,50,203,442,145,319,370,834,645
17455,Muneville-le-Bingard,50364,50,85,213,70,160,145,375,298
17456,Muneville-sur-Mer,50365,50,32,130,36,132,108,276,162
17457,Nay,50368,50,12,20,3,22,12,37,32
17458,Négreville,50369,50,50,220,30,295,195,520,270
17459,Néhou,50370,50,68,129,48,197,109,354,197
17460,Le Neufbourg,50371,50,47,76,29,162,64,255,123
17461,Neufmesnil,50372,50,5,78,14,80,34,128,83
17462,Neuville-au-Plain,50373,50,15,17,3,26,16,45,32
17463,Neuville-en-Beaumont,50374,50,5,0,5,10,5,20,5
17464,Nicorps,50376,50,47,80,21,174,44,239,127
17465,Notre-Dame-de-Cenilly,50378,50,112,188,60,184,128,372,300
17466,Notre-Dame-de-Livoye,50379,50,20,25,23,45,15,83,45
17467,Nouainville,50382,50,4,120,40,244,84,368,124
17468,Octeville-l'Avenel,50384,50,13,48,20,62,29,111,61
17469,Omonville-la-Petite,50385,50,25,24,12,32,23,67,49
17470,Omonville-la-Rogue,50386,50,29,104,21,205,72,298,133
17471,Orglandes,50387,50,21,77,37,108,71,216,98
17472,Orval sur Sienne,50388,50,117,244,94,525,171,790,361
17473,Ouville,50389,50,84,116,36,148,76,260,200
17474,Ozeville,50390,50,8,38,4,59,21,84,46
17475,Grandparigny,50391,50,510,527,164,1037,449,1650,1037
17476,Percy-en-Normandie,50393,50,511,593,216,791,382,1389,1104
17477,Périers,50394,50,506,463,171,712,278,1161,969
17478,La Pernelle,50395,50,40,55,15,90,60,165,95
17479,Perriers-en-Beauficel,50397,50,55,50,15,90,10,115,105
17480,Le Perron,50398,50,28,60,4,56,56,116,88
17481,Le Petit-Celland,50399,50,12,52,44,68,36,148,64
17482,Picauville,50400,50,528,650,254,887,446,1587,1178
17483,Pierreville,50401,50,45,210,55,245,155,455,255
17484,Les Pieux,50402,50,313,763,364,1106,552,2022,1076
17485,Pirou,50403,50,305,265,105,571,173,849,570
17486,Placy-Montaigu,50404,50,10,50,15,90,55,160,60
17487,Le Plessis-Lastelle,50405,50,50,55,20,80,30,130,105
17488,Poilley,50407,50,140,235,70,280,185,535,375
17489,Pontaubault,50408,50,45,139,54,140,111,305,184
17490,Pont-Hébert,50409,50,329,391,153,443,327,923,720
17491,Pontorson,50410,50,857,720,391,1541,564,2496,1577
17492,Ponts,50411,50,89,144,33,142,143,318,233
17493,Portbail,50412,50,320,271,65,659,206,930,591
17494,Précey,50413,50,76,152,72,104,116,292,228
17495,Quettehou,50417,50,304,356,124,576,236,936,660
17496,Quettreville-sur-Sienne,50419,50,238,469,189,546,367,1102,707
17497,Quibou,50420,50,103,250,90,324,175,589,353
17498,Quinéville,50421,50,84,44,20,104,28,152,128
17499,Raids,50422,50,19,38,12,41,37,90,57
17500,Rampan,50423,50,40,40,10,80,35,125,80
17501,Rauville-la-Bigot,50425,50,95,315,90,435,205,730,410
17502,Rauville-la-Place,50426,50,68,76,48,152,52,252,144
17503,Ravenoville,50427,50,40,35,5,165,15,185,75
17504,Reffuveille,50428,50,114,56,43,160,41,244,170
17505,Regnéville-sur-Mer,50429,50,125,130,30,360,100,490,255
17506,Reigneville-Bocage,50430,50,4,8,8,8,4,20,12
17507,Remilly-sur-Lozon,50431,50,113,179,93,147,75,315,292
17508,Réville,50433,50,249,207,81,399,146,626,456
17509,Rocheville,50435,50,103,135,53,154,106,313,238
17510,Romagny Fontenay,50436,50,133,329,85,523,218,826,462
17511,Roncey,50437,50,176,182,126,257,70,453,358
17512,La Ronde-Haye,50438,50,35,85,10,145,65,220,120
17513,Le Rozel,50442,50,30,40,15,95,65,175,70
17514,Sacey,50443,50,50,170,50,175,100,325,220
17515,Saint-Amand,50444,50,268,593,205,800,442,1447,861
17516,Saint-André-de-Bohon,50445,50,52,88,20,88,38,146,140
17517,Saint-André-de-l'Épine,50446,50,48,120,56,220,108,384,168
17518,Saint-Aubin-des-Préaux,50447,50,60,108,20,152,84,256,168
17519,Saint-Aubin-de-Terregatte,50448,50,120,180,45,230,110,385,300
17520,Saint-Aubin-du-Perron,50449,50,36,80,17,60,41,118,116
17521,Saint-Barthélemy,50450,50,60,56,28,116,64,208,116
17522,Saint-Brice,50451,50,20,36,4,52,32,88,56
17523,Saint-Brice-de-Landelles,50452,50,90,190,65,225,135,425,280
17524,Sainte-Cécile,50453,50,143,200,95,250,155,500,343
17525,Saint-Christophe-du-Foc,50454,50,28,148,24,116,104,244,176
17526,Saint-Clair-sur-l'Elle,50455,50,109,225,90,334,120,544,334
17527,Saint-Clément-Rancoudray,50456,50,80,120,25,205,115,345,200
17528,Sainte-Colombe,50457,50,35,55,15,70,30,115,90
17529,Sainte-Croix-Hague,50460,50,52,240,84,272,172,528,292
17530,Saint-Cyr,50461,50,30,55,10,50,56,116,85
17531,Saint-Cyr-du-Bailleul,50462,50,50,80,15,190,65,270,130
17532,Saint-Denis-le-Gast,50463,50,112,124,24,196,72,292,236
17533,Saint-Denis-le-Vêtu,50464,50,60,160,100,208,96,404,220
17534,Saint-Ébremond-de-Bonfossé,50465,50,90,180,65,280,100,445,270
17535,Saint-Floxel,50467,50,28,114,16,193,81,290,142
17536,Saint-Fromond,50468,50,125,185,55,230,145,430,310
17537,Sainte-Geneviève,50469,50,55,60,20,90,75,185,115
17538,Saint-Georges-de-la-Rivière,50471,50,30,50,35,141,30,206,80
17539,Saint-Georges-de-Livoye,50472,50,40,50,15,110,5,130,90
17540,Saint-Georges-d'Elle,50473,50,40,76,47,133,60,240,116
17541,Saint-Georges-de-Rouelley,50474,50,160,80,44,192,72,308,240
17542,Saint-Georges-Montcocq,50475,50,92,155,71,375,129,575,247
17543,Saint-Germain-d'Elle,50476,50,33,54,4,58,48,110,87
17544,Saint-Germain-des-Vaux,50477,50,45,70,30,150,55,235,115
17545,Saint-Germain-de-Tournebut,50478,50,29,90,49,81,93,223,119
17546,Saint-Germain-de-Varreville,50479,50,40,20,4,40,20,64,60
17547,Saint-Germain-le-Gaillard,50480,50,125,180,80,225,140,445,305
17548,Saint-Germain-sur-Ay,50481,50,226,144,80,363,99,542,370
17549,Saint-Germain-sur-Sèves,50482,50,32,44,32,56,28,116,76
17550,Saint-Gilles,50483,50,80,205,50,286,205,541,285
17551,Saint-Hilaire-du-Harcouët,50484,50,1316,1174,468,1991,883,3342,2490
17552,Saint-Hilaire-Petitville,50485,50,150,318,112,501,183,796,468
17553,Saint-Jacques-de-Néhou,50486,50,60,184,71,109,123,303,244
17554,Saint-James,50487,50,493,494,245,917,356,1518,987
17555,Saint-Jean-de-Daye,50488,50,140,104,40,196,116,352,244
17556,Saint-Jean-de-la-Haize,50489,50,68,105,27,139,113,279,173
17557,Saint-Jean-de-la-Rivière,50490,50,30,70,20,185,40,245,100
17558,Saint-Jean-de-Savigny,50491,50,37,137,52,67,95,214,174
17559,Saint-Jean-d'Elle,50492,50,301,629,194,730,509,1433,930
17560,Saint-Jean-des-Champs,50493,50,130,390,56,468,266,790,520
17561,Saint-Jean-du-Corail-des-Bois,50495,50,30,15,0,20,15,35,45
17562,Saint-Jean-le-Thomas,50496,50,147,44,10,142,35,187,191
17563,Saint-Joseph,50498,50,65,210,40,315,155,510,275
17564,Saint-Laurent-de-Cuves,50499,50,90,85,55,165,100,320,175
17565,Saint-Laurent-de-Terregatte,50500,50,112,168,80,136,128,344,280
17566,Saint-Lô,50502,50,2678,4054,2705,5858,3192,11755,6732
17567,Saint-Lô-d'Ourville,50503,50,95,75,25,255,55,335,170
17568,Saint-Louet-sur-Vire,50504,50,4,58,21,50,43,114,62
17569,Saint-Loup,50505,50,80,235,15,178,215,408,315
17570,Saint-Malo-de-la-Lande,50506,50,30,120,55,185,75,315,150
17571,Saint-Marcouf,50507,50,85,43,34,99,29,162,128
17572,Sainte-Marie-du-Mont,50509,50,124,140,60,276,96,432,264
17573,Saint-Martin-d'Aubigny,50510,50,64,144,68,152,100,320,208
17574,Saint-Martin-d'Audouville,50511,50,5,20,30,40,30,100,25
17575,Saint-Martin-de-Bonfossé,50512,50,60,155,40,163,115,318,215
17576,Saint-Martin-de-Cenilly,50513,50,20,25,25,80,25,130,45
17577,Chaulieu,50514,50,36,76,28,104,40,172,112
17578,Saint-Martin-des-Champs,50516,50,382,477,156,849,380,1385,859
17579,Saint-Martin-de-Varreville,50517,50,39,42,3,53,23,79,81
17580,Saint-Martin-le-Bouillant,50518,50,80,64,24,88,60,172,144
17581,Saint-Martin-le-Gréard,50519,50,10,160,20,130,155,305,170
17582,Saint-Maur-des-Bois,50521,50,55,25,25,35,20,80,80
17583,Saint-Maurice-en-Cotentin,50522,50,20,60,15,110,55,180,80
17584,Sainte-Mère-Église,50523,50,495,543,218,797,388,1403,1038
17585,Saint-Michel-de-la-Pierre,50524,50,15,60,30,75,35,140,75
17586,Saint-Michel-de-Montjoie,50525,50,80,45,0,150,40,190,125
17587,Saint-Nicolas-de-Pierrepont,50528,50,40,80,32,88,52,172,120
17588,Saint-Nicolas-des-Bois,50529,50,16,22,3,26,19,48,38
17589,Saint-Ovin,50531,50,60,205,65,295,125,485,265
17590,Saint-Pair-sur-Mer,50532,50,772,718,224,1553,533,2310,1490
17591,Saint-Patrice-de-Claids,50533,50,32,24,20,56,24,100,56
17592,Saint-Pellerin,50534,50,20,100,30,150,74,254,120
17593,Le Parc,50535,50,113,230,95,255,195,545,343
17594,Saint-Pierre-d'Arthéglise,50536,50,20,15,20,70,10,100,35
17595,Saint-Pierre-de-Coutances,50537,50,52,116,12,156,84,252,168
17596,Saint-Pierre-de-Semilly,50538,50,45,130,40,175,70,285,175
17597,Saint-Pierre-Église,50539,50,252,432,156,548,296,1000,684
17598,Saint-Pierre-Langers,50540,50,84,136,40,172,104,316,220
17599,Saint-Planchers,50541,50,135,320,120,510,235,865,455
17600,Saint-Pois,50542,50,92,71,39,181,79,299,163
17601,Saint-Quentin-sur-le-Homme,50543,50,160,300,152,380,228,760,460
17602,Bourgvallées,50546,50,263,618,235,834,514,1583,881
17603,Saint-Sauveur-de-Pierrepont,50548,50,28,32,4,44,20,68,60
17604,Saint-Sauveur-la-Pommeraye,50549,50,40,56,44,136,28,208,96
17605,Saint-Sauveur-Lendelin,50550,50,207,424,143,523,244,910,631
17606,Saint-Sauveur-le-Vicomte,50551,50,297,524,262,671,291,1224,821
17607,Saint-Sébastien-de-Raids,50552,50,32,96,44,88,84,216,128
17608,Saint-Senier-de-Beuvron,50553,50,24,69,24,97,43,164,93
17609,Saint-Senier-sous-Avranches,50554,50,227,307,59,473,232,764,534
17610,Sainte-Suzanne-sur-Vire,50556,50,60,164,48,244,116,408,224
17611,Saint-Vaast-la-Hougue,50562,50,433,284,149,681,207,1037,717
17612,Saint-Vigor-des-Monts,50563,50,55,55,15,100,60,175,110
17613,Terre-et-Marais,50564,50,84,333,116,397,247,760,417
17614,Sartilly-Baie-Bocage,50565,50,437,706,244,712,530,1486,1143
17615,Saussemesnil,50567,50,123,237,37,319,150,506,360
17616,Saussey,50568,50,50,124,29,176,75,280,174
17617,Savigny,50569,50,48,113,63,94,56,213,161
17618,Savigny-le-Vieux,50570,50,94,91,29,135,52,216,185
17619,Sébeville,50571,50,4,8,0,12,8,20,12
17620,Sénoville,50572,50,5,60,5,100,45,150,65
17621,Servigny,50573,50,6,54,3,64,44,111,60
17622,Servon,50574,50,21,39,25,91,42,158,60
17623,Sideville,50575,50,36,197,60,168,152,380,233
17624,Siouville-Hague,50576,50,125,260,133,319,225,677,385
17625,Sortosville-en-Beaumont,50577,50,56,68,24,116,44,184,124
17626,Sortosville,50578,50,4,28,4,48,24,76,32
17627,Sottevast,50579,50,136,348,76,394,294,764,484
17628,Sotteville,50580,50,10,168,60,153,99,312,178
17629,Soulles,50581,50,35,146,50,160,85,295,181
17630,Sourdeval,50582,50,799,520,179,1132,355,1666,1319
17631,Sourdeval-les-Bois,50583,50,32,44,20,64,36,120,76
17632,Subligny,50584,50,37,83,22,138,47,207,120
17633,Surtainville,50585,50,180,245,140,440,170,750,425
17634,Taillepied,50587,50,0,8,4,8,8,20,8
17635,Tamerville,50588,50,55,180,55,260,105,420,235
17636,Tanis,50589,50,32,77,32,57,87,176,109
17637,Le Tanu,50590,50,40,88,24,108,92,224,128
17638,Le Teilleul,50591,50,442,304,137,566,240,943,746
17639,Tessy Bocage,50592,50,285,454,124,589,310,1023,739
17640,Teurthéville-Bocage,50593,50,60,130,65,205,125,395,190
17641,Teurthéville-Hague,50594,50,67,278,62,347,196,605,345
17642,Théville,50596,50,43,63,17,105,38,160,106
17643,Tirepied,50597,50,88,204,68,240,168,476,292
17644,Tocqueville,50598,50,44,58,21,93,41,155,102
17645,Tollevast,50599,50,123,358,154,463,245,862,481
17646,Tonneville,50600,50,28,160,56,236,156,448,188
17647,Torigny-les-Villes,50601,50,718,1004,403,1253,835,2491,1722
17648,Tourville-sur-Sienne,50603,50,169,170,60,300,90,450,339
17649,Tréauville,50604,50,95,220,80,205,135,420,315
17650,Trelly,50605,50,100,185,40,190,145,375,285
17651,Tribehou,50606,50,90,134,54,158,115,327,224
17652,La Trinité,50607,50,52,120,24,84,104,212,172
17653,Troisgots,50608,50,28,92,28,104,72,204,120
17654,Turqueville,50609,50,20,40,12,32,44,88,60
17655,Urville,50610,50,20,64,16,68,48,132,84
17656,Urville-Nacqueville,50611,50,207,466,139,922,361,1422,673
17657,Vains,50612,50,100,160,45,357,95,497,260
17658,Valcanville,50613,50,95,87,16,92,61,169,182
17659,Valognes,50615,50,1183,1313,484,2301,1043,3828,2496
17660,Le Val-Saint-Père,50616,50,220,494,131,681,391,1203,714
17661,Varenguebec,50617,50,50,63,25,79,53,157,113
17662,Varouville,50618,50,28,58,13,124,33,170,86
17663,Le Vast,50619,50,38,58,19,96,50,165,96
17664,Vasteville,50620,50,25,358,102,263,297,662,383
17665,Vaudreville,50621,50,18,16,9,9,13,31,34
17666,Vaudrimesnil,50622,50,36,101,45,112,62,219,137
17667,Vauville,50623,50,33,62,52,132,43,227,95
17668,La Vendelée,50624,50,35,110,35,190,80,305,145
17669,Ver,50626,50,35,80,70,115,60,245,115
17670,Vergoncey,50627,50,30,50,25,40,55,120,80
17671,Vernix,50628,50,28,56,12,52,32,96,84
17672,Vesly,50629,50,80,181,96,232,92,420,261
17673,Les Veys,50631,50,38,98,39,127,75,241,136
17674,Le Vicel,50633,50,30,30,20,35,15,70,60
17675,Videcosville,50634,50,10,35,5,20,25,50,45
17676,Vierville,50636,50,0,10,0,25,5,30,10
17677,Villebaudon,50637,50,20,72,32,112,64,208,92
17678,Villedieu-les-Poêles-Rouffigny,50639,50,745,757,412,1333,537,2282,1502
17679,Villiers-le-Pré,50640,50,30,50,25,50,35,110,80
17680,Villiers-Fossard,50641,50,31,180,25,207,142,374,211
17681,Virandeville,50643,50,85,185,90,285,145,520,270
17682,Yquelon,50647,50,180,195,60,460,165,685,375
17683,Yvetot-Bocage,50648,50,90,305,120,370,230,720,395
17684,Ablancourt,51001,51,16,34,20,44,25,89,50
17685,Saint-Martin-d'Ablois,51002,51,180,328,96,552,232,880,508
17686,Aigny,51003,51,30,65,30,70,65,165,95
17687,Allemanche-Launay-et-Soyer,51004,51,20,19,6,12,15,33,39
17688,Allemant,51005,51,28,45,0,65,39,104,73
17689,Alliancelles,51006,51,45,25,5,50,20,75,70
17690,Ambonnay,51007,51,90,265,90,328,180,598,355
17691,Ambrières,51008,51,4,50,8,78,54,140,54
17692,Anglure,51009,51,106,193,68,317,117,502,299
17693,Angluzelles-et-Courcelles,51010,51,28,48,4,32,44,80,76
17694,Anthenay,51012,51,0,15,15,25,10,50,15
17695,Aougny,51013,51,0,32,0,25,26,51,32
17696,Arcis-le-Ponsart,51014,51,60,60,20,70,55,145,120
17697,Argers,51015,51,25,30,5,15,30,50,55
17698,Arrigny,51016,51,30,50,21,99,27,147,80
17699,Arzillières-Neuville,51017,51,65,80,15,110,50,175,145
17700,Athis,51018,51,52,206,43,261,177,481,258
17701,Aubérive,51019,51,32,60,28,68,32,128,92
17702,Aubilly,51020,51,0,28,4,12,12,28,28
17703,Aulnay-l'Aître,51022,51,44,36,0,36,36,72,80
17704,Aulnay-sur-Marne,51023,51,20,64,16,80,68,164,84
17705,Auménancourt,51025,51,72,332,80,224,288,592,404
17706,Auve,51027,51,21,88,20,78,42,140,109
17707,Avenay-Val-d'Or,51028,51,99,220,93,242,180,515,319
17708,Avize,51029,51,164,436,208,508,336,1052,600
17709,Aÿ-Champagne,51030,51,654,1193,595,1996,1023,3614,1847
17710,Baconnes,51031,51,25,70,25,85,50,160,95
17711,Bagneux,51032,51,75,105,50,180,70,300,180
17712,Le Baizil,51033,51,40,56,24,96,28,148,96
17713,Bannay,51034,51,0,0,0,6,3,9,0
17714,Bannes,51035,51,24,84,56,76,60,192,108
17715,Barbonne-Fayel,51036,51,34,82,28,194,114,336,116
17716,Baslieux-lès-Fismes,51037,51,44,80,16,72,84,172,124
17717,Baslieux-sous-Châtillon,51038,51,12,38,16,57,28,101,50
17718,Bassu,51039,51,8,32,20,48,28,96,40
17719,Bassuet,51040,51,40,40,30,110,50,190,80
17720,Baudement,51041,51,10,5,10,45,25,80,15
17721,Baye,51042,51,40,95,30,150,70,250,135
17722,Bazancourt,51043,51,224,560,156,668,408,1232,784
17723,Beaumont-sur-Vesle,51044,51,57,164,109,324,107,540,221
17724,Beaunay,51045,51,24,24,16,36,12,64,48
17725,Beine-Nauroy,51046,51,40,301,80,391,220,691,341
17726,Belval-en-Argonne,51047,51,25,5,0,15,0,15,30
17727,Belval-sous-Châtillon,51048,51,5,30,15,50,40,105,35
17728,Bergères-lès-Vertus,51049,51,65,145,65,240,100,405,210
17729,Bergères-sous-Montmirail,51050,51,35,20,0,44,25,69,55
17730,Berméricourt,51051,51,24,45,10,59,40,109,69
17731,Berru,51052,51,52,120,28,188,104,320,172
17732,Berzieux,51053,51,16,21,8,8,4,20,37
17733,Bétheniville,51054,51,60,436,145,332,288,765,496
17734,Bétheny,51055,51,664,1442,594,2501,1196,4291,2106
17735,Bethon,51056,51,45,50,20,105,65,190,95
17736,Bettancourt-la-Longue,51057,51,10,5,0,50,5,55,15
17737,Bezannes,51058,51,154,472,143,533,253,929,626
17738,Bignicourt-sur-Marne,51059,51,65,60,15,165,40,220,125
17739,Bignicourt-sur-Saulx,51060,51,12,40,8,57,39,104,52
17740,Billy-le-Grand,51061,51,0,28,20,40,32,92,28
17741,Binarville,51062,51,8,20,4,44,20,68,28
17742,Binson-et-Orquigny,51063,51,5,55,20,60,40,120,60
17743,Blacy,51065,51,120,125,65,275,65,405,245
17744,Blaise-sous-Arzillières,51066,51,73,53,12,104,47,163,126
17745,Blesme,51068,51,20,95,30,20,75,125,115
17746,Bligny,51069,51,30,35,15,35,20,70,65
17747,Boissy-le-Repos,51070,51,35,25,16,68,25,109,60
17748,Bouchy-Saint-Genest,51071,51,4,38,8,71,50,129,42
17749,Bouilly,51072,51,16,48,8,64,56,128,64
17750,Bouleuse,51073,51,10,65,5,85,50,140,75
17751,Boult-sur-Suippe,51074,51,155,468,81,517,402,1000,623
17752,Bourgogne,51075,51,105,210,60,360,175,595,315
17753,Boursault,51076,51,27,114,26,140,103,269,141
17754,Bouvancourt,51077,51,15,40,10,90,30,130,55
17755,Bouy,51078,51,24,156,92,143,78,313,180
17756,Bouzy,51079,51,135,260,85,270,210,565,395
17757,Brandonvillers,51080,51,45,55,5,40,45,90,100
17758,Branscourt,51081,51,28,64,20,104,44,168,92
17759,Braux-Sainte-Cohière,51082,51,4,12,9,24,24,57,16
17760,Braux-Saint-Remy,51083,51,10,20,0,35,20,55,30
17761,Bréban,51084,51,0,10,25,40,10,75,10
17762,Le Breuil,51085,51,70,120,30,120,60,210,190
17763,Breuil,51086,51,12,104,32,100,88,220,116
17764,Breuvery-sur-Coole,51087,51,20,52,12,88,32,132,72
17765,Brimont,51088,51,24,67,45,196,53,294,91
17766,Brouillet,51089,51,10,30,0,43,5,48,40
17767,Broussy-le-Grand,51090,51,36,61,23,75,63,161,97
17768,Broussy-le-Petit,51091,51,35,20,5,40,35,80,55
17769,Broyes,51092,51,50,70,40,140,55,235,120
17770,Brugny-Vaudancourt,51093,51,20,110,20,225,105,350,130
17771,Brusson,51094,51,20,25,31,105,5,141,45
17772,Le Buisson,51095,51,4,18,8,20,12,40,22
17773,Bussy-le-Château,51097,51,55,25,5,50,20,75,80
17774,Bussy-le-Repos,51098,51,10,50,5,30,50,85,60
17775,Bussy-Lettrée,51099,51,35,125,20,90,65,175,160
17776,La Caure,51100,51,3,19,0,24,25,49,22
17777,Caurel,51101,51,65,160,25,235,135,395,225
17778,Cauroy-lès-Hermonville,51102,51,28,156,36,164,124,324,184
17779,La Celle-sous-Chantemerle,51103,51,25,41,0,50,36,86,66
17780,Cernay-en-Dormois,51104,51,25,44,10,53,30,93,69
17781,Cernay-lès-Reims,51105,51,203,278,76,459,213,748,481
17782,Cernon,51106,51,0,35,15,50,25,90,35
17783,Chaintrix-Bierges,51107,51,20,92,48,84,76,208,112
17784,Châlons-en-Champagne,51108,51,5034,10344,6102,12552,8056,26710,15378
17785,Châlons-sur-Vesle,51109,51,8,80,20,88,20,128,88
17786,Chaltrait,51110,51,15,10,0,20,10,30,25
17787,Chambrecy,51111,51,3,32,16,43,27,86,35
17788,Chamery,51112,51,52,84,32,152,56,240,136
17789,Champaubert,51113,51,15,25,25,55,15,95,40
17790,Champfleury,51115,51,84,104,48,196,100,344,188
17791,Champguyon,51116,51,30,90,20,90,45,155,120
17792,Champigneul-Champagne,51117,51,55,80,30,65,75,170,135
17793,Champigny,51118,51,81,392,86,447,273,806,473
17794,Champillon,51119,51,85,110,35,185,85,305,195
17795,Champlat-et-Boujacourt,51120,51,25,50,10,35,40,85,75
17796,Champvoisy,51121,51,10,85,30,65,75,170,95
17797,Changy,51122,51,12,24,20,56,8,84,36
17798,Chantemerle,51124,51,10,10,0,15,10,25,20
17799,Chapelaine,51125,51,6,16,3,6,16,25,22
17800,La Chapelle-Felcourt,51126,51,10,5,0,20,5,25,15
17801,La Chapelle-Lasson,51127,51,15,20,0,35,10,45,35
17802,La Chapelle-sous-Orbais,51128,51,0,5,0,20,10,30,5
17803,Charleville,51129,51,45,75,5,85,55,145,120
17804,Charmont,51130,51,27,47,6,62,39,107,74
17805,Les Charmontois,51132,51,5,15,0,75,25,100,20
17806,Le Châtelier,51133,51,13,9,9,12,0,21,22
17807,Châtelraould-Saint-Louvent,51134,51,35,55,10,95,40,145,90
17808,Châtillon-sur-Broué,51135,51,4,8,8,36,16,60,12
17809,Châtillon-sur-Marne,51136,51,72,204,40,228,160,428,276
17810,Châtillon-sur-Morin,51137,51,4,42,17,92,30,139,46
17811,Châtrices,51138,51,5,15,0,15,5,20,20
17812,Chaudefontaine,51139,51,20,78,9,117,61,187,98
17813,Chaumuzy,51140,51,45,111,40,100,95,235,156
17814,La Chaussée-sur-Marne,51141,51,60,235,44,285,186,515,295
17815,Chavot-Courcourt,51142,51,53,82,15,119,48,182,135
17816,Le Chemin,51143,51,20,5,0,10,10,20,25
17817,Cheminon,51144,51,55,110,60,277,94,431,165
17818,Chenay,51145,51,25,36,25,131,35,191,61
17819,Cheniers,51146,51,15,30,10,35,20,65,45
17820,La Cheppe,51147,51,25,95,10,145,60,215,120
17821,Cheppes-la-Prairie,51148,51,25,31,12,47,30,89,56
17822,Chepy,51149,51,48,113,12,103,95,210,161
17823,Cherville,51150,51,12,20,4,32,8,44,32
17824,Chichey,51151,51,10,45,15,100,30,145,55
17825,Chigny-les-Roses,51152,51,70,125,55,185,105,345,195
17826,Chouilly,51153,51,145,210,70,320,245,635,355
17827,Clamanges,51154,51,30,45,20,65,50,135,75
17828,Clesles,51155,51,55,175,25,215,165,405,230
17829,Cloyes-sur-Marne,51156,51,20,33,8,40,33,81,53
17830,Coizard-Joches,51157,51,20,5,15,10,20,45,25
17831,Val-des-Marais,51158,51,44,122,45,182,93,320,166
17832,Compertrix,51160,51,189,450,110,435,285,830,639
17833,Condé-sur-Marne,51161,51,55,235,65,275,150,490,290
17834,Conflans-sur-Seine,51162,51,77,109,79,227,90,396,186
17835,Congy,51163,51,30,70,35,88,24,147,100
17836,Connantray-Vaurefroy,51164,51,31,36,6,22,18,46,67
17837,Connantre,51165,51,105,304,115,410,179,704,409
17838,Contault,51166,51,6,12,6,24,6,36,18
17839,Coole,51167,51,35,35,10,40,30,80,70
17840,Coolus,51168,51,44,32,4,84,24,112,76
17841,Corbeil,51169,51,15,10,0,40,15,55,25
17842,Corfélix,51170,51,4,36,12,28,24,64,40
17843,Cormicy,51171,51,93,434,62,470,288,820,527
17844,Cormontreuil,51172,51,1127,1179,545,2168,898,3611,2306
17845,Cormoyeux,51173,51,12,20,4,38,33,75,32
17846,Corribert,51174,51,0,12,3,16,12,31,12
17847,Corrobert,51175,51,12,68,16,52,44,112,80
17848,Corroy,51176,51,16,37,21,20,34,75,53
17849,Coulommes-la-Montagne,51177,51,30,35,20,75,40,135,65
17850,Coupetz,51178,51,9,22,6,22,9,37,31
17851,Coupéville,51179,51,10,51,25,50,40,115,61
17852,Courcelles-Sapicourt,51181,51,25,120,35,90,80,205,145
17853,Courcemain,51182,51,15,25,15,50,25,90,40
17854,Courcy,51183,51,90,270,100,390,165,655,360
17855,Courdemanges,51184,51,69,61,12,150,53,215,130
17856,Courgivaux,51185,51,40,75,24,64,59,147,115
17857,Courjeonnet,51186,51,5,0,0,30,5,35,5
17858,Courlandon,51187,51,15,90,35,90,50,175,105
17859,Courmas,51188,51,12,52,4,76,48,128,64
17860,Courtagnon,51190,51,0,17,0,33,8,41,17
17861,Courtémont,51191,51,15,10,10,15,5,30,25
17862,Courthiézy,51192,51,45,90,20,140,70,230,135
17863,Courtisols,51193,51,265,585,190,980,390,1560,850
17864,Courville,51194,51,36,136,16,136,128,280,172
17865,Couvrot,51195,51,116,192,56,348,156,560,308
17866,Cramant,51196,51,105,200,60,325,170,555,305
17867,La Croix-en-Champagne,51197,51,0,25,5,30,25,60,25
17868,Crugny,51198,51,68,185,50,181,125,356,253
17869,Cuchery,51199,51,30,90,30,160,85,275,120
17870,Cuis,51200,51,89,70,25,180,40,245,159
17871,Cuisles,51201,51,12,44,4,40,36,80,56
17872,Cumières,51202,51,126,172,54,201,164,419,298
17873,Cuperly,51203,51,28,60,24,88,32,144,88
17874,Damery,51204,51,210,350,65,550,277,892,560
17875,Dampierre-au-Temple,51205,51,16,40,47,96,31,174,56
17876,Dampierre-le-Château,51206,51,10,35,10,45,20,75,45
17877,Dampierre-sur-Moivre,51208,51,15,28,3,19,31,53,43
17878,Dizy,51210,51,225,295,130,625,265,1020,520
17879,Dommartin-Dampierre,51211,51,4,8,4,36,12,52,12
17880,Dommartin-Lettrée,51212,51,30,40,30,35,20,85,70
17881,Dommartin-sous-Hans,51213,51,12,8,0,4,16,20,20
17882,Dommartin-Varimont,51214,51,36,36,16,32,24,72,72
17883,Dompremy,51215,51,15,50,10,30,40,80,65
17884,Dontrien,51216,51,39,67,26,56,40,122,106
17885,Dormans,51217,51,389,602,229,1043,469,1741,991
17886,Val-de-Vière,51218,51,15,35,10,45,30,85,50
17887,Drosnay,51219,51,8,53,18,62,52,132,61
17888,Drouilly,51220,51,34,36,4,37,16,57,70
17889,Éclaires,51222,51,0,32,6,27,15,48,32
17890,Écollemont,51223,51,10,10,5,35,5,45,20
17891,Écriennes,51224,51,0,40,20,85,35,140,40
17892,Écueil,51225,51,25,60,40,140,40,220,85
17893,Écury-le-Repos,51226,51,20,10,0,22,10,32,30
17894,Écury-sur-Coole,51227,51,38,149,12,125,125,262,187
17895,Élise-Daucourt,51228,51,10,10,20,50,10,80,20
17896,Épense,51229,51,30,35,5,40,20,65,65
17897,Épernay,51230,51,3043,5063,3004,7153,4202,14359,8106
17898,L'Épine,51231,51,41,117,19,251,104,374,158
17899,Époye,51232,51,34,120,30,140,110,280,154
17900,Escardes,51233,51,16,8,4,32,16,52,24
17901,Esclavolles-Lurey,51234,51,85,130,45,270,70,385,215
17902,Les Essarts-lès-Sézanne,51235,51,27,71,31,51,44,126,98
17903,Les Essarts-le-Vicomte,51236,51,20,35,15,60,10,85,55
17904,Esternay,51237,51,256,492,192,616,364,1172,748
17905,Étoges,51238,51,12,139,47,89,134,270,151
17906,Étréchy,51239,51,5,40,10,35,25,70,45
17907,Étrepy,51240,51,29,40,0,34,22,56,69
17908,Euvy,51241,51,8,20,8,40,12,60,28
17909,Fagnières,51242,51,592,1276,360,1577,899,2836,1868
17910,Faux-Fresnay,51243,51,56,96,8,128,72,208,152
17911,Faux-Vésigneul,51244,51,17,39,25,74,47,146,56
17912,Faverolles-et-Coëmy,51245,51,35,164,30,195,148,373,199
17913,Favresse,51246,51,36,60,12,84,20,116,96
17914,Fèrebrianges,51247,51,27,28,12,41,16,69,55
17915,Fère-Champenoise,51248,51,320,582,220,671,400,1291,902
17916,Festigny,51249,51,57,80,24,132,72,228,137
17917,Fismes,51250,51,499,1333,541,1817,921,3279,1832
17918,Flavigny,51251,51,30,45,10,55,40,105,75
17919,Fleury-la-Rivière,51252,51,75,77,67,177,62,306,152
17920,Florent-en-Argonne,51253,51,52,72,8,80,44,132,124
17921,Fontaine-Denis-Nuisy,51254,51,29,40,16,94,25,135,69
17922,Fontaine-en-Dormois,51255,51,0,8,0,8,4,12,8
17923,Fontaine-sur-Ay,51256,51,20,90,20,145,60,225,110
17924,La Forestière,51258,51,40,45,20,105,5,130,85
17925,Francheville,51259,51,20,60,10,65,55,130,80
17926,Le Fresne,51260,51,4,20,4,16,12,32,24
17927,Fresne-lès-Reims,51261,51,40,100,40,185,60,285,140
17928,Frignicourt,51262,51,289,324,151,700,284,1135,613
17929,Fromentières,51263,51,40,104,25,147,79,251,144
17930,Le Gault-Soigny,51264,51,40,125,60,150,125,335,165
17931,Gaye,51265,51,100,132,36,204,112,352,232
17932,Germaine,51266,51,41,127,16,147,115,278,168
17933,Germigny,51267,51,36,32,24,56,36,116,68
17934,Germinon,51268,51,17,42,16,54,30,100,59
17935,Giffaumont-Champaubert,51269,51,29,65,15,125,40,180,94
17936,Gigny-Bussy,51270,51,12,58,19,72,46,137,70
17937,Gionges,51271,51,0,69,16,44,32,92,69
17938,Givry-en-Argonne,51272,51,56,104,28,140,108,276,160
17939,Givry-lès-Loisy,51273,51,0,21,0,25,25,50,21
17940,Gizaucourt,51274,51,10,10,10,60,10,80,20
17941,Glannes,51275,51,8,32,28,76,28,132,40
17942,Gourgançon,51276,51,24,26,3,49,22,74,50
17943,Sainte-Marie-du-Lac-Nuisement,51277,51,29,51,12,76,48,136,80
17944,Les Grandes-Loges,51278,51,40,85,15,75,55,145,125
17945,Granges-sur-Aube,51279,51,10,55,25,50,45,120,65
17946,Gratreuil,51280,51,10,15,5,0,0,5,25
17947,Grauves,51281,51,75,150,50,285,85,420,225
17948,Gueux,51282,51,225,416,120,695,230,1045,641
17949,Hans,51283,51,40,20,10,40,25,75,60
17950,Haussignémont,51284,51,30,70,25,84,84,193,100
17951,Haussimont,51285,51,9,20,19,51,9,79,29
17952,Hauteville,51286,51,0,60,9,97,36,142,60
17953,Hautvillers,51287,51,36,162,52,269,166,487,198
17954,Heiltz-le-Hutier,51288,51,28,64,12,68,64,144,92
17955,Heiltz-le-Maurupt,51289,51,30,123,40,137,95,272,153
17956,Heiltz-l'Évêque,51290,51,22,70,8,105,47,160,92
17957,Hermonville,51291,51,148,446,84,482,310,876,594
17958,Herpont,51292,51,20,17,8,41,17,66,37
17959,Heutrégiville,51293,51,35,90,25,120,125,270,125
17960,Hourges,51294,51,12,17,0,16,26,42,29
17961,Huiron,51295,51,33,62,3,130,38,171,95
17962,Humbauville,51296,51,10,15,5,30,10,45,25
17963,Igny-Comblizy,51298,51,13,88,40,131,57,228,101
17964,Isles-sur-Suippe,51299,51,44,234,56,285,202,543,278
17965,Isle-sur-Marne,51300,51,16,20,10,19,15,44,36
17966,Isse,51301,51,8,36,0,44,28,72,44
17967,Les Istres-et-Bury,51302,51,15,15,15,40,5,60,30
17968,Jâlons,51303,51,48,146,53,161,129,343,194
17969,Janvilliers,51304,51,8,56,16,68,28,112,64
17970,Janvry,51305,51,16,36,16,44,28,88,52
17971,Joiselle,51306,51,0,28,4,44,16,64,28
17972,Jonchery-sur-Suippe,51307,51,20,72,16,56,52,124,92
17973,Jonchery-sur-Vesle,51308,51,189,460,100,815,270,1185,649
17974,Jonquery,51309,51,12,44,4,28,24,56,56
17975,Jouy-lès-Reims,51310,51,12,48,4,84,34,122,60
17976,Jussecourt-Minecourt,51311,51,64,52,4,56,40,100,116
17977,Juvigny,51312,51,94,240,55,330,215,600,334
17978,Lachy,51313,51,43,76,0,111,42,153,119
17979,Lagery,51314,51,4,60,16,48,60,124,64
17980,Landricourt,51315,51,20,44,20,36,32,88,64
17981,Larzicourt,51316,51,32,48,3,127,39,169,80
17982,Laval-sur-Tourbe,51317,51,0,5,5,25,5,35,5
17983,Lavannes,51318,51,36,188,40,216,136,392,224
17984,Lenharrée,51319,51,10,20,10,40,15,65,30
17985,Leuvrigny,51320,51,75,100,45,105,45,195,175
17986,Lhéry,51321,51,0,12,8,25,24,57,12
17987,Lignon,51322,51,12,31,8,28,22,58,43
17988,Linthelles,51323,51,28,32,4,16,24,44,60
17989,Linthes,51324,51,10,15,10,60,10,80,25
17990,Lisse-en-Champagne,51325,51,15,40,0,40,30,70,55
17991,Livry-Louvercy,51326,51,44,400,76,248,348,672,444
17992,Loisy-en-Brie,51327,51,25,30,40,80,5,125,55
17993,Loisy-sur-Marne,51328,51,100,236,60,380,228,668,336
17994,Loivre,51329,51,89,309,97,486,217,800,398
17995,Ludes,51333,51,80,159,34,207,106,347,239
17996,Luxémont-et-Villotte,51334,51,47,88,8,179,65,252,135
17997,Maffrécourt,51336,51,25,20,0,0,25,25,45
17998,Magneux,51337,51,5,85,25,99,65,189,90
17999,Mailly-Champagne,51338,51,60,140,70,285,112,467,200
18000,Mairy-sur-Marne,51339,51,45,145,30,235,100,365,190
18001,Maisons-en-Champagne,51340,51,55,130,45,145,120,310,185
18002,Malmy,51341,51,0,8,8,20,4,32,8
18003,Mancy,51342,51,55,50,20,95,35,150,105
18004,Marcilly-sur-Seine,51343,51,130,116,40,232,63,335,246
18005,Mardeuil,51344,51,242,321,146,631,206,983,563
18006,Mareuil-en-Brie,51345,51,24,68,4,84,68,156,92
18007,Mareuil-le-Port,51346,51,147,245,96,413,205,714,392
18008,Marfaux,51348,51,17,30,7,36,26,69,47
18009,Margerie-Hancourt,51349,51,28,36,16,96,24,136,64
18010,Margny,51350,51,3,26,9,36,22,67,29
18011,Marigny,51351,51,24,15,10,50,5,65,39
18012,Marolles,51352,51,45,251,60,351,160,571,296
18013,Marsangis,51353,51,10,5,5,10,10,25,15
18014,Marson,51354,51,29,67,22,74,73,169,96
18015,Massiges,51355,51,15,15,0,15,5,20,30
18016,Matignicourt-Goncourt,51356,51,0,20,12,72,32,116,20
18017,Matougues,51357,51,85,130,40,260,105,405,215
18018,Maurupt-le-Montois,51358,51,88,136,52,164,112,328,224
18019,Mécringes,51359,51,28,48,12,44,60,116,76
18020,Le Meix-Saint-Epoing,51360,51,16,48,12,140,32,184,64
18021,Le Meix-Tiercelin,51361,51,5,20,25,45,10,80,25
18022,Merfy,51362,51,64,160,36,256,104,396,224
18023,Merlaut,51363,51,30,50,55,80,40,175,80
18024,Méry-Prémecy,51364,51,0,8,12,29,0,41,8
18025,Les Mesneux,51365,51,85,203,45,337,140,522,288
18026,Le Mesnil-sur-Oger,51367,51,160,295,105,320,225,650,455
18027,Minaucourt-le-Mesnil-lès-Hurlus,51368,51,3,9,3,10,12,25,12
18028,Moeurs-Verdey,51369,51,40,90,10,125,55,190,130
18029,Moiremont,51370,51,8,48,12,92,48,152,56
18030,Moivre,51371,51,0,17,0,24,4,28,17
18031,Moncetz-Longevas,51372,51,34,106,44,210,96,350,140
18032,Moncetz-l'Abbaye,51373,51,17,6,3,33,9,45,23
18033,Mondement-Montgivroux,51374,51,8,8,0,20,8,28,16
18034,Montbré,51375,51,45,60,15,120,20,155,105
18035,Montgenost,51376,51,35,35,20,40,35,95,70
18036,Montépreux,51377,51,4,4,8,20,4,32,8
18037,Monthelon,51378,51,60,85,35,90,85,210,145
18038,Montigny-sur-Vesle,51379,51,44,138,34,144,97,275,182
18039,Montmirail,51380,51,569,844,373,1057,594,2024,1413
18040,Montmort-Lucy,51381,51,102,149,39,155,109,303,251
18041,Mont-sur-Courville,51382,51,8,60,20,24,32,76,68
18042,Morangis,51384,51,12,94,25,117,77,219,106
18043,Morsains,51386,51,4,29,4,50,25,79,33
18044,Moslins,51387,51,24,72,16,128,76,220,96
18045,Mourmelon-le-Grand,51388,51,361,1469,586,916,1159,2661,1830
18046,Mourmelon-le-Petit,51389,51,62,205,92,231,135,458,267
18047,Moussy,51390,51,118,132,60,266,77,403,250
18048,Muizon,51391,51,283,535,130,849,319,1298,818
18049,Mutigny,51392,51,9,59,9,62,40,111,68
18050,Nanteuil-la-Forêt,51393,51,24,72,12,76,52,140,96
18051,Nesle-la-Reposte,51395,51,12,0,9,55,0,64,12
18052,Nesle-le-Repons,51396,51,23,29,13,33,27,73,52
18053,La Neuville-aux-Bois,51397,51,26,15,9,44,21,74,41
18054,La Neuville-aux-Larris,51398,51,23,34,23,63,30,116,57
18055,La Neuville-au-Pont,51399,51,64,156,44,156,132,332,220
18056,Neuvy,51402,51,36,68,16,64,52,132,104
18057,Nogent-l'Abbesse,51403,51,80,119,40,197,128,365,199
18058,Noirlieu,51404,51,20,15,5,40,15,60,35
18059,Norrois,51406,51,19,20,25,36,19,80,39
18060,La Noue,51407,51,53,128,8,82,76,166,181
18061,Nuisement-sur-Coole,51409,51,28,92,20,132,64,216,120
18062,Oeuilly,51410,51,65,83,45,211,86,342,148
18063,Oger,51411,51,72,124,52,212,124,388,196
18064,Ognes,51412,51,20,16,8,20,8,36,36
18065,Oiry,51413,51,60,155,65,382,126,573,215
18066,Olizy,51414,51,5,45,20,70,30,120,50
18067,Omey,51415,51,32,52,24,80,44,148,84
18068,Orbais-l'Abbaye,51416,51,104,152,36,204,92,332,256
18069,Orconte,51417,51,42,73,73,144,57,274,115
18070,Ormes,51418,51,27,96,16,184,74,274,123
18071,Outines,51419,51,35,25,5,35,30,70,60
18072,Outrepont,51420,51,40,15,5,20,5,30,55
18073,Oyes,51421,51,6,14,0,29,12,41,20
18074,Pargny-lès-Reims,51422,51,30,130,15,160,110,285,160
18075,Pargny-sur-Saulx,51423,51,255,471,185,691,320,1196,726
18076,Passavant-en-Argonne,51424,51,36,44,12,84,32,128,80
18077,Passy-Grigny,51425,51,59,85,25,160,60,245,144
18078,Péas,51426,51,12,16,8,28,12,48,28
18079,Les Petites-Loges,51428,51,21,151,4,131,120,255,172
18080,Pévy,51429,51,24,56,16,88,44,148,80
18081,Pierre-Morains,51430,51,28,24,4,24,16,44,52
18082,Pierry,51431,51,154,225,65,524,154,743,379
18083,Pleurs,51432,51,115,223,47,279,150,476,338
18084,Plichancourt,51433,51,15,60,25,80,50,155,75
18085,Plivot,51434,51,68,212,36,260,164,460,280
18086,Pocancy,51435,51,16,32,20,72,20,112,48
18087,Pogny,51436,51,68,271,48,301,217,566,339
18088,Poilly,51437,51,0,21,8,28,25,61,21
18089,Poix,51438,51,5,20,10,25,15,50,25
18090,Pomacle,51439,51,44,111,24,130,78,232,155
18091,Pontfaverger-Moronvilliers,51440,51,171,475,193,450,363,1006,646
18092,Ponthion,51441,51,6,20,16,52,6,74,26
18093,Possesse,51442,51,25,55,15,55,35,105,80
18094,Potangis,51443,51,20,17,8,29,12,49,37
18095,Pouillon,51444,51,36,104,52,156,76,284,140
18096,Pourcy,51445,51,28,36,8,57,28,93,64
18097,Pringy,51446,51,50,103,90,119,45,254,153
18098,Prosnes,51447,51,40,156,20,210,85,315,196
18099,Prouilly,51448,51,70,120,45,210,90,345,190
18100,Prunay,51449,51,90,285,110,320,215,645,375
18101,Puisieulx,51450,51,28,112,36,116,100,252,140
18102,Queudes,51451,51,8,26,0,16,25,41,34
18103,Rapsécourt,51452,51,0,10,0,15,10,25,10
18104,Recy,51453,51,104,296,52,388,212,652,400
18105,Reims,51454,51,17556,44467,34855,46841,33861,115557,62023
18106,Reims-la-Brûlée,51455,51,6,57,17,82,49,148,63
18107,Remicourt,51456,51,20,0,5,15,10,30,20
18108,Reuil,51457,51,24,49,23,87,55,165,73
18109,Reuves,51458,51,35,10,0,10,0,10,45
18110,Réveillon,51459,51,15,25,5,35,20,60,40
18111,Rieux,51460,51,30,75,25,60,20,105,105
18112,Rilly-la-Montagne,51461,51,102,246,85,358,158,601,348
18113,Les Rivières-Henruel,51463,51,20,45,15,65,25,105,65
18114,Romain,51464,51,40,100,24,120,52,196,140
18115,Romery,51465,51,20,35,5,65,30,100,55
18116,Romigny,51466,51,40,50,25,50,40,115,90
18117,Rosnay,51468,51,16,108,24,108,76,208,124
18118,Rouffy,51469,51,15,25,25,20,35,80,40
18119,Rouvroy-Ripont,51470,51,0,15,0,5,5,10,15
18120,Sacy,51471,51,40,88,20,176,52,248,128
18121,Saint-Amand-sur-Fion,51472,51,120,300,85,317,203,605,420
18122,Saint-Bon,51473,51,8,18,0,33,20,53,26
18123,Saint-Brice-Courcelles,51474,51,365,920,220,1300,565,2085,1285
18124,Saint-Chéron,51475,51,15,10,0,15,15,30,25
18125,Saint-Étienne-au-Temple,51476,51,57,239,46,229,209,484,296
18126,Saint-Étienne-sur-Suippe,51477,51,12,88,12,100,72,184,100
18127,Saint-Eulien,51478,51,27,146,34,116,82,232,173
18128,Saint-Euphraise-et-Clairizet,51479,51,16,53,4,84,43,131,69
18129,Sainte-Gemme,51480,51,25,35,10,40,20,70,60
18130,Saint-Germain-la-Ville,51482,51,48,172,28,136,140,304,220
18131,Saint-Gibrien,51483,51,9,134,33,177,96,306,143
18132,Saint-Gilles,51484,51,8,87,35,90,43,168,95
18133,Saint-Hilaire-au-Temple,51485,51,34,121,39,81,58,178,155
18134,Saint-Hilaire-le-Grand,51486,51,36,81,22,87,57,166,117
18135,Saint-Hilaire-le-Petit,51487,51,44,81,16,89,86,191,125
18136,Saint-Imoges,51488,51,0,96,8,94,86,188,96
18137,Saint-Jean-devant-Possesse,51489,51,10,5,0,15,0,15,15
18138,Saint-Jean-sur-Moivre,51490,51,20,55,10,80,45,135,75
18139,Saint-Jean-sur-Tourbe,51491,51,12,16,8,52,4,64,28
18140,Saint-Just-Sauvage,51492,51,256,296,113,516,215,844,552
18141,Saint-Léonard,51493,51,0,37,12,24,37,73,37
18142,Saint-Loup,51495,51,0,28,0,25,16,41,28
18143,Saint-Lumier-en-Champagne,51496,51,25,80,10,55,95,160,105
18144,Saint-Lumier-la-Populeuse,51497,51,9,9,8,0,8,16,18
18145,Saint-Mard-sur-Auve,51498,51,4,24,4,32,12,48,28
18146,Saint-Mard-lès-Rouffy,51499,51,10,45,15,60,25,100,55
18147,Saint-Mard-sur-le-Mont,51500,51,0,50,15,45,25,85,50
18148,Sainte-Marie-à-Py,51501,51,30,31,16,41,41,98,61
18149,Saint-Martin-aux-Champs,51502,51,4,32,8,32,24,64,36
18150,Saint-Martin-l'Heureux,51503,51,0,12,9,38,6,53,12
18151,Saint-Martin-sur-le-Pré,51504,51,172,105,45,247,115,407,277
18152,Saint-Masmes,51505,51,40,80,45,205,70,320,120
18153,Saint-Memmie,51506,51,742,1340,705,1732,989,3426,2082
18154,Sainte-Menehould,51507,51,699,871,305,1355,662,2322,1570
18155,Saint-Ouen-Domprot,51508,51,33,34,12,80,12,104,67
18156,Saint-Pierre,51509,51,20,92,20,108,56,184,112
18157,Saint-Quentin-les-Marais,51510,51,4,36,0,39,41,80,40
18158,Saint-Quentin-le-Verger,51511,51,8,30,4,36,36,76,38
18159,Saint-Quentin-sur-Coole,51512,51,8,30,16,8,21,45,38
18160,Saint-Remy-en-Bouzemont-Saint-Genest-et-Isson,51513,51,65,130,15,205,130,350,195
18161,Saint-Remy-sous-Broyes,51514,51,15,30,15,15,25,55,45
18162,Saint-Remy-sur-Bussy,51515,51,32,120,8,100,64,172,152
18163,Saint-Saturnin,51516,51,5,5,5,25,10,40,10
18164,Saint-Souplet-sur-Py,51517,51,21,26,6,27,28,61,47
18165,Saint-Thierry,51518,51,88,180,44,180,108,332,268
18166,Saint-Thomas-en-Argonne,51519,51,13,6,9,3,3,15,19
18167,Saint-Utin,51520,51,8,20,12,32,20,64,28
18168,Saint-Vrain,51521,51,27,67,34,57,26,117,94
18169,Sapignicourt,51522,51,48,100,40,100,76,216,148
18170,Sarcy,51523,51,21,51,29,60,43,132,72
18171,Saron-sur-Aube,51524,51,37,48,30,111,35,176,85
18172,Sarry,51525,51,200,488,105,931,318,1354,688
18173,Saudoy,51526,51,40,50,35,160,70,265,90
18174,Savigny-sur-Ardres,51527,51,44,56,4,92,48,144,100
18175,Scrupt,51528,51,9,31,6,40,22,68,40
18176,Selles,51529,51,12,121,49,135,48,232,133
18177,Sept-Saulx,51530,51,40,172,72,164,136,372,212
18178,Sermaize-les-Bains,51531,51,333,470,144,696,302,1142,803
18179,Sermiers,51532,51,67,115,27,166,100,293,182
18180,Servon-Melzicourt,51533,51,10,35,10,40,15,65,45
18181,Serzy-et-Prin,51534,51,15,46,6,43,38,87,61
18182,Sézanne,51535,51,707,995,525,1695,823,3043,1702
18183,Sillery,51536,51,164,450,146,655,316,1117,614
18184,Sivry-Ante,51537,51,20,45,20,70,40,130,65
18185,Sogny-aux-Moulins,51538,51,9,19,10,39,16,65,28
18186,Sogny-en-l'Angle,51539,51,4,12,24,12,16,52,16
18187,Soizy-aux-Bois,51542,51,17,59,16,24,43,83,76
18188,Somme-Bionne,51543,51,25,20,5,20,10,35,45
18189,Sommepy-Tahure,51544,51,71,176,49,117,146,312,247
18190,Sommesous,51545,51,70,135,55,150,115,320,205
18191,Somme-Suippe,51546,51,41,126,13,86,111,210,167
18192,Somme-Tourbe,51547,51,25,35,20,35,35,90,60
18193,Somme-Vesle,51548,51,20,110,25,80,105,210,130
18194,Somme-Yèvre,51549,51,9,19,6,24,30,60,28
18195,Sompuis,51550,51,45,50,25,130,35,190,95
18196,Somsois,51551,51,44,36,12,88,16,116,80
18197,Songy,51552,51,34,55,20,85,37,142,89
18198,Souain-Perthes-lès-Hurlus,51553,51,44,80,44,20,48,112,124
18199,Soudé,51555,51,22,36,8,25,56,89,58
18200,Soudron,51556,51,30,90,30,75,85,190,120
18201,Soulanges,51557,51,64,116,44,148,100,292,180
18202,Soulières,51558,51,35,30,15,25,20,60,65
18203,Suippes,51559,51,231,957,425,741,798,1964,1188
18204,Suizy-le-Franc,51560,51,12,24,12,48,4,64,36
18205,Taissy,51562,51,304,500,200,860,365,1425,804
18206,Talus-Saint-Prix,51563,51,8,40,8,25,26,59,48
18207,Val de Livre,51564,51,51,183,50,143,166,359,234
18208,Thaas,51565,51,20,35,10,30,25,65,55
18209,Thibie,51566,51,48,64,24,96,60,180,112
18210,Thiéblemont-Farémont,51567,51,28,124,32,148,108,288,152
18211,Thil,51568,51,32,61,8,85,63,156,93
18212,Thillois,51569,51,35,120,20,95,60,175,155
18213,Le Thoult-Trosnay,51570,51,3,16,6,37,18,61,19
18214,Val-de-Vesle,51571,51,60,271,76,285,214,575,331
18215,Tilloy-et-Bellay,51572,51,15,65,15,80,40,135,80
18216,Tinqueux,51573,51,1590,2216,977,3563,1619,6159,3806
18217,Togny-aux-Boeufs,51574,51,20,25,4,47,25,76,45
18218,Tours-sur-Marne,51576,51,156,352,120,456,268,844,508
18219,Tramery,51577,51,13,39,6,41,23,70,52
18220,Trécon,51578,51,16,12,0,24,16,40,28
18221,Tréfols,51579,51,28,36,20,40,40,100,64
18222,Trépail,51580,51,64,80,52,152,68,272,144
18223,Treslon,51581,51,38,65,10,75,40,125,103
18224,Trigny,51582,51,45,130,17,221,89,327,175
18225,Trois-Fontaines-l'Abbaye,51583,51,10,35,15,95,40,150,45
18226,Trois-Puits,51584,51,32,44,8,52,28,88,76
18227,Troissy,51585,51,88,212,96,268,212,576,300
18228,Unchair,51586,51,16,30,8,52,22,82,46
18229,Vadenay,51587,51,30,70,10,90,40,140,100
18230,Valmy,51588,51,35,75,5,110,65,180,110
18231,Vanault-le-Châtel,51589,51,17,42,13,45,36,94,59
18232,Vanault-les-Dames,51590,51,50,95,45,105,85,235,145
18233,Vandeuil,51591,51,20,72,12,84,32,128,92
18234,Vandières,51592,51,45,70,5,125,55,185,115
18235,Vassimont-et-Chapelaine,51594,51,8,4,4,20,4,28,12
18236,Vatry,51595,51,4,36,12,32,36,80,40
18237,Vauchamps,51596,51,60,105,20,110,80,210,165
18238,Vauciennes,51597,51,32,68,12,124,76,212,100
18239,Vauclerc,51598,51,30,110,50,240,75,365,140
18240,Vaudemange,51599,51,35,90,60,40,65,165,125
18241,Vaudesincourt,51600,51,3,20,9,28,13,50,23
18242,Vavray-le-Grand,51601,51,32,44,8,60,32,100,76
18243,Vavray-le-Petit,51602,51,15,5,5,25,0,30,20
18244,Vélye,51603,51,8,52,24,52,36,112,60
18245,Ventelay,51604,51,25,60,12,79,53,144,85
18246,Venteuil,51605,51,119,119,19,143,95,257,238
18247,Verdon,51607,51,10,35,10,80,50,140,45
18248,Vernancourt,51608,51,20,8,24,20,8,52,28
18249,Verneuil,51609,51,112,151,98,270,130,498,263
18250,Verrières,51610,51,68,96,28,152,84,264,164
18251,Vert-Toulon,51611,51,52,52,40,100,48,188,104
18252,Vertus,51612,51,330,515,160,817,384,1361,845
18253,Verzenay,51613,51,137,228,73,245,189,507,365
18254,Verzy,51614,51,70,281,69,374,185,628,351
18255,Vésigneul-sur-Marne,51616,51,15,68,3,50,81,134,83
18256,La Veuve,51617,51,90,165,60,225,95,380,255
18257,Le Vézier,51618,51,9,56,27,43,30,100,65
18258,Le Vieil-Dampierre,51619,51,24,36,0,36,24,60,60
18259,Vienne-la-Ville,51620,51,36,21,0,70,12,82,57
18260,Vienne-le-Château,51621,51,95,90,50,125,85,260,185
18261,Ville-Dommange,51622,51,80,86,17,97,68,182,166
18262,Ville-en-Selve,51623,51,26,53,16,112,12,140,79
18263,Ville-en-Tardenois,51624,51,30,214,75,224,115,414,244
18264,Villeneuve-la-Lionne,51625,51,40,72,8,108,72,188,112
18265,La Villeneuve-lès-Charleville,51626,51,15,25,5,45,10,60,40
18266,Villeneuve-Renneville-Chevigny,51627,51,35,75,5,110,90,205,110
18267,Villeneuve-Saint-Vistre-et-Villevotte,51628,51,4,35,0,49,20,69,39
18268,Villers-Allerand,51629,51,90,205,50,260,160,470,295
18269,Villers-aux-Bois,51630,51,20,86,40,58,92,190,106
18270,Villers-aux-Noeuds,51631,51,8,54,8,72,17,97,62
18271,Villers-en-Argonne,51632,51,20,50,5,130,25,160,70
18272,Villers-Franqueux,51633,51,30,53,32,120,31,183,83
18273,Villers-le-Château,51634,51,24,36,20,124,28,172,60
18274,Villers-le-Sec,51635,51,10,25,5,50,25,80,35
18275,Villers-Marmery,51636,51,70,123,55,250,63,368,193
18276,Villers-sous-Châtillon,51637,51,10,85,15,60,75,150,95
18277,Villeseneux,51638,51,32,76,20,44,52,116,108
18278,La Ville-sous-Orbais,51639,51,10,5,15,29,5,49,15
18279,Ville-sur-Tourbe,51640,51,16,72,12,77,69,158,88
18280,Villevenard,51641,51,25,35,21,80,25,126,60
18281,Villiers-aux-Corneilles,51642,51,5,25,0,45,20,65,30
18282,Vinay,51643,51,85,134,24,216,133,373,219
18283,Vincelles,51644,51,35,56,30,127,52,209,91
18284,Vindey,51645,51,12,28,8,64,20,92,40
18285,Virginy,51646,51,10,28,10,30,23,63,38
18286,Vitry-en-Perthois,51647,51,82,173,54,337,146,537,255
18287,Vitry-la-Ville,51648,51,22,107,16,137,59,212,129
18288,Vitry-le-François,51649,51,1796,3195,1419,4230,2124,7773,4991
18289,Voilemont,51650,51,15,5,0,20,0,20,20
18290,Voipreux,51651,51,9,43,12,75,44,131,52
18291,Vouarces,51652,51,20,4,12,20,20,52,24
18292,Vouillers,51654,51,8,66,21,66,51,138,74
18293,Vouzy,51655,51,12,76,0,107,71,178,88
18294,Vraux,51656,51,75,115,20,135,115,270,190
18295,Vrigny,51657,51,24,56,12,72,44,128,80
18296,Vroil,51658,51,15,15,5,40,25,70,30
18297,Wargemoulin-Hurlus,51659,51,9,15,3,3,9,15,24
18298,Warmeriville,51660,51,180,657,245,738,523,1506,837
18299,Witry-lès-Reims,51662,51,358,1312,419,1778,966,3163,1670
18300,Magenta,51663,51,226,301,214,559,306,1079,527
18301,Ageville,52001,52,44,80,16,68,88,172,124
18302,Aigremont,52002,52,0,0,0,15,0,15,0
18303,Aillianville,52003,52,45,40,20,55,20,95,85
18304,Aingoulaincourt,52004,52,0,8,0,16,0,16,8
18305,Aizanville,52005,52,7,3,0,15,0,15,10
18306,Allichamps,52006,52,45,60,20,114,105,239,105
18307,Ambonville,52007,52,12,16,8,20,12,40,28
18308,Andelot-Blancheville,52008,52,123,153,83,289,105,477,276
18309,Andilly-en-Bassigny,52009,52,25,16,6,24,19,49,41
18310,Annéville-la-Prairie,52011,52,4,4,4,40,12,56,8
18311,Annonville,52012,52,8,0,0,0,8,8,8
18312,Anrosey,52013,52,30,20,10,66,0,76,50
18313,Aprey,52014,52,24,44,12,76,40,128,68
18314,Arbigny-sous-Varennes,52015,52,36,28,0,20,24,44,64
18315,Arbot,52016,52,16,12,0,28,12,40,28
18316,Arc-en-Barrois,52017,52,144,168,76,212,120,408,312
18317,Arnancourt,52019,52,9,12,10,35,9,54,21
18318,Attancourt,52021,52,21,36,15,77,46,138,57
18319,Aubepierre-sur-Aube,52022,52,45,55,5,50,35,90,100
18320,Auberive,52023,52,12,48,28,84,16,128,60
18321,Audeloncourt,52025,52,16,18,0,31,14,45,34
18322,Aujeurres,52027,52,0,15,0,40,20,60,15
18323,Aulnoy-sur-Aube,52028,52,5,15,10,20,10,40,20
18324,Autigny-le-Grand,52029,52,35,20,5,95,10,110,55
18325,Autigny-le-Petit,52030,52,17,8,0,29,0,29,25
18326,Autreville-sur-la-Renne,52031,52,56,88,16,144,80,240,144
18327,Avrecourt,52033,52,19,10,6,49,12,67,29
18328,Bailly-aux-Forges,52034,52,8,40,8,48,24,80,48
18329,Baissey,52035,52,52,26,3,48,31,82,78
18330,Bannes,52037,52,40,105,25,170,65,260,145
18331,Bassoncourt,52038,52,20,8,8,28,4,40,28
18332,Baudrecourt,52039,52,15,22,0,21,18,39,37
18333,Bay-sur-Aube,52040,52,8,8,8,16,8,32,16
18334,Beauchemin,52042,52,16,29,4,20,16,40,45
18335,Belmont,52043,52,4,20,12,16,4,32,24
18336,Roches-Bettaincourt,52044,52,70,156,30,216,115,361,226
18337,Bettancourt-la-Ferrée,52045,52,440,270,95,675,215,985,710
18338,Beurville,52047,52,20,20,10,35,15,60,40
18339,Biesles,52050,52,192,348,88,472,264,824,540
18340,Bize,52051,52,4,17,4,16,4,24,21
18341,Blaisy,52053,52,0,10,0,35,15,50,10
18342,Blécourt,52055,52,13,16,9,34,12,55,29
18343,Blessonville,52056,52,25,51,0,72,46,118,76
18344,Blumeray,52057,52,12,12,4,55,0,59,24
18345,Bologne,52058,52,234,395,180,715,291,1186,629
18346,Bonnecourt,52059,52,36,40,0,36,24,60,76
18347,Bourbonne-les-Bains,52060,52,435,285,198,784,220,1202,720
18348,Bourdons-sur-Rognon,52061,52,28,36,28,112,48,188,64
18349,Bourg,52062,52,12,30,6,69,13,88,42
18350,Bourg-Sainte-Marie,52063,52,4,9,4,63,12,79,13
18351,Bourmont,52064,52,50,115,55,155,65,275,165
18352,Bouzancourt,52065,52,5,15,25,15,10,50,20
18353,Brachay,52066,52,12,12,0,8,20,28,24
18354,Brainville-sur-Meuse,52067,52,9,6,3,37,9,49,15
18355,Braux-le-Châtel,52069,52,12,40,4,24,44,72,52
18356,Brennes,52070,52,16,36,12,56,24,92,52
18357,Brethenay,52072,52,72,80,12,136,56,204,152
18358,Breuvannes-en-Bassigny,52074,52,114,98,55,216,87,358,212
18359,Briaucourt,52075,52,16,56,12,80,44,136,72
18360,Bricon,52076,52,20,115,30,190,85,305,135
18361,Brousseval,52079,52,125,165,45,255,105,405,290
18362,Bugnières,52082,52,30,35,15,35,35,85,65
18363,Champsevraine,52083,52,135,150,75,290,95,460,285
18364,Busson,52084,52,0,10,0,10,15,25,10
18365,Buxières-lès-Clefmont,52085,52,0,20,0,15,10,25,20
18366,Buxières-lès-Villiers,52087,52,6,31,12,77,20,109,37
18367,Ceffonds,52088,52,80,165,40,240,100,380,245
18368,Celles-en-Bassigny,52089,52,10,15,15,5,25,45,25
18369,Celsoy,52090,52,16,32,4,36,32,72,48
18370,Cerisières,52091,52,10,25,5,40,10,55,35
18371,Chalancey,52092,52,13,26,6,36,10,52,39
18372,Chalindrey,52093,52,430,505,175,1005,335,1515,935
18373,Vals-des-Tilles,52094,52,24,40,10,65,30,105,64
18374,Chalvraines,52095,52,70,15,15,65,15,95,85
18375,Chambroncourt,52097,52,12,8,0,12,12,24,20
18376,Chamouilley,52099,52,100,196,95,285,135,515,296
18377,Champigneulles-en-Bassigny,52101,52,20,15,0,5,15,20,35
18378,Champigny-lès-Langres,52102,52,50,74,38,160,33,231,124
18379,Champigny-sous-Varennes,52103,52,30,40,20,15,25,60,70
18380,Chancenay,52104,52,197,216,110,399,119,628,413
18381,Changey,52105,52,43,57,4,105,44,153,100
18382,Chanoy,52106,52,16,48,4,40,44,88,64
18383,Chantraines,52107,52,40,80,20,60,55,135,120
18384,Charmes,52108,52,5,40,50,20,50,120,45
18385,Charmes-en-l'Angle,52109,52,0,0,0,8,0,8,0
18386,Charmes-la-Grande,52110,52,25,35,20,75,5,100,60
18387,Chassigny,52113,52,48,39,16,61,34,111,87
18388,Châteauvillain,52114,52,202,343,151,486,287,924,545
18389,Chatenay-Mâcheron,52115,52,12,20,4,48,20,72,32
18390,Chatenay-Vaudin,52116,52,0,20,0,20,15,35,20
18391,Chatonrupt-Sommermont,52118,52,30,70,35,90,80,205,100
18392,Chaudenay,52119,52,36,87,33,74,67,174,123
18393,Chauffourt,52120,52,17,49,12,73,42,127,66
18394,Chaumont,52121,52,3281,4380,2637,7526,3574,13737,7661
18395,Chaumont-la-Ville,52122,52,29,16,12,18,13,43,45
18396,Chevillon,52123,52,154,322,122,410,294,826,476
18397,Chézeaux,52124,52,45,0,0,25,0,25,45
18398,Chamarandes-Choignes,52125,52,112,203,52,371,162,585,315
18399,Choilley-Dardenay,52126,52,17,35,6,34,43,83,52
18400,Choiseul,52127,52,25,10,10,25,10,45,35
18401,Cirey-lès-Mareilles,52128,52,16,32,28,32,20,80,48
18402,Cirey-sur-Blaise,52129,52,25,25,0,28,16,44,50
18403,Cirfontaines-en-Azois,52130,52,13,30,30,74,16,120,43
18404,Cirfontaines-en-Ornois,52131,52,12,34,4,20,8,32,46
18405,Clefmont,52132,52,15,30,26,85,15,126,45
18406,Clinchamp,52133,52,30,10,5,40,0,45,40
18407,Cohons,52134,52,50,45,5,90,40,135,95
18408,Coiffy-le-Bas,52135,52,35,20,0,20,20,40,55
18409,Coiffy-le-Haut,52136,52,28,16,16,28,20,64,44
18410,Colmier-le-Bas,52137,52,8,0,0,12,0,12,8
18411,Colmier-le-Haut,52138,52,9,9,7,18,3,28,18
18412,Colombey-les-Deux-Églises,52140,52,155,175,35,170,130,335,330
18413,Condes,52141,52,60,56,32,116,36,184,116
18414,Consigny,52142,52,15,10,9,12,12,33,25
18415,Coublanc,52145,52,22,19,9,16,22,47,41
18416,Coupray,52146,52,35,30,40,25,20,85,65
18417,Courcelles-en-Montagne,52147,52,25,10,0,30,20,50,35
18418,Courcelles-sur-Blaise,52149,52,10,25,0,35,25,60,35
18419,Cour-l'Évêque,52151,52,23,36,10,31,42,83,59
18420,Culmont,52155,52,85,105,25,235,90,350,190
18421,Curel,52156,52,60,80,35,175,55,265,140
18422,Curmont,52157,52,6,0,0,0,0,0,6
18423,Cusey,52158,52,32,60,32,100,52,184,92
18424,Cuves,52159,52,0,7,0,12,3,15,7
18425,Daillancourt,52160,52,6,6,6,42,12,60,12
18426,Daillecourt,52161,52,20,10,0,36,15,51,30
18427,Dammartin-sur-Meuse,52162,52,12,33,16,61,40,117,45
18428,Dampierre,52163,52,37,90,16,125,60,201,127
18429,Damrémont,52164,52,44,56,12,80,36,128,100
18430,Dancevoir,52165,52,45,25,15,75,35,125,70
18431,Darmannes,52167,52,32,72,20,60,76,156,104
18432,Dinteville,52168,52,10,10,0,15,10,25,20
18433,Domblain,52169,52,9,24,3,15,25,43,33
18434,Dommarien,52170,52,50,40,9,45,30,84,90
18435,Dommartin-le-Franc,52171,52,45,58,17,60,37,114,103
18436,Dommartin-le-Saint-Père,52172,52,57,59,10,62,46,118,116
18437,Domremy-Landéville,52173,52,10,20,0,45,5,50,30
18438,Doncourt-sur-Meuse,52174,52,15,9,3,3,9,15,24
18439,Donjeux,52175,52,33,83,9,90,65,164,116
18440,Doulaincourt-Saucourt,52177,52,132,135,53,250,117,420,267
18441,Doulevant-le-Château,52178,52,66,80,25,125,65,215,146
18442,Doulevant-le-Petit,52179,52,5,0,0,20,0,20,5
18443,Échenay,52181,52,12,22,0,28,22,50,34
18444,Éclaron-Braucourt-Sainte-Livière,52182,52,296,544,236,532,472,1240,840
18445,Ecot-la-Combe,52183,52,6,0,9,9,3,21,6
18446,Effincourt,52184,52,0,20,10,30,10,50,20
18447,Enfonvelle,52185,52,35,10,5,10,10,25,45
18448,Épizon,52187,52,33,34,0,62,20,82,67
18449,Le Val-d'Esnoms,52189,52,67,73,30,83,58,171,140
18450,Esnouveaux,52190,52,51,67,30,107,40,177,118
18451,Euffigneix,52193,52,32,84,16,136,60,212,116
18452,Eurville-Bienville,52194,52,266,465,254,666,422,1342,731
18453,Farincourt,52195,52,15,15,0,19,10,29,30
18454,Faverolles,52196,52,10,15,20,50,10,80,25
18455,Fayl-Billot,52197,52,220,227,105,481,180,766,447
18456,Fays,52198,52,10,25,10,30,15,55,35
18457,Ferrière-et-Lafolie,52199,52,16,8,0,12,12,24,24
18458,Flagey,52200,52,5,15,5,35,20,60,20
18459,Flammerécourt,52201,52,10,40,0,10,20,30,50
18460,Fontaines-sur-Marne,52203,52,20,50,20,50,25,95,70
18461,Forcey,52204,52,3,12,6,38,6,50,15
18462,Foulain,52205,52,60,137,60,226,131,417,197
18463,Frampas,52206,52,15,35,5,80,30,115,50
18464,Frécourt,52207,52,20,15,25,20,5,50,35
18465,Fresnes-sur-Apance,52208,52,60,15,5,55,20,80,75
18466,Froncles,52211,52,275,327,132,604,218,954,602
18467,Fronville,52212,52,44,76,48,88,72,208,120
18468,Genevrières,52213,52,60,15,10,40,10,60,75
18469,La Genevroye,52214,52,0,8,0,4,12,16,8
18470,Germaines,52216,52,4,4,12,8,4,24,8
18471,Germainvilliers,52217,52,0,38,0,21,32,53,38
18472,Germay,52218,52,10,0,0,25,5,30,10
18473,Germisay,52219,52,4,8,0,16,0,16,12
18474,Giey-sur-Aujon,52220,52,15,15,10,75,15,100,30
18475,Gillancourt,52221,52,25,21,0,34,12,46,46
18476,Gillaumé,52222,52,12,0,6,18,0,24,12
18477,Gilley,52223,52,20,15,0,35,0,35,35
18478,Goncourt,52225,52,38,56,13,86,43,142,94
18479,Graffigny-Chemin,52227,52,38,26,8,76,34,118,64
18480,Grandchamp,52228,52,24,8,0,16,16,32,32
18481,Grenant,52229,52,24,24,16,56,20,92,48
18482,Gudmont-Villiers,52230,52,38,68,35,85,47,167,106
18483,Guindrecourt-aux-Ormes,52231,52,16,24,4,40,12,56,40
18484,Guindrecourt-sur-Blaise,52232,52,20,12,0,0,8,8,32
18485,Guyonvelle,52233,52,23,13,9,23,18,50,36
18486,Hâcourt,52234,52,0,4,4,4,12,20,4
18487,Hallignicourt,52235,52,15,85,20,90,80,190,100
18488,Harréville-les-Chanteurs,52237,52,40,95,15,95,70,180,135
18489,Heuilley-le-Grand,52240,52,25,65,14,79,40,133,90
18490,Haute-Amance,52242,52,111,195,84,293,208,585,306
18491,Huilliécourt,52243,52,30,16,6,31,12,49,46
18492,Humbécourt,52244,52,67,232,70,225,163,458,299
18493,Humberville,52245,52,8,24,12,24,12,48,32
18494,Humes-Jorquenay,52246,52,135,140,45,200,85,330,275
18495,Illoud,52247,52,55,60,35,30,45,110,115
18496,Is-en-Bassigny,52248,52,115,125,45,140,130,315,240
18497,Isômes,52249,52,0,20,15,75,35,125,20
18498,Joinville,52250,52,565,674,347,1100,496,1943,1239
18499,Jonchery,52251,52,80,292,80,332,248,660,372
18500,Juzennecourt,52253,52,3,59,18,61,44,123,62
18501,Lachapelle-en-Blaisy,52254,52,12,6,0,28,9,37,18
18502,Lafauche,52256,52,10,10,0,40,10,50,20
18503,Laferté-sur-Amance,52257,52,20,20,8,48,16,72,40
18504,Laferté-sur-Aube,52258,52,40,69,40,164,35,239,109
18505,Lamancine,52260,52,20,25,5,50,20,75,45
18506,Lamothe-en-Blaisy,52262,52,4,20,8,20,20,48,24
18507,Laneuvelle,52264,52,18,6,3,21,6,30,24
18508,Bayard-sur-Marne,52265,52,132,313,118,468,257,843,445
18509,Laneuville-à-Rémy,52266,52,3,13,3,18,15,36,16
18510,Laneuville-au-Pont,52267,52,25,30,15,85,30,130,55
18511,Langres,52269,52,1156,1556,877,2523,1423,4823,2712
18512,Lanques-sur-Rognon,52271,52,15,40,25,95,30,150,55
18513,Lanty-sur-Aube,52272,52,10,15,10,75,15,100,25
18514,Larivière-Arnoncourt,52273,52,33,6,3,34,16,53,39
18515,Latrecey-Ormoy-sur-Aube,52274,52,45,44,27,85,41,153,89
18516,Lavernoy,52275,52,21,20,0,20,26,46,41
18517,Laville-aux-Bois,52276,52,45,55,20,90,15,125,100
18518,Lavilleneuve,52277,52,16,12,0,32,12,44,28
18519,Lavilleneuve-au-Roi,52278,52,12,9,3,39,9,51,21
18520,Lecey,52280,52,44,40,10,80,45,135,84
18521,Leffonds,52282,52,12,95,55,72,76,203,107
18522,Leschères-sur-le-Blaiseron,52284,52,12,12,13,36,8,57,24
18523,Leuchey,52285,52,0,40,0,10,35,45,40
18524,Leurville,52286,52,6,15,0,32,12,44,21
18525,Levécourt,52287,52,10,41,5,30,20,55,51
18526,Lezéville,52288,52,13,26,12,29,21,62,39
18527,Liffol-le-Petit,52289,52,60,65,10,105,50,165,125
18528,Les Loges,52290,52,29,20,16,24,13,53,49
18529,Longchamp,52291,52,10,15,5,35,5,45,25
18530,Longeau-Percey,52292,52,100,130,60,265,120,445,230
18531,Louvemont,52294,52,95,180,65,270,105,440,275
18532,Louvières,52295,52,28,12,0,44,16,60,40
18533,Luzy-sur-Marne,52297,52,35,60,15,85,70,170,95
18534,Maâtz,52298,52,5,15,0,20,30,50,20
18535,Magneux,52300,52,8,40,16,92,20,128,48
18536,Maisoncelles,52301,52,9,6,6,21,3,30,15
18537,Maizières,52302,52,31,33,12,52,30,94,64
18538,Maizières-sur-Amance,52303,52,10,25,5,40,20,65,35
18539,Malaincourt-sur-Meuse,52304,52,15,0,0,30,5,35,15
18540,Mandres-la-Côte,52305,52,45,138,44,130,106,280,183
18541,Manois,52306,52,110,110,40,145,40,225,220
18542,Marac,52307,52,45,65,10,40,65,115,110
18543,Maranville,52308,52,51,74,35,135,55,225,125
18544,Marbéville,52310,52,10,15,10,30,30,70,25
18545,Marcilly-en-Bassigny,52311,52,16,27,19,101,22,142,43
18546,Mardor,52312,52,5,10,0,25,5,30,15
18547,Mareilles,52313,52,30,35,25,40,40,105,65
18548,Marnay-sur-Marne,52315,52,32,60,28,120,64,212,92
18549,Mathons,52316,52,12,16,12,4,16,32,28
18550,Melay,52318,52,95,35,10,90,20,120,130
18551,Mennouveaux,52319,52,0,8,4,33,4,41,8
18552,Merrey,52320,52,16,9,9,35,15,59,25
18553,Mertrud,52321,52,12,30,6,66,31,103,42
18554,Meures,52322,52,35,25,15,40,15,70,60
18555,Millières,52325,52,15,19,3,25,21,49,34
18556,Mirbel,52326,52,20,0,0,15,0,15,20
18557,Moëslains,52327,52,68,48,67,142,52,261,116
18558,Montcharvot,52328,52,20,4,0,24,0,24,24
18559,Montheries,52330,52,9,15,0,7,15,22,24
18560,La Porte du Der,52331,52,325,476,194,778,336,1308,801
18561,Val-de-Meuse,52332,52,250,366,204,598,333,1135,616
18562,Montot-sur-Rognon,52335,52,29,21,17,32,4,53,50
18563,Montreuil-sur-Blaise,52336,52,25,53,16,16,47,79,78
18564,Montreuil-sur-Thonnance,52337,52,4,16,8,20,12,40,20
18565,Morancourt,52341,52,30,30,15,30,30,75,60
18566,Morionvilliers,52342,52,5,10,5,10,10,25,15
18567,Mouilleron,52344,52,15,15,0,0,10,10,30
18568,Mussey-sur-Marne,52346,52,44,104,40,92,84,216,148
18569,Narcy,52347,52,28,60,24,100,40,164,88
18570,Neuilly-l'Évêque,52348,52,93,137,65,214,77,356,230
18571,Neuilly-sur-Suize,52349,52,65,50,10,135,40,185,115
18572,Neuvelle-lès-Voisey,52350,52,18,21,6,24,6,36,39
18573,Nijon,52351,52,24,12,8,20,8,36,36
18574,Ninville,52352,52,10,35,0,20,25,45,45
18575,Nogent,52353,52,777,690,374,1200,645,2219,1467
18576,Noidant-Chatenoy,52354,52,20,15,0,35,0,35,35
18577,Noidant-le-Rocheux,52355,52,33,22,0,52,29,81,55
18578,Nomécourt,52356,52,12,25,8,16,32,56,37
18579,Noncourt-sur-le-Rongeant,52357,52,10,50,15,65,44,124,60
18580,Noyers,52358,52,8,4,16,38,0,54,12
18581,Nully,52359,52,30,45,35,55,5,95,75
18582,Occey,52360,52,25,30,15,45,30,90,55
18583,Orbigny-au-Mont,52362,52,20,15,5,90,5,100,35
18584,Orbigny-au-Val,52363,52,16,12,4,48,12,64,28
18585,Orcevaux,52364,52,10,15,5,60,15,80,25
18586,Orges,52365,52,51,77,25,71,87,183,128
18587,Ormancey,52366,52,15,20,10,25,20,55,35
18588,Ormoy-lès-Sexfontaines,52367,52,12,4,4,16,0,20,16
18589,Orquevaux,52369,52,19,15,5,25,15,45,34
18590,Osne-le-Val,52370,52,55,25,15,110,40,165,80
18591,Oudincourt,52371,52,23,50,10,30,45,85,73
18592,Outremécourt,52372,52,20,28,16,28,12,56,48
18593,Ozières,52373,52,4,12,0,24,4,28,16
18594,Le Pailly,52374,52,60,60,15,105,55,175,120
18595,Palaiseul,52375,52,5,25,0,15,20,35,30
18596,Pansey,52376,52,6,33,3,15,24,42,39
18597,Parnoy-en-Bassigny,52377,52,60,75,25,75,65,165,135
18598,Paroy-sur-Saulx,52378,52,5,10,0,10,10,20,15
18599,Peigney,52380,52,68,76,20,136,56,212,144
18600,Perrancey-les-Vieux-Moulins,52383,52,44,60,8,132,56,196,104
18601,Perrogney-les-Fontaines,52384,52,32,8,16,32,16,64,40
18602,Perrusse,52385,52,10,0,0,15,5,20,10
18603,Perthes,52386,52,56,140,76,140,100,316,196
18604,Pierremont-sur-Amance,52388,52,30,20,30,45,10,85,50
18605,Pisseloup,52390,52,8,0,4,25,4,33,8
18606,Planrupt,52391,52,40,75,25,110,30,165,115
18607,Plesnoy,52392,52,6,25,6,28,22,56,31
18608,Poinsenot,52393,52,12,0,0,28,0,28,12
18609,Poinson-lès-Fayl,52394,52,30,70,25,55,45,125,100
18610,Poinson-lès-Grancey,52395,52,0,10,0,30,15,45,10
18611,Poinson-lès-Nogent,52396,52,16,36,12,64,32,108,52
18612,Poiseul,52397,52,26,24,0,6,13,19,50
18613,Poissons,52398,52,85,130,87,237,90,414,215
18614,Pont-la-Ville,52399,52,40,26,9,25,19,53,66
18615,Le Châtelet-sur-Meuse,52400,52,20,28,4,72,32,108,48
18616,Poulangy,52401,52,96,80,24,124,80,228,176
18617,Praslay,52403,52,5,10,5,20,20,45,15
18618,Le Montsaugeonnais,52405,52,104,295,115,422,239,776,399
18619,Pressigny,52406,52,40,35,25,84,20,129,75
18620,Prez-sous-Lafauche,52407,52,36,55,22,111,43,176,91
18621,Rives Dervoises,52411,52,173,314,142,422,236,800,487
18622,Rachecourt-Suzémont,52413,52,5,25,0,35,30,65,30
18623,Rachecourt-sur-Marne,52414,52,90,210,65,250,180,495,300
18624,Rançonnières,52415,52,30,15,0,35,25,60,45
18625,Rangecourt,52416,52,12,9,6,19,9,34,21
18626,Rennepont,52419,52,15,35,5,75,20,100,50
18627,Reynel,52420,52,30,20,10,65,10,85,50
18628,Riaucourt,52421,52,38,88,16,95,57,168,126
18629,Richebourg,52422,52,48,56,12,112,44,168,104
18630,Rimaucourt,52423,52,95,160,75,275,90,440,255
18631,Rivières-le-Bois,52424,52,15,23,9,30,22,61,38
18632,Rivière-les-Fosses,52425,52,25,45,30,80,25,135,70
18633,Rizaucourt-Buchey,52426,52,26,27,4,28,22,54,53
18634,Rochefort-sur-la-Côte,52428,52,6,7,6,15,6,27,13
18635,Roches-sur-Marne,52429,52,85,130,35,230,100,365,215
18636,Rochetaillée,52431,52,28,28,4,48,36,88,56
18637,Rolampont,52432,52,200,365,118,529,300,947,565
18638,Romain-sur-Meuse,52433,52,20,32,4,52,12,68,52
18639,Rouécourt,52436,52,25,0,5,10,0,15,25
18640,Rouelles,52437,52,0,5,0,15,10,25,5
18641,Rougeux,52438,52,20,15,10,45,15,70,35
18642,Rouvres-sur-Aube,52439,52,20,10,5,40,15,60,30
18643,Rouvroy-sur-Marne,52440,52,35,95,55,135,60,250,130
18644,Rupt,52442,52,45,65,20,115,70,205,110
18645,Sailly,52443,52,5,0,0,20,5,25,5
18646,Saint-Blin,52444,52,60,80,20,129,50,199,140
18647,Saint-Broingt-le-Bois,52445,52,4,32,4,20,16,40,36
18648,Saint-Broingt-les-Fosses,52446,52,8,64,20,76,41,137,72
18649,Saint-Ciergues,52447,52,50,45,0,60,35,95,95
18650,Saint-Dizier,52448,52,3475,5607,2915,8309,3960,15184,9082
18651,Saints-Geosmes,52449,52,105,221,83,496,176,755,326
18652,Saint-Loup-sur-Aujon,52450,52,15,35,10,45,25,80,50
18653,Saint-Martin-lès-Langres,52452,52,4,24,16,24,26,66,28
18654,Saint-Maurice,52453,52,5,55,0,53,40,93,60
18655,Saint-Thiébault,52455,52,31,42,15,93,18,126,73
18656,Saint-Urbain-Maconcourt,52456,52,33,162,54,230,117,401,195
18657,Saint-Vallier-sur-Marne,52457,52,30,21,21,42,27,90,51
18658,Sarcey,52459,52,5,40,15,45,15,75,45
18659,Sarrey,52461,52,56,92,28,112,80,220,148
18660,Saudron,52463,52,12,8,0,12,8,20,20
18661,Saulles,52464,52,20,10,0,15,5,20,30
18662,Saulxures,52465,52,8,36,12,56,20,88,44
18663,Savigny,52467,52,12,20,0,20,16,36,32
18664,Semilly,52468,52,16,16,4,36,24,64,32
18665,Semoutiers-Montsaon,52469,52,55,120,100,165,125,390,175
18666,Serqueux,52470,52,105,85,25,139,65,229,190
18667,Sexfontaines,52472,52,5,35,15,45,30,90,40
18668,Signéville,52473,52,36,12,4,16,20,40,48
18669,Silvarouvres,52474,52,15,0,0,10,0,10,15
18670,Sommancourt,52475,52,12,8,4,12,12,28,20
18671,Sommerécourt,52476,52,8,4,13,33,0,46,12
18672,Sommevoire,52479,52,85,160,65,225,119,409,245
18673,Soncourt-sur-Marne,52480,52,40,97,10,126,96,232,137
18674,Soulaucourt-sur-Mouzon,52482,52,20,8,12,48,4,64,28
18675,Soyers,52483,52,25,9,0,10,14,24,34
18676,Suzannecourt,52484,52,40,100,45,120,80,245,140
18677,Ternat,52486,52,13,13,0,16,8,24,26
18678,Thilleux,52487,52,12,12,20,36,4,60,24
18679,Thivet,52488,52,25,38,32,112,33,177,63
18680,Thol-lès-Millières,52489,52,12,8,0,4,8,12,20
18681,Thonnance-lès-Joinville,52490,52,80,200,100,316,120,536,280
18682,Thonnance-les-Moulins,52491,52,23,29,6,40,11,57,52
18683,Torcenay,52492,52,110,105,45,225,60,330,215
18684,Tornay,52493,52,0,10,0,20,10,30,10
18685,Treix,52494,52,30,45,25,85,45,155,75
18686,Trémilly,52495,52,4,34,4,8,31,43,38
18687,Troisfontaines-la-Ville,52497,52,56,108,48,132,80,260,164
18688,Vaillant,52499,52,18,0,6,6,6,18,18
18689,Valcourt,52500,52,83,106,34,266,79,379,189
18690,Valleret,52502,52,4,12,8,20,12,40,16
18691,Valleroy,52503,52,20,0,0,5,0,5,20
18692,Varennes-sur-Amance,52504,52,84,50,15,113,44,172,134
18693,Vaudrecourt,52505,52,25,0,5,10,0,15,25
18694,Vaudrémont,52506,52,25,27,0,35,16,51,52
18695,Vauxbons,52507,52,15,10,0,20,10,30,25
18696,Vaux-sur-Blaise,52510,52,59,71,46,111,48,205,130
18697,Vaux-sur-Saint-Urbain,52511,52,0,13,3,28,9,40,13
18698,Vecqueville,52512,52,71,140,35,255,71,361,211
18699,Velles,52513,52,15,7,3,21,3,27,22
18700,Verbiesles,52514,52,40,56,24,144,28,196,96
18701,Verseilles-le-Bas,52515,52,12,25,22,20,16,58,37
18702,Verseilles-le-Haut,52516,52,5,25,0,0,30,30,30
18703,Vesaignes-sous-Lafauche,52517,52,11,22,9,45,19,73,33
18704,Vesaignes-sur-Marne,52518,52,40,15,5,35,10,50,55
18705,Vesvres-sous-Chalancey,52519,52,15,6,3,6,6,15,21
18706,Vicq,52520,52,60,15,5,55,20,80,75
18707,Viéville,52522,52,35,95,55,48,110,213,130
18708,Vignes-la-Côte,52523,52,0,0,8,24,8,40,0
18709,Vignory,52524,52,50,40,35,85,35,155,90
18710,Villars-en-Azois,52525,52,12,6,3,21,9,33,18
18711,Villars-Santenoge,52526,52,19,16,6,21,9,36,35
18712,Ville-en-Blaisois,52528,52,6,51,6,71,23,100,57
18713,Villegusien-le-Lac,52529,52,151,222,68,356,144,568,373
18714,Villiers-en-Lieu,52534,52,235,390,135,535,235,905,625
18715,Villiers-le-Sec,52535,52,79,180,115,215,135,465,259
18716,Villiers-lès-Aprey,52536,52,8,0,8,12,12,32,8
18717,Villiers-sur-Suize,52538,52,48,64,40,88,36,164,112
18718,Violot,52539,52,5,35,15,20,15,50,40
18719,Vitry-en-Montagne,52540,52,14,0,0,3,0,3,14
18720,Vitry-lès-Nogent,52541,52,30,60,0,40,60,100,90
18721,Vivey,52542,52,20,10,0,20,0,20,30
18722,Voillecomte,52543,52,25,125,65,185,110,360,150
18723,Voisey,52544,52,95,25,20,155,10,185,120
18724,Voisines,52545,52,29,20,6,3,13,22,49
18725,Voncourt,52546,52,12,0,0,4,0,4,12
18726,Vouécourt,52547,52,25,30,5,120,25,150,55
18727,Vraincourt,52548,52,3,21,6,31,9,46,24
18728,Vroncourt-la-Côte,52549,52,0,8,8,12,0,20,8
18729,Wassy,52550,52,350,650,185,920,515,1620,1000
18730,Ahuillé,53001,53,170,557,150,535,365,1050,727
18731,Alexain,53002,53,40,205,30,110,177,317,245
18732,Ambrières-les-Vallées,53003,53,447,588,219,990,418,1627,1035
18733,Ampoigné,53004,53,35,190,95,130,130,355,225
18734,Andouillé,53005,53,279,633,144,652,422,1218,912
18735,Argenton-Notre-Dame,53006,53,20,65,0,65,56,121,85
18736,Argentré,53007,53,227,777,220,887,550,1657,1004
18737,Aron,53008,53,220,444,204,636,260,1100,664
18738,Arquenay,53009,53,70,180,60,205,110,375,250
18739,Assé-le-Bérenger,53010,53,16,128,44,144,104,292,144
18740,Astillé,53011,53,66,246,76,195,174,445,312
18741,Athée,53012,53,45,145,45,155,105,305,190
18742,Averton,53013,53,50,120,65,258,100,423,170
18743,Azé,53014,53,485,815,212,1209,502,1923,1300
18744,La Baconnière,53015,53,115,625,175,440,455,1070,740
18745,Bais,53016,53,190,215,130,430,145,705,405
18746,Ballée,53017,53,120,195,30,230,130,390,315
18747,Ballots,53018,53,184,348,108,304,256,668,532
18748,Bannes,53019,53,7,32,3,37,29,69,39
18749,La Bazoge-Montpinçon,53021,53,21,328,73,268,234,575,349
18750,La Bazouge-de-Chemeré,53022,53,35,165,60,170,95,325,200
18751,La Bazouge-des-Alleux,53023,53,17,185,46,87,152,285,202
18752,Bazougers,53025,53,100,374,113,244,273,630,474
18753,Beaulieu-sur-Oudon,53026,53,32,153,35,99,108,242,185
18754,Beaumont-Pied-de-Boeuf,53027,53,20,48,0,74,39,113,68
18755,Belgeard,53028,53,40,193,41,140,140,321,233
18756,Bierné,53029,53,94,201,60,162,110,332,295
18757,Le Bignon-du-Maine,53030,53,25,93,12,89,81,182,118
18758,La Bigottière,53031,53,52,168,36,100,136,272,220
18759,Blandouet,53032,53,9,39,15,49,26,90,48
18760,La Boissière,53033,53,10,30,10,50,10,70,40
18761,Bonchamp-lès-Laval,53034,53,551,1581,243,2338,996,3577,2132
18762,Bouchamps-lès-Craon,53035,53,60,170,55,145,120,320,230
18763,Bouère,53036,53,130,362,50,274,230,554,492
18764,Bouessay,53037,53,55,235,60,205,190,455,290
18765,Boulay-les-Ifs,53038,53,24,44,8,72,36,116,68
18766,Le Bourgneuf-la-Forêt,53039,53,270,505,119,448,349,916,775
18767,Bourgon,53040,53,76,208,52,144,168,364,284
18768,Brains-sur-les-Marches,53041,53,34,45,20,110,30,160,79
18769,Brecé,53042,53,128,220,60,290,145,495,348
18770,Brée,53043,53,100,130,40,155,105,300,230
18771,La Brûlatte,53045,53,64,160,70,255,125,450,224
18772,Le Buret,53046,53,12,92,16,100,72,188,104
18773,Carelles,53047,53,52,50,16,82,33,131,102
18774,Chailland,53048,53,240,343,84,344,216,644,583
18775,Châlons-du-Maine,53049,53,44,240,92,140,178,410,284
18776,Champéon,53051,53,74,117,50,164,99,313,191
18777,Champfrémont,53052,53,30,80,20,110,55,185,110
18778,Champgenéteux,53053,53,58,128,29,152,108,289,186
18779,Changé,53054,53,623,1410,484,2017,839,3340,2033
18780,Chantrigné,53055,53,90,130,65,205,90,360,220
18781,La Chapelle-Anthenaise,53056,53,32,318,50,244,233,527,350
18782,La Chapelle-au-Riboul,53057,53,95,140,25,160,85,270,235
18783,La Chapelle-Craonnaise,53058,53,4,93,49,82,62,193,97
18784,La Chapelle-Rainsouin,53059,53,32,148,56,88,92,236,180
18785,Charchigné,53061,53,48,140,44,176,92,312,188
18786,Château-Gontier,53062,53,1912,2538,1240,3513,1845,6598,4450
18787,Châtelain,53063,53,60,160,40,124,100,264,220
18788,Châtillon-sur-Colmont,53064,53,214,254,104,330,139,573,468
18789,Châtres-la-Forêt,53065,53,48,238,45,219,168,432,286
18790,Chemazé,53066,53,160,404,124,344,288,756,564
18791,Chémeré-le-Roi,53067,53,35,115,40,100,90,230,150
18792,Chérancé,53068,53,25,30,15,60,20,95,55
18793,Chevaigné-du-Maine,53069,53,45,20,5,70,30,105,65
18794,Colombiers-du-Plessis,53071,53,65,123,25,142,58,225,188
18795,Commer,53072,53,105,340,125,360,265,750,445
18796,Congrier,53073,53,89,220,57,317,152,526,309
18797,Contest,53074,53,50,242,105,300,160,565,292
18798,Cosmes,53075,53,45,95,25,55,75,155,140
18799,Cossé-en-Champagne,53076,53,30,106,5,100,90,195,136
18800,Cossé-le-Vivien,53077,53,432,784,268,860,588,1716,1216
18801,Coudray,53078,53,68,309,76,180,237,493,377
18802,Couesmes-Vaucé,53079,53,75,85,25,127,55,207,160
18803,Couptrain,53080,53,45,16,3,20,22,45,61
18804,Courbeveille,53082,53,20,235,50,190,160,400,255
18805,Courcité,53083,53,120,225,50,320,195,565,345
18806,Craon,53084,53,872,872,354,1463,591,2408,1744
18807,Crennes-sur-Fraubée,53085,53,20,45,0,80,40,120,65
18808,La Croixille,53086,53,79,204,48,154,152,354,283
18809,La Cropte,53087,53,12,49,17,66,48,131,61
18810,Cuillé,53088,53,170,232,27,266,165,458,402
18811,Daon,53089,53,55,117,44,142,75,261,172
18812,Denazé,53090,53,29,32,9,23,29,61,61
18813,Désertines,53091,53,80,100,39,164,79,282,180
18814,Deux-Évailles,53092,53,20,55,15,85,15,115,75
18815,La Dorée,53093,53,111,45,15,96,35,146,156
18816,Entrammes,53094,53,200,620,204,676,480,1360,820
18817,Épineux-le-Seguin,53095,53,12,76,26,16,76,118,88
18818,Ernée,53096,53,1045,1237,455,1867,867,3189,2282
18819,Évron,53097,53,1434,1477,678,2205,932,3815,2911
18820,Fontaine-Couverte,53098,53,42,103,36,117,82,235,145
18821,Forcé,53099,53,68,305,56,340,224,620,373
18822,Fougerolles-du-Plessis,53100,53,291,166,56,493,127,676,457
18823,Fromentières,53101,53,125,280,55,180,200,435,405
18824,Gastines,53102,53,27,41,13,38,25,76,68
18825,Le Genest-Saint-Isle,53103,53,199,625,175,715,410,1300,824
18826,Gennes-sur-Glaize,53104,53,94,271,116,239,192,547,365
18827,Gesnes,53105,53,3,56,29,57,50,136,59
18828,Gesvres,53106,53,70,135,40,150,115,305,205
18829,Gorron,53107,53,681,461,194,885,251,1330,1142
18830,La Gravelle,53108,53,32,137,67,118,101,286,169
18831,Grazay,53109,53,88,174,76,152,124,352,262
18832,Grez-en-Bouère,53110,53,130,265,115,281,205,601,395
18833,La Haie-Traversaine,53111,53,28,124,60,168,84,312,152
18834,Le Ham,53112,53,55,85,55,130,60,245,140
18835,Hambers,53113,53,90,145,40,175,131,346,235
18836,Hardanges,53114,53,40,26,12,66,38,116,66
18837,Hercé,53115,53,47,57,33,98,37,168,104
18838,Le Horps,53116,53,140,204,65,183,153,401,344
18839,Houssay,53117,53,36,128,64,124,100,288,164
18840,Le Housseau-Brétignolles,53118,53,52,76,16,48,56,120,128
18841,L'Huisserie,53119,53,356,1045,383,1626,648,2657,1401
18842,Izé,53120,53,50,100,20,223,65,308,150
18843,Javron-les-Chapelles,53121,53,245,200,100,518,163,781,445
18844,Jublains,53122,53,74,147,89,189,113,391,221
18845,Juvigné,53123,53,190,391,65,400,345,810,581
18846,Laigné,53124,53,90,300,50,240,185,475,390
18847,Landivy,53125,53,195,280,30,420,180,630,475
18848,Larchamp,53126,53,161,239,97,360,143,600,400
18849,Lassay-les-Châteaux,53127,53,337,525,186,727,387,1300,862
18850,Laubrières,53128,53,63,90,24,78,35,137,153
18851,Launay-Villiers,53129,53,65,135,0,80,95,175,200
18852,Laval,53130,53,6232,11771,7073,14586,8444,30103,18003
18853,Lesbois,53131,53,15,42,9,78,29,116,57
18854,Levaré,53132,53,48,84,32,100,56,188,132
18855,Lignières-Orgères,53133,53,140,184,68,292,116,476,324
18856,Livet,53134,53,50,40,15,35,25,75,90
18857,Livré-la-Touche,53135,53,55,183,25,282,131,438,238
18858,Loigné-sur-Mayenne,53136,53,40,280,112,280,180,572,320
18859,Loiron-Ruillé,53137,53,245,768,204,680,576,1460,1013
18860,Longuefuye,53138,53,0,130,25,95,105,225,130
18861,Loupfougères,53139,53,57,106,17,116,74,207,163
18862,Louverné,53140,53,439,1085,395,1331,757,2483,1524
18863,Louvigné,53141,53,50,405,60,325,275,660,455
18864,Madré,53142,53,56,62,13,100,59,172,118
18865,Maisoncelles-du-Maine,53143,53,40,181,20,170,125,315,221
18866,Marcillé-la-Ville,53144,53,60,250,65,225,220,510,310
18867,Marigné-Peuton,53145,53,40,172,48,148,140,336,212
18868,Martigné-sur-Mayenne,53146,53,154,466,242,448,329,1019,620
18869,Mayenne,53147,53,1889,2827,1505,4290,2117,7912,4716
18870,Mée,53148,53,12,64,32,32,60,124,76
18871,Ménil,53150,53,72,312,64,316,216,596,384
18872,Méral,53151,53,160,296,96,220,236,552,456
18873,Meslay-du-Maine,53152,53,677,645,275,754,375,1404,1322
18874,Mézangers,53153,53,92,216,64,188,140,392,308
18875,Montaudin,53154,53,153,208,67,257,129,453,361
18876,Montenay,53155,53,205,301,82,439,235,756,506
18877,Montflours,53156,53,11,75,33,67,33,133,86
18878,Montigné-le-Brillant,53157,53,90,385,40,505,255,800,475
18879,Montjean,53158,53,86,286,93,263,240,596,372
18880,Montourtier,53159,53,48,98,54,54,68,176,146
18881,Montreuil-Poulay,53160,53,30,95,10,185,65,260,125
18882,Montsûrs,53161,53,442,456,159,528,343,1030,898
18883,Moulay,53162,53,160,210,85,415,115,615,370
18884,Neau,53163,53,72,192,60,215,162,437,264
18885,Neuilly-le-Vendin,53164,53,75,50,40,160,25,225,125
18886,Niafles,53165,53,12,80,48,128,52,228,92
18887,Nuillé-sur-Vicoin,53168,53,150,336,100,365,236,701,486
18888,Olivet,53169,53,20,115,25,160,90,275,135
18889,Oisseau,53170,53,134,348,75,360,233,668,482
18890,Origné,53172,53,10,165,50,85,130,265,175
18891,La Pallu,53173,53,25,55,20,45,40,105,80
18892,Parigné-sur-Braye,53174,53,34,230,80,272,149,501,264
18893,Parné-sur-Roc,53175,53,95,401,137,341,267,745,496
18894,Le Pas,53176,53,67,153,25,128,91,244,220
18895,La Pellerine,53177,53,40,75,35,126,65,226,115
18896,Peuton,53178,53,24,84,8,60,56,124,108
18897,Placé,53179,53,35,90,35,100,65,200,125
18898,Pommerieux,53180,53,54,220,43,140,174,357,274
18899,Pontmain,53181,53,168,128,44,280,88,412,296
18900,Port-Brillet,53182,53,288,388,156,616,284,1056,676
18901,Préaux,53184,53,5,65,15,65,15,95,70
18902,Pré-en-Pail-Saint-Samson,53185,53,352,478,202,837,370,1409,830
18903,Quelaines-Saint-Gault,53186,53,315,600,230,560,405,1195,915
18904,Ravigny,53187,53,36,52,16,80,28,124,88
18905,Renazé,53188,53,511,586,185,838,398,1421,1097
18906,Rennes-en-Grenouilles,53189,53,50,20,10,15,20,45,70
18907,Le Ribay,53190,53,65,135,50,150,80,280,200
18908,La Roë,53191,53,30,60,3,81,42,126,90
18909,La Rouaudière,53192,53,40,105,25,100,70,195,145
18910,Ruillé-Froid-Fonds,53193,53,25,165,48,159,113,320,190
18911,Sacé,53195,53,16,189,36,88,151,275,205
18912,Saint-Aignan-de-Couptrain,53196,53,45,95,30,125,85,240,140
18913,Saint-Aignan-sur-Roë,53197,53,140,172,96,300,124,520,312
18914,Saint-Aubin-du-Désert,53198,53,60,50,5,90,35,130,110
18915,Saint-Aubin-Fosse-Louvain,53199,53,65,45,5,70,40,115,110
18916,Saint-Baudelle,53200,53,80,380,95,385,210,690,460
18917,Saint-Berthevin,53201,53,983,1765,688,2562,1200,4450,2748
18918,Saint-Berthevin-la-Tannière,53202,53,75,64,43,125,45,213,139
18919,Saint-Brice,53203,53,50,155,60,148,120,328,205
18920,Saint-Calais-du-Désert,53204,53,60,85,50,100,80,230,145
18921,Saint-Céneré,53205,53,16,157,48,152,108,308,173
18922,Saint-Charles-la-Forêt,53206,53,8,60,32,88,44,164,68
18923,Saint-Christophe-du-Luat,53207,53,69,259,43,171,199,413,328
18924,Saint-Cyr-en-Pail,53208,53,60,107,39,147,94,280,167
18925,Saint-Cyr-le-Gravelais,53209,53,80,155,10,175,100,285,235
18926,Saint-Denis-d'Anjou,53210,53,220,388,116,452,276,844,608
18927,Saint-Denis-de-Gastines,53211,53,310,365,109,407,232,748,675
18928,Saint-Denis-du-Maine,53212,53,40,140,15,90,120,225,180
18929,Saint-Ellier-du-Maine,53213,53,89,127,18,157,87,262,216
18930,Saint-Erblon,53214,53,10,50,25,40,40,105,60
18931,Saint-Fort,53215,53,256,372,97,627,200,924,628
18932,Saint-Fraimbault-de-Prières,53216,53,60,259,60,276,177,513,319
18933,Sainte-Gemmes-le-Robert,53218,53,114,235,75,255,195,525,349
18934,Saint-Georges-Buttavent,53219,53,139,368,162,412,251,825,507
18935,Saint-Georges-le-Fléchard,53220,53,20,157,16,75,105,196,177
18936,Saint-Georges-sur-Erve,53221,53,45,85,36,115,57,208,130
18937,Saint-Germain-d'Anxure,53222,53,30,125,40,75,115,230,155
18938,Saint-Germain-de-Coulamer,53223,53,74,72,13,121,63,197,146
18939,Saint-Germain-le-Fouilloux,53224,53,68,405,92,248,293,633,473
18940,Saint-Germain-le-Guillaume,53225,53,48,140,32,144,120,296,188
18941,Saint-Hilaire-du-Maine,53226,53,61,266,110,210,168,488,327
18942,Saint-Jean-sur-Erve,53228,53,74,97,12,136,75,223,171
18943,Saint-Jean-sur-Mayenne,53229,53,64,534,148,492,381,1021,598
18944,Saint-Julien-du-Terroux,53230,53,46,54,15,91,43,149,100
18945,Saint-Laurent-des-Mortiers,53231,53,15,67,32,39,30,101,82
18946,Saint-Léger,53232,53,40,95,15,95,75,185,135
18947,Saint-Loup-du-Dorat,53233,53,25,105,40,130,60,230,130
18948,Saint-Loup-du-Gast,53234,53,47,108,25,100,60,185,155
18949,Sainte-Marie-du-Bois,53235,53,30,35,0,105,45,150,65
18950,Saint-Mars-du-Désert,53236,53,22,35,0,59,21,80,57
18951,Saint-Mars-sur-Colmont,53237,53,30,115,50,205,80,335,145
18952,Saint-Mars-sur-la-Futaie,53238,53,93,129,36,187,86,309,222
18953,Saint-Martin-de-Connée,53239,53,60,82,38,145,48,231,142
18954,Saint-Martin-du-Limet,53240,53,45,110,30,165,109,304,155
18955,Saint-Michel-de-Feins,53241,53,30,70,15,30,50,95,100
18956,Saint-Michel-de-la-Roë,53242,53,30,97,4,81,33,118,127
18957,Saint-Ouën-des-Toits,53243,53,155,513,166,448,345,959,668
18958,Saint-Ouën-des-Vallons,53244,53,10,40,10,85,35,130,50
18959,Saint-Pierre-des-Landes,53245,53,136,244,72,320,156,548,380
18960,Saint-Pierre-des-Nids,53246,53,249,438,138,748,282,1168,687
18961,Saint-Pierre-la-Cour,53247,53,309,587,214,524,456,1194,896
18962,Saint-Pierre-sur-Erve,53248,53,5,55,5,55,40,100,60
18963,Saint-Pierre-sur-Orthe,53249,53,86,67,42,148,57,247,153
18964,Saint-Poix,53250,53,48,108,40,136,68,244,156
18965,Saint-Quentin-les-Anges,53251,53,35,120,40,150,70,260,155
18966,Saint-Saturnin-du-Limet,53253,53,35,140,40,155,95,290,175
18967,Saint-Sulpice,53254,53,24,64,36,64,36,136,88
18968,Sainte-Suzanne-et-Chammes,53255,53,227,345,73,416,239,728,572
18969,Saint-Thomas-de-Courceriers,53256,53,25,20,10,100,30,140,45
18970,Saulges,53257,53,48,71,33,68,33,134,119
18971,La Selle-Craonnaise,53258,53,85,240,60,230,190,480,325
18972,Senonnes,53259,53,20,84,40,120,64,224,104
18973,Simplé,53260,53,4,145,56,95,77,228,149
18974,Soucé,53261,53,40,30,13,51,17,81,70
18975,Soulgé-sur-Ouette,53262,53,125,335,45,330,235,610,460
18976,Thuboeuf,53263,53,34,67,31,73,46,150,101
18977,Thorigné-en-Charnie,53264,53,40,60,25,35,50,110,100
18978,Torcé-Viviers-en-Charnie,53265,53,104,192,60,288,100,448,296
18979,Trans,53266,53,35,55,20,70,45,135,90
18980,Vaiges,53267,53,185,275,105,305,205,615,460
18981,Vautorte,53269,53,80,172,40,136,164,340,252
18982,Vieuvy,53270,53,26,23,0,28,19,47,49
18983,Villaines-la-Juhel,53271,53,537,563,176,1097,386,1659,1100
18984,Villepail,53272,53,25,50,15,63,45,123,75
18985,Villiers-Charlemagne,53273,53,70,310,115,280,285,680,380
18986,Vimarcé,53274,53,45,70,10,85,35,130,115
18987,Voutré,53276,53,111,249,55,224,202,481,360
18988,Abaucourt,54001,54,40,75,15,90,70,175,115
18989,Abbéville-lès-Conflans,54002,54,10,30,40,115,40,195,40
18990,Aboncourt,54003,54,30,35,15,15,15,45,65
18991,Affléville,54004,54,32,40,28,56,32,116,72
18992,Affracourt,54005,54,20,15,5,30,20,55,35
18993,Agincourt,54006,54,48,116,24,156,96,276,164
18994,Aingeray,54007,54,15,115,65,248,110,423,130
18995,Allain,54008,54,20,120,100,156,80,336,140
18996,Allamont,54009,54,16,40,12,40,36,88,56
18997,Allamps,54010,54,36,152,48,188,116,352,188
18998,Allondrelle-la-Malmaison,54011,54,51,169,65,139,133,337,220
18999,Amance,54012,54,36,76,22,96,52,170,112
19000,Amenoncourt,54013,54,5,15,0,35,10,45,20
19001,Ancerviller,54014,54,42,62,22,72,35,129,104
19002,Anderny,54015,54,35,80,30,70,55,155,115
19003,Andilly,54016,54,16,64,23,55,74,152,80
19004,Angomont,54017,54,22,16,3,18,9,30,38
19005,Anoux,54018,54,32,46,22,68,42,132,78
19006,Ansauville,54019,54,0,35,10,25,20,55,35
19007,Anthelupt,54020,54,43,95,22,169,77,268,138
19008,Armaucourt,54021,54,6,50,29,65,30,124,56
19009,Arnaville,54022,54,65,136,85,175,125,385,201
19010,Arracourt,54023,54,52,56,12,76,52,140,108
19011,Arraye-et-Han,54024,54,28,72,48,80,60,188,100
19012,Art-sur-Meurthe,54025,54,114,271,96,430,146,672,385
19013,Athienville,54026,54,40,36,4,56,32,92,76
19014,Atton,54027,54,54,219,84,271,174,529,273
19015,Auboué,54028,54,535,540,280,710,405,1395,1075
19016,Audun-le-Roman,54029,54,258,653,256,738,505,1499,911
19017,Autrepierre,54030,54,12,22,6,22,12,40,34
19018,Autreville-sur-Moselle,54031,54,28,55,35,102,34,171,83
19019,Autrey,54032,54,20,35,8,49,22,79,55
19020,Avillers,54033,54,8,36,4,20,35,59,44
19021,Avrainville,54034,54,21,35,21,49,47,117,56
19022,Avricourt,54035,54,54,70,45,165,35,245,124
19023,Avril,54036,54,111,350,104,244,235,583,461
19024,Azelot,54037,54,36,120,12,168,96,276,156
19025,Azerailles,54038,54,96,176,76,296,144,516,272
19026,Baccarat,54039,54,520,987,523,1420,723,2666,1507
19027,Badonviller,54040,54,228,348,124,504,268,896,576
19028,Bagneux,54041,54,16,44,4,28,28,60,60
19029,Bainville-aux-Miroirs,54042,54,52,76,24,108,72,204,128
19030,Bainville-sur-Madon,54043,54,130,320,85,365,255,705,450
19031,Barbas,54044,54,16,38,31,41,22,94,54
19032,Barbonville,54045,54,43,92,56,78,91,225,135
19033,Barisey-au-Plain,54046,54,45,136,35,105,95,235,181
19034,Barisey-la-Côte,54047,54,16,44,24,46,49,119,60
19035,Les Baroches,54048,54,25,101,15,140,70,225,126
19036,Baslieux,54049,54,85,190,35,180,115,330,275
19037,Bathelémont,54050,54,4,8,4,28,8,40,12
19038,Batilly,54051,54,155,291,102,366,257,725,446
19039,Battigny,54052,54,0,40,0,28,56,84,40
19040,Bauzemont,54053,54,16,40,8,52,24,84,56
19041,Bayon,54054,54,175,400,85,415,350,850,575
19042,Bayonville-sur-Mad,54055,54,35,75,20,145,35,200,110
19043,Bazailles,54056,54,25,15,25,70,20,115,40
19044,Beaumont,54057,54,8,21,0,12,16,28,29
19045,Béchamps,54058,54,5,35,5,30,20,55,40
19046,Belleau,54059,54,84,170,95,213,183,491,254
19047,Belleville,54060,54,182,363,132,346,288,766,545
19048,Bénaménil,54061,54,48,152,76,168,112,356,200
19049,Benney,54062,54,84,149,73,162,151,386,233
19050,Bernécourt,54063,54,24,44,24,68,32,124,68
19051,Bertrambois,54064,54,50,60,35,135,30,200,110
19052,Bertrichamps,54065,54,120,222,82,406,181,669,342
19053,Bettainvillers,54066,54,32,84,32,85,75,192,116
19054,Beuveille,54067,54,70,216,30,220,225,475,286
19055,Beuvezin,54068,54,20,15,5,40,0,45,35
19056,Beuvillers,54069,54,36,92,24,112,108,244,128
19057,Bey-sur-Seille,54070,54,12,36,20,44,32,96,48
19058,Bezange-la-Grande,54071,54,26,24,6,62,23,91,50
19059,Bezaumont,54072,54,28,60,20,92,44,156,88
19060,Bicqueley,54073,54,90,213,129,291,183,603,303
19061,Bienville-la-Petite,54074,54,5,10,0,10,10,20,15
19062,Bionville,54075,54,15,25,10,65,15,90,40
19063,Blainville-sur-l'Eau,54076,54,330,1025,405,1370,770,2545,1355
19064,Blâmont,54077,54,164,244,104,308,148,560,408
19065,Blémerey,54078,54,0,30,10,15,25,50,30
19066,Blénod-lès-Pont-à-Mousson,54079,54,520,1121,610,1394,783,2787,1641
19067,Blénod-lès-Toul,54080,54,89,330,110,325,210,645,419
19068,Boismont,54081,54,49,109,30,165,87,282,158
19069,Boncourt,54082,54,16,28,16,96,28,140,44
19070,Bonviller,54083,54,12,48,12,80,24,116,60
19071,Mont-Bonvillers,54084,54,90,215,85,315,215,615,305
19072,Borville,54085,54,20,35,0,40,20,60,55
19073,Boucq,54086,54,47,92,36,89,58,183,139
19074,Bouillonville,54087,54,0,58,0,37,50,87,58
19075,Bouvron,54088,54,12,92,36,68,52,156,104
19076,Bouxières-aux-Chênes,54089,54,140,400,92,472,324,888,540
19077,Bouxières-aux-Dames,54090,54,617,876,363,1313,735,2411,1493
19078,Bouxières-sous-Froidmont,54091,54,24,80,36,104,60,200,104
19079,Bouzanville,54092,54,20,5,0,20,15,35,25
19080,Brainville,54093,54,25,35,5,55,35,95,60
19081,Bralleville,54094,54,25,45,5,75,30,110,70
19082,Bratte,54095,54,0,15,5,8,25,38,15
19083,Bréhain-la-Ville,54096,54,16,76,35,110,86,231,92
19084,Bréménil,54097,54,15,15,0,65,10,75,30
19085,Brémoncourt,54098,54,8,39,0,40,39,79,47
19086,Briey,54099,54,596,1375,541,1854,1111,3506,1971
19087,Brin-sur-Seille,54100,54,96,227,24,248,162,434,323
19088,Brouville,54101,54,12,20,16,60,12,88,32
19089,Bruley,54102,54,70,148,69,217,68,354,218
19090,Bruville,54103,54,30,75,15,105,10,130,105
19091,Buissoncourt,54104,54,24,56,32,88,52,172,80
19092,Bulligny,54105,54,84,104,52,160,92,304,188
19093,Bures,54106,54,15,20,0,5,20,25,35
19094,Buriville,54107,54,4,36,8,20,20,48,40
19095,Burthecourt-aux-Chênes,54108,54,20,15,5,35,15,55,35
19096,Ceintrey,54109,54,64,260,72,224,288,584,324
19097,Cerville,54110,54,34,150,38,183,117,338,184
19098,Chaligny,54111,54,419,683,222,917,608,1747,1102
19099,Chambley-Bussières,54112,54,40,215,35,168,220,423,255
19100,Champenoux,54113,54,160,266,101,470,213,784,426
19101,Champey-sur-Moselle,54114,54,25,75,30,140,75,245,100
19102,Champigneulles,54115,54,789,1651,739,2577,1162,4478,2440
19103,Chanteheux,54116,54,360,530,190,630,395,1215,890
19104,Chaouilley,54117,54,9,35,0,34,25,59,44
19105,Charency-Vezin,54118,54,36,157,56,163,151,370,193
19106,Charey,54119,54,16,16,12,9,13,34,32
19107,Charmes-la-Côte,54120,54,36,96,28,88,88,204,132
19108,Charmois,54121,54,28,16,24,88,24,136,44
19109,Chaudeney-sur-Moselle,54122,54,35,165,95,263,145,503,200
19110,Chavigny,54123,54,184,490,185,618,380,1183,674
19111,Chazelles-sur-Albe,54124,54,0,8,4,16,8,28,8
19112,Chenevières,54125,54,40,120,60,160,116,336,160
19113,Chenicourt,54126,54,20,68,16,76,48,140,88
19114,Chenières,54127,54,75,165,50,210,140,400,240
19115,Choloy-Ménillot,54128,54,63,176,49,261,146,456,239
19116,Cirey-sur-Vezouze,54129,54,214,410,150,579,255,984,624
19117,Clayeures,54130,54,16,45,6,57,32,95,61
19118,Clémery,54131,54,25,125,50,185,110,345,150
19119,Clérey-sur-Brenon,54132,54,0,28,4,36,8,48,28
19120,Coincourt,54133,54,18,29,13,33,12,58,47
19121,Colmey,54134,54,22,46,12,73,56,141,68
19122,Colombey-les-Belles,54135,54,99,460,120,362,360,842,559
19123,Conflans-en-Jarnisy,54136,54,324,480,240,809,416,1465,804
19124,Cons-la-Grandville,54137,54,86,113,30,183,117,330,199
19125,Cosnes-et-Romain,54138,54,270,550,240,1040,529,1809,820
19126,Courbesseaux,54139,54,24,98,9,78,90,177,122
19127,Courcelles,54140,54,10,35,5,30,20,55,45
19128,Coyviller,54141,54,55,30,5,15,40,60,85
19129,Crantenoy,54142,54,12,48,22,32,21,75,60
19130,Crépey,54143,54,44,104,36,92,92,220,148
19131,Crévéchamps,54144,54,31,70,57,87,79,223,101
19132,Crévic,54145,54,114,234,88,283,119,490,348
19133,Crézilles,54146,54,20,85,45,98,55,198,105
19134,Crion,54147,54,4,12,8,20,22,50,16
19135,Croismare,54148,54,92,144,52,224,100,376,236
19136,Crusnes,54149,54,140,409,105,567,359,1031,549
19137,Custines,54150,54,362,701,259,937,532,1728,1063
19138,Cutry,54151,54,168,244,64,264,264,592,412
19139,Damelevières,54152,54,336,897,232,973,605,1810,1233
19140,Dampvitoux,54153,54,15,15,0,30,5,35,30
19141,Deneuvre,54154,54,80,135,45,159,76,280,215
19142,Deuxville,54155,54,30,160,45,105,105,255,190
19143,Diarville,54156,54,72,109,48,122,98,268,181
19144,Dieulouard,54157,54,547,1128,453,1545,899,2897,1675
19145,Dolcourt,54158,54,0,36,16,48,24,88,36
19146,Dombasle-sur-Meurthe,54159,54,1283,2534,1092,2955,1811,5858,3817
19147,Domèvre-en-Haye,54160,54,15,155,30,120,100,250,170
19148,Domèvre-sur-Vezouze,54161,54,35,65,30,100,60,190,100
19149,Domgermain,54162,54,110,333,92,392,255,739,443
19150,Domjevin,54163,54,20,65,25,80,55,160,85
19151,Dommarie-Eulmont,54164,54,12,24,12,32,12,56,36
19152,Dommartemont,54165,54,147,106,35,230,60,325,253
19153,Dommartin-la-Chaussée,54166,54,0,30,0,10,15,25,30
19154,Dommartin-lès-Toul,54167,54,176,544,184,684,428,1296,720
19155,Dommartin-sous-Amance,54168,54,36,36,24,128,24,176,72
19156,Domprix,54169,54,0,30,15,35,15,65,30
19157,Domptail-en-l'Air,54170,54,8,16,4,16,16,36,24
19158,Doncourt-lès-Conflans,54171,54,65,330,150,398,255,803,395
19159,Doncourt-lès-Longuyon,54172,54,32,88,32,68,88,188,120
19160,Drouville,54173,54,32,60,24,32,56,112,92
19161,Écrouves,54174,54,345,1070,350,1245,765,2360,1415
19162,Einvaux,54175,54,20,84,20,108,80,208,104
19163,Einville-au-Jard,54176,54,208,295,130,370,210,710,503
19164,Emberménil,54177,54,13,80,20,68,53,141,93
19165,Épiez-sur-Chiers,54178,54,12,40,17,65,22,104,52
19166,Éply,54179,54,35,80,35,95,65,195,115
19167,Erbéviller-sur-Amezule,54180,54,0,23,0,35,12,47,23
19168,Errouville,54181,54,94,152,57,247,131,435,246
19169,Essey-et-Maizerais,54182,54,28,124,69,112,72,253,152
19170,Essey-la-Côte,54183,54,13,10,9,29,3,41,23
19171,Essey-lès-Nancy,54184,54,1274,1800,996,2600,1539,5135,3074
19172,Étreval,54185,54,15,15,5,10,10,25,30
19173,Eulmont,54186,54,84,238,74,357,159,590,322
19174,Euvezin,54187,54,8,25,20,24,16,60,33
19175,Faulx,54188,54,115,325,85,445,185,715,440
19176,Favières,54189,54,72,164,52,164,148,364,236
19177,Fécocourt,54190,54,20,20,15,40,5,60,40
19178,Fenneviller,54191,54,20,10,10,45,10,65,30
19179,Ferrières,54192,54,28,76,32,84,72,188,104
19180,Fey-en-Haye,54193,54,0,14,4,28,8,40,14
19181,Fillières,54194,54,48,124,68,148,120,336,172
19182,Flainval,54195,54,21,75,4,72,31,107,96
19183,Flavigny-sur-Moselle,54196,54,124,321,87,630,239,956,445
19184,Fléville-devant-Nancy,54197,54,313,455,166,1025,306,1497,768
19185,Fléville-Lixières,54198,54,12,67,12,82,78,172,79
19186,Flin,54199,54,35,79,60,163,30,253,114
19187,Flirey,54200,54,23,30,35,50,15,100,53
19188,Fontenoy-la-Joûte,54201,54,43,63,20,71,67,158,106
19189,Fontenoy-sur-Moselle,54202,54,22,118,17,96,94,207,140
19190,Forcelles-Saint-Gorgon,54203,54,16,41,8,45,40,93,57
19191,Forcelles-sous-Gugney,54204,54,5,20,5,30,25,60,25
19192,Foug,54205,54,322,629,231,941,486,1658,951
19193,Fraimbois,54206,54,24,126,20,112,101,233,150
19194,Fraisnes-en-Saintois,54207,54,0,26,15,55,15,85,26
19195,Francheville,54208,54,40,55,20,105,55,180,95
19196,Franconville,54209,54,4,25,0,8,24,32,29
19197,Fréménil,54210,54,30,85,25,35,60,120,115
19198,Frémonville,54211,54,48,48,12,37,29,78,96
19199,Fresnois-la-Montagne,54212,54,56,92,52,132,92,276,148
19200,Friauville,54213,54,52,88,32,120,72,224,140
19201,Frolois,54214,54,70,168,66,204,125,395,238
19202,Frouard,54215,54,840,1571,781,2284,1163,4228,2411
19203,Froville,54216,54,8,32,4,36,36,76,40
19204,Gélacourt,54217,54,48,28,20,32,28,80,76
19205,Gélaucourt,54218,54,4,20,0,16,21,37,24
19206,Gellenoncourt,54219,54,10,35,0,5,35,40,45
19207,Gémonville,54220,54,15,20,0,25,5,30,35
19208,Gerbécourt-et-Haplemont,54221,54,12,60,16,52,68,136,72
19209,Gerbéviller,54222,54,130,329,100,377,241,718,459
19210,Germiny,54223,54,28,42,21,41,29,91,70
19211,Germonville,54224,54,16,25,20,24,24,68,41
19212,Gézoncourt,54225,54,8,48,16,72,36,124,56
19213,Gibeaumeix,54226,54,40,44,8,44,28,80,84
19214,Giraumont,54227,54,182,343,173,353,290,816,525
19215,Giriviller,54228,54,15,20,5,10,15,30,35
19216,Glonville,54229,54,56,67,25,89,62,176,123
19217,Gogney,54230,54,10,5,5,35,0,40,15
19218,Gondrecourt-Aix,54231,54,5,65,10,45,55,110,70
19219,Gondreville,54232,54,290,790,275,960,530,1765,1080
19220,Gondrexon,54233,54,4,4,0,12,0,12,8
19221,Gorcy,54234,54,333,680,236,737,580,1553,1013
19222,Goviller,54235,54,65,100,45,90,90,225,165
19223,Grand-Failly,54236,54,48,52,32,116,60,208,100
19224,Grimonviller,54237,54,5,16,5,35,20,60,21
19225,Gripport,54238,54,45,80,10,90,55,155,125
19226,Griscourt,54239,54,16,25,18,18,23,59,41
19227,Grosrouvres,54240,54,0,17,0,24,18,42,17
19228,Gugney,54241,54,6,7,9,22,6,37,13
19229,Gye,54242,54,8,60,24,64,60,148,68
19230,Hablainville,54243,54,30,65,25,90,20,135,95
19231,Hagéville,54244,54,9,22,3,43,12,58,31
19232,Haigneville,54245,54,4,0,16,20,4,40,4
19233,Halloville,54246,54,8,20,0,20,20,40,28
19234,Hammeville,54247,54,16,40,4,76,28,108,56
19235,Hamonville,54248,54,12,6,9,22,15,46,18
19236,Hannonville-Suzémont,54249,54,32,68,9,55,69,133,100
19237,Haraucourt,54250,54,94,178,50,179,143,372,272
19238,Harbouey,54251,54,21,25,9,57,4,70,46
19239,Haroué,54252,54,24,110,25,119,109,253,134
19240,Hatrize,54253,54,100,172,80,260,152,492,272
19241,Haucourt-Moulaine,54254,54,460,690,330,945,600,1875,1150
19242,Haudonville,54255,54,8,24,4,48,8,60,32
19243,Haussonville,54256,54,6,77,6,109,60,175,83
19244,Heillecourt,54257,54,612,1202,521,2357,841,3719,1814
19245,Hénaménil,54258,54,25,40,10,55,35,100,65
19246,Herbéviller,54259,54,12,52,17,79,40,136,64
19247,Hériménil,54260,54,85,245,38,364,142,544,330
19248,Herserange,54261,54,549,1050,518,1071,925,2514,1599
19249,Hoéville,54262,54,30,55,15,50,55,120,85
19250,Homécourt,54263,54,1079,1322,712,1859,1062,3633,2401
19251,Houdelmont,54264,54,25,60,30,60,45,135,85
19252,Houdemont,54265,54,311,502,180,912,285,1377,813
19253,Houdreville,54266,54,36,108,60,140,84,284,144
19254,Housséville,54268,54,35,35,20,69,15,104,70
19255,Hudiviller,54269,54,53,57,40,100,52,192,110
19256,Hussigny-Godbrange,54270,54,463,868,393,1050,779,2222,1331
19257,Igney,54271,54,24,40,8,40,28,76,64
19258,Jaillon,54272,54,12,119,43,100,137,280,131
19259,Jarny,54273,54,1264,1793,962,2794,1313,5069,3057
19260,Jarville-la-Malgrange,54274,54,1260,2095,1150,2745,1726,5621,3355
19261,Jaulny,54275,54,19,42,35,67,21,123,61
19262,Jeandelaincourt,54276,54,70,220,35,255,215,505,290
19263,Jeandelize,54277,54,35,75,60,130,80,270,110
19264,Jevoncourt,54278,54,5,30,25,10,30,65,35
19265,Jezainville,54279,54,130,230,79,330,160,569,360
19266,Joeuf,54280,54,1358,1307,632,2161,1040,3833,2665
19267,Jolivet,54281,54,105,195,53,372,128,553,300
19268,Joppécourt,54282,54,12,49,13,28,41,82,61
19269,Jouaville,54283,54,25,86,5,115,65,185,111
19270,Joudreville,54284,54,180,275,85,330,235,650,455
19271,Juvrecourt,54285,54,8,8,12,24,0,36,16
19272,Labry,54286,54,177,349,139,534,216,889,526
19273,Lachapelle,54287,54,15,55,25,115,50,190,70
19274,Lagney,54288,54,28,136,44,188,88,320,164
19275,Laître-sous-Amance,54289,54,40,100,25,150,95,270,140
19276,Laix,54290,54,17,39,20,59,29,108,56
19277,Laloeuf,54291,54,7,71,19,99,52,170,78
19278,Lamath,54292,54,16,34,4,63,33,100,50
19279,Landécourt,54293,54,16,37,6,12,22,40,53
19280,Landremont,54294,54,13,29,4,44,29,77,42
19281,Landres,54295,54,89,189,90,274,191,555,278
19282,Laneuvelotte,54296,54,34,114,20,130,99,249,148
19283,Laneuveville-aux-Bois,54297,54,25,73,26,69,73,168,98
19284,Laneuveville-derrière-Foug,54298,54,4,25,4,58,30,92,29
19285,Laneuveville-devant-Bayon,54299,54,30,60,19,68,65,152,90
19286,Laneuveville-devant-Nancy,54300,54,693,1695,610,1863,1268,3741,2388
19287,Lanfroicourt,54301,54,4,20,20,52,12,84,24
19288,Lantéfontaine,54302,54,120,150,60,300,120,480,270
19289,Laronxe,54303,54,65,80,25,100,94,219,145
19290,Laxou,54304,54,1724,2915,1761,4476,2548,8785,4639
19291,Lay-Saint-Christophe,54305,54,390,495,255,805,395,1455,885
19292,Lay-Saint-Remy,54306,54,40,112,24,96,92,212,152
19293,Lebeuville,54307,54,21,47,0,51,28,79,68
19294,Leintrey,54308,54,38,17,18,43,3,64,55
19295,Lemainville,54309,54,70,100,30,100,75,205,170
19296,Leménil-Mitry,54310,54,0,0,0,0,0,0,0
19297,Lenoncourt,54311,54,28,164,56,192,148,396,192
19298,Lesménils,54312,54,60,130,40,170,85,295,190
19299,Létricourt,54313,54,16,100,24,16,88,128,116
19300,Lexy,54314,54,452,765,298,1131,687,2116,1217
19301,Leyr,54315,54,65,259,75,308,223,606,324
19302,Limey-Remenauville,54316,54,17,56,21,127,25,173,73
19303,Lironville,54317,54,16,50,12,32,28,72,66
19304,Liverdun,54318,54,677,1457,563,1977,1076,3616,2134
19305,Loisy,54320,54,40,85,20,110,80,210,125
19306,Longlaville,54321,54,360,460,205,785,450,1440,820
19307,Longuyon,54322,54,894,1155,504,1774,913,3191,2049
19308,Longwy,54323,54,1990,3135,1869,4231,2727,8827,5125
19309,Lorey,54324,54,17,25,13,18,25,56,42
19310,Loromontzey,54325,54,0,17,4,41,8,53,17
19311,Lubey,54326,54,25,47,20,60,44,124,72
19312,Lucey,54327,54,58,139,43,219,114,376,197
19313,Ludres,54328,54,524,1402,576,2607,1098,4281,1926
19314,Lunéville,54329,54,2472,4722,2500,5744,3216,11460,7194
19315,Lupcourt,54330,54,30,115,35,135,115,285,145
19316,Magnières,54331,54,56,51,18,95,28,141,107
19317,Maidières,54332,54,257,326,104,515,216,835,583
19318,Mailly-sur-Seille,54333,54,40,85,15,70,50,135,125
19319,Mairy-Mainville,54334,54,41,143,40,179,99,318,184
19320,Maixe,54335,54,65,80,20,150,90,260,145
19321,Maizières,54336,54,88,312,76,268,252,596,400
19322,Malavillers,54337,54,28,36,16,36,20,72,64
19323,Malleloy,54338,54,125,300,60,245,240,545,425
19324,Malzéville,54339,54,890,1920,685,2725,1510,4920,2810
19325,Mamey,54340,54,32,96,40,76,84,200,128
19326,Mance,54341,54,90,102,50,198,89,337,192
19327,Mancieulles,54342,54,294,466,161,462,447,1070,760
19328,Mandres-aux-Quatre-Tours,54343,54,18,29,12,34,36,82,47
19329,Mangonville,54344,54,25,70,5,69,60,134,95
19330,Manoncourt-en-Vermois,54345,54,15,115,10,119,85,214,130
19331,Manoncourt-en-Woëvre,54346,54,25,75,25,80,50,155,100
19332,Manonville,54348,54,30,85,5,70,60,135,115
19333,Manonviller,54349,54,30,45,15,45,45,105,75
19334,Marainviller,54350,54,102,135,56,166,125,347,237
19335,Marbache,54351,54,224,428,188,560,312,1060,652
19336,Maron,54352,54,94,209,57,267,164,488,303
19337,Mars-la-Tour,54353,54,95,245,55,290,225,570,340
19338,Marthemont,54354,54,0,10,0,15,20,35,10
19339,Martincourt,54355,54,15,17,10,35,13,58,32
19340,Mattexey,54356,54,0,16,3,24,15,42,16
19341,Maxéville,54357,54,660,2404,1320,2257,1755,5332,3064
19342,Mazerulles,54358,54,33,57,10,66,51,127,90
19343,Méhoncourt,54359,54,10,56,17,84,44,145,66
19344,Ménil-la-Tour,54360,54,33,72,16,90,65,171,105
19345,Mercy-le-Bas,54362,54,192,272,92,448,280,820,464
19346,Mercy-le-Haut,54363,54,20,75,35,80,60,175,95
19347,Méréville,54364,54,115,352,74,532,272,878,467
19348,Merviller,54365,54,50,111,0,148,50,198,161
19349,Messein,54366,54,165,475,230,625,345,1200,640
19350,Mexy,54367,54,251,580,167,710,421,1298,831
19351,Mignéville,54368,54,30,50,10,70,35,115,80
19352,Millery,54369,54,50,140,55,265,120,440,190
19353,Minorville,54370,54,32,108,12,32,72,116,140
19354,Moineville,54371,54,110,255,125,365,200,690,365
19355,Moivrons,54372,54,40,115,40,170,95,305,155
19356,Moncel-lès-Lunéville,54373,54,60,160,60,192,128,380,220
19357,Moncel-sur-Seille,54374,54,25,140,60,165,100,325,165
19358,Montauville,54375,54,145,256,70,405,212,687,401
19359,Montenoy,54376,54,15,135,10,165,105,280,150
19360,Montigny,54377,54,15,20,12,57,3,72,35
19361,Montigny-sur-Chiers,54378,54,52,132,28,136,140,304,184
19362,Mont-l'Étroit,54379,54,15,25,20,30,15,65,40
19363,Mont-le-Vignoble,54380,54,20,100,20,165,85,270,120
19364,Montreux,54381,54,10,10,0,20,15,35,20
19365,Mont-Saint-Martin,54382,54,952,2000,807,2269,1552,4628,2952
19366,Mont-sur-Meurthe,54383,54,125,300,110,392,185,687,425
19367,Morfontaine,54385,54,68,325,90,248,293,631,393
19368,Moriviller,54386,54,15,15,0,40,10,50,30
19369,Morville-sur-Seille,54387,54,0,31,16,36,38,90,31
19370,Mouacourt,54388,54,0,25,5,54,5,64,25
19371,Mouaville,54389,54,6,29,3,9,32,44,35
19372,Mousson,54390,54,10,30,5,46,20,71,40
19373,Moutiers,54391,54,259,290,216,498,235,949,549
19374,Moutrot,54392,54,15,85,15,86,53,154,100
19375,Moyen,54393,54,33,142,37,160,102,299,175
19376,Murville,54394,54,16,49,8,91,47,146,65
19377,Nancy,54395,54,8798,20854,26856,23949,19073,69878,29652
19378,Neufmaisons,54396,54,6,30,9,53,55,117,36
19379,Neuves-Maisons,54397,54,908,1648,827,2021,1286,4134,2556
19380,Neuviller-lès-Badonviller,54398,54,9,16,0,26,17,43,25
19381,Neuviller-sur-Moselle,54399,54,12,48,26,48,47,121,60
19382,Nomeny,54400,54,124,340,68,396,264,728,464
19383,Nonhigny,54401,54,12,41,12,32,24,68,53
19384,Norroy-le-Sec,54402,54,55,105,15,118,105,238,160
19385,Norroy-lès-Pont-à-Mousson,54403,54,150,310,100,460,220,780,460
19386,Noviant-aux-Prés,54404,54,8,84,60,60,56,176,92
19387,Ochey,54405,54,15,180,80,130,105,315,195
19388,Ogéviller,54406,54,35,75,15,134,30,179,110
19389,Ognéville,54407,54,15,28,6,24,16,46,43
19390,Olley,54408,54,28,76,16,80,48,144,104
19391,Omelmont,54409,54,20,39,8,60,29,97,59
19392,Onville,54410,54,32,140,36,128,148,312,172
19393,Ormes-et-Ville,54411,54,25,60,10,90,50,150,85
19394,Othe,54412,54,0,4,0,16,12,28,4
19395,Ozerailles,54413,54,13,27,18,37,19,74,40
19396,Pagney-derrière-Barine,54414,54,48,140,84,242,116,442,188
19397,Pagny-sur-Moselle,54415,54,539,1009,351,1306,819,2476,1548
19398,Pannes,54416,54,10,46,6,41,40,87,56
19399,Parey-Saint-Césaire,54417,54,12,50,13,64,52,129,62
19400,Parroy,54418,54,31,20,23,33,19,75,51
19401,Parux,54419,54,6,9,0,27,13,40,15
19402,Petit-Failly,54420,54,3,24,3,25,16,44,27
19403,Petitmont,54421,54,57,50,22,103,48,173,107
19404,Pettonville,54422,54,12,21,0,8,20,28,33
19405,Pexonne,54423,54,40,105,25,140,65,230,145
19406,Phlin,54424,54,6,10,0,9,12,21,16
19407,Piennes,54425,54,405,645,225,715,445,1385,1050
19408,Pierre-la-Treiche,54426,54,40,100,60,195,95,350,140
19409,Pierre-Percée,54427,54,25,30,10,30,20,60,55
19410,Pierrepont,54428,54,105,195,90,325,155,570,300
19411,Pierreville,54429,54,40,76,48,96,56,200,116
19412,Pompey,54430,54,654,1147,397,1439,749,2585,1801
19413,Pont-à-Mousson,54431,54,1563,3888,1727,4280,2939,8946,5451
19414,Pont-Saint-Vincent,54432,54,275,435,170,620,350,1140,710
19415,Port-sur-Seille,54433,54,6,57,3,70,45,118,63
19416,Praye,54434,54,45,60,15,95,45,155,105
19417,Prény,54435,54,20,80,25,145,80,250,100
19418,Preutin-Higny,54436,54,20,25,5,55,25,85,45
19419,Pulligny,54437,54,101,276,146,439,158,743,377
19420,Pulney,54438,54,20,20,10,10,10,30,40
19421,Pulnoy,54439,54,520,946,375,1701,705,2781,1466
19422,Puxe,54440,54,16,20,13,21,22,56,36
19423,Puxieux,54441,54,5,65,55,70,60,185,70
19424,Quevilloncourt,54442,54,12,18,6,15,18,39,30
19425,Raon-lès-Leau,54443,54,0,4,12,16,8,36,4
19426,Raucourt,54444,54,25,60,10,80,54,144,85
19427,Raville-sur-Sânon,54445,54,8,36,4,24,36,64,44
19428,Réchicourt-la-Petite,54446,54,5,20,5,25,10,40,25
19429,Réclonville,54447,54,21,4,0,24,0,24,25
19430,Rehainviller,54449,54,95,254,77,333,204,614,349
19431,Reherrey,54450,54,39,20,15,45,5,65,59
19432,Réhon,54451,54,515,935,380,1085,935,2400,1450
19433,Reillon,54452,54,4,29,0,20,16,36,33
19434,Rembercourt-sur-Mad,54453,54,5,30,15,90,30,135,35
19435,Remenoville,54455,54,20,50,10,38,50,98,70
19436,Réméréville,54456,54,62,138,42,125,117,284,200
19437,Remoncourt,54457,54,8,8,0,8,8,16,16
19438,Repaix,54458,54,20,8,4,44,8,56,28
19439,Richardménil,54459,54,218,449,206,1109,337,1652,667
19440,Rogéville,54460,54,5,55,10,60,65,135,60
19441,Romain,54461,54,4,16,4,24,20,48,20
19442,Rosières-aux-Salines,54462,54,189,617,285,890,485,1660,806
19443,Rosières-en-Haye,54463,54,16,77,20,61,50,131,93
19444,Rouves,54464,54,0,36,4,36,28,68,36
19445,Roville-devant-Bayon,54465,54,75,215,55,275,200,530,290
19446,Royaumeix,54466,54,15,55,37,102,41,180,70
19447,Rozelieures,54467,54,5,60,5,80,30,115,65
19448,Saffais,54468,54,5,55,5,30,35,70,60
19449,Saint-Ail,54469,54,24,101,60,168,82,310,125
19450,Saint-Baussant,54470,54,12,16,4,28,8,40,28
19451,Saint-Boingt,54471,54,25,20,5,25,10,40,45
19452,Saint-Clément,54472,54,115,179,87,277,133,497,294
19453,Saint-Firmin,54473,54,16,54,3,68,40,111,70
19454,Sainte-Geneviève,54474,54,16,40,16,52,60,128,56
19455,Saint-Germain,54475,54,15,50,0,40,45,85,65
19456,Saint-Jean-lès-Longuyon,54476,54,25,117,69,140,88,297,142
19457,Saint-Julien-lès-Gorze,54477,54,10,50,5,70,25,100,60
19458,Saint-Marcel,54478,54,4,34,0,46,26,72,38
19459,Saint-Mard,54479,54,15,35,5,25,20,50,50
19460,Saint-Martin,54480,54,0,5,15,30,5,50,5
19461,Saint-Maurice-aux-Forges,54481,54,12,28,8,32,24,64,40
19462,Saint-Max,54482,54,1362,1995,1423,2962,1744,6129,3357
19463,Saint-Nicolas-de-Port,54483,54,823,1746,850,2352,1379,4581,2569
19464,Sainte-Pôle,54484,54,15,55,10,50,50,110,70
19465,Saint-Pancré,54485,54,12,92,24,120,68,212,104
19466,Saint-Remimont,54486,54,31,86,22,122,65,209,117
19467,Saint-Rémy-aux-Bois,54487,54,0,20,4,48,20,72,20
19468,Saint-Sauveur,54488,54,4,12,0,16,16,32,16
19469,Saint-Supplet,54489,54,15,20,15,50,40,105,35
19470,Saizerais,54490,54,120,444,116,492,356,964,564
19471,Sancy,54491,54,31,66,10,128,77,215,97
19472,Sanzey,54492,54,9,37,6,35,18,59,46
19473,Saulnes,54493,54,340,540,240,715,595,1550,880
19474,Saulxerotte,54494,54,10,20,10,30,15,55,30
19475,Saulxures-lès-Nancy,54495,54,714,951,294,1418,750,2462,1665
19476,Saulxures-lès-Vannes,54496,54,70,100,39,98,85,222,170
19477,Saxon-Sion,54497,54,4,24,0,24,16,40,28
19478,Seichamps,54498,54,842,1014,400,1666,745,2811,1856
19479,Seicheprey,54499,54,20,20,10,30,15,55,40
19480,Selaincourt,54500,54,26,38,13,37,39,89,64
19481,Seranville,54501,54,8,28,0,36,28,64,36
19482,Serres,54502,54,27,56,15,65,35,115,83
19483,Serrouville,54504,54,40,168,124,192,176,492,208
19484,Sexey-aux-Forges,54505,54,55,178,44,227,121,392,233
19485,Sexey-les-Bois,54506,54,24,63,47,118,55,220,87
19486,Sionviller,54507,54,5,0,10,70,10,90,5
19487,Sivry,54508,54,8,81,8,55,75,138,89
19488,Sommerviller,54509,54,116,193,108,340,184,632,309
19489,Sornéville,54510,54,15,136,36,84,58,178,151
19490,Sponville,54511,54,0,25,15,80,10,105,25
19491,Tanconville,54512,54,10,20,10,50,25,85,30
19492,Tantonville,54513,54,60,165,85,215,115,415,225
19493,Tellancourt,54514,54,25,155,80,205,120,405,180
19494,Thélod,54515,54,24,55,35,84,29,148,79
19495,They-sous-Vaudemont,54516,54,0,8,0,4,8,12,8
19496,Thézey-Saint-Martin,54517,54,15,56,6,63,48,117,71
19497,Thiaucourt-Regniéville,54518,54,141,269,107,295,203,605,410
19498,Thiaville-sur-Meurthe,54519,54,95,111,53,179,62,294,206
19499,Thiébauménil,54520,54,60,115,30,120,80,230,175
19500,Thil,54521,54,246,340,185,472,359,1016,586
19501,Thorey-Lyautey,54522,54,4,29,8,54,17,79,33
19502,Thuilley-aux-Groseilles,54523,54,4,52,24,56,60,140,56
19503,Thumeréville,54524,54,15,15,10,25,5,40,30
19504,Tiercelet,54525,54,89,101,62,226,96,384,190
19505,Tomblaine,54526,54,958,2270,947,2275,1680,4902,3228
19506,Tonnoy,54527,54,80,180,76,240,160,476,260
19507,Toul,54528,54,1674,4015,2120,4395,3000,9515,5689
19508,Tramont-Émy,54529,54,10,10,0,10,5,15,20
19509,Tramont-Lassus,54530,54,8,12,4,20,17,41,20
19510,Tramont-Saint-André,54531,54,0,4,8,20,8,36,4
19511,Tremblecourt,54532,54,32,48,8,72,36,116,80
19512,Trieux,54533,54,264,710,220,724,589,1533,974
19513,Trondes,54534,54,57,147,36,153,103,292,204
19514,Tronville,54535,54,25,65,5,70,35,110,90
19515,Tucquegnieux,54536,54,555,475,220,870,395,1485,1030
19516,Ugny,54537,54,40,195,65,275,150,490,235
19517,Uruffe,54538,54,40,93,47,104,63,214,133
19518,Vacqueville,54539,54,30,60,15,85,65,165,90
19519,Val-et-Châtillon,54540,54,115,135,50,245,70,365,250
19520,Valhey,54541,54,8,64,12,40,56,108,72
19521,Valleroy,54542,54,300,539,242,814,428,1484,839
19522,Vallois,54543,54,25,38,4,38,20,62,63
19523,Vandelainville,54544,54,13,17,3,54,18,75,30
19524,Vandeléville,54545,54,16,64,8,59,46,113,80
19525,Vandières,54546,54,110,165,95,383,165,643,275
19526,Vandoeuvre-lès-Nancy,54547,54,2966,7437,6049,7567,4445,18061,10403
19527,Vannes-le-Châtel,54548,54,75,140,25,215,95,335,215
19528,Varangéville,54549,54,564,852,347,1224,725,2296,1416
19529,Vathiménil,54550,54,40,105,35,119,55,209,145
19530,Vaucourt,54551,54,12,12,0,20,16,36,24
19531,Vaudémont,54552,54,0,5,15,25,5,45,5
19532,Vaudeville,54553,54,15,41,3,54,43,100,56
19533,Vaudigny,54554,54,8,20,8,16,16,40,28
19534,Vaxainville,54555,54,15,55,5,30,15,50,70
19535,Vého,54556,54,15,25,0,30,25,55,40
19536,Velaine-en-Haye,54557,54,134,450,197,595,385,1177,584
19537,Velaine-sous-Amance,54558,54,31,38,27,86,40,153,69
19538,Velle-sur-Moselle,54559,54,55,65,10,110,50,170,120
19539,Veney,54560,54,10,15,0,10,20,30,25
19540,Vennezey,54561,54,25,25,0,0,20,20,50
19541,Verdenal,54562,54,8,39,18,38,21,77,47
19542,Vézelise,54563,54,135,370,135,375,305,815,505
19543,Viéville-en-Haye,54564,54,9,43,0,57,26,83,52
19544,Vigneulles,54565,54,10,68,3,80,50,133,78
19545,Vilcey-sur-Trey,54566,54,0,25,0,33,31,64,25
19546,Villacourt,54567,54,37,91,39,129,66,234,128
19547,Ville-au-Montois,54568,54,40,85,15,75,60,150,125
19548,Ville-au-Val,54569,54,12,72,12,52,48,112,84
19549,Villecey-sur-Mad,54570,54,12,88,27,77,82,186,100
19550,Ville-en-Vermois,54571,54,32,156,36,276,88,400,188
19551,Ville-Houdlémont,54572,54,55,185,60,195,170,425,240
19552,Villers-en-Haye,54573,54,15,30,10,60,45,115,45
19553,Villers-la-Chèvre,54574,54,30,115,70,245,105,420,145
19554,Villers-la-Montagne,54575,54,118,284,168,574,242,984,402
19555,Villers-le-Rond,54576,54,8,17,4,44,17,65,25
19556,Villers-lès-Moivrons,54577,54,0,62,12,20,35,67,62
19557,Villers-lès-Nancy,54578,54,2472,2690,1637,4439,2295,8371,5162
19558,Villers-sous-Prény,54579,54,40,75,42,69,72,183,115
19559,Villerupt,54580,54,1510,1896,1124,2896,1868,5888,3406
19560,Ville-sur-Yron,54581,54,30,70,20,110,70,200,100
19561,Villette,54582,54,27,34,10,54,32,96,61
19562,Villey-le-Sec,54583,54,20,95,70,195,30,295,115
19563,Villey-Saint-Étienne,54584,54,99,278,80,335,230,645,377
19564,Virecourt,54585,54,67,110,30,140,95,265,177
19565,Viterne,54586,54,75,215,60,240,165,465,290
19566,Vitrey,54587,54,19,65,10,47,50,107,84
19567,Vitrimont,54588,54,52,88,44,112,92,248,140
19568,Vittonville,54589,54,0,20,6,49,18,73,20
19569,Viviers-sur-Chiers,54590,54,83,114,31,216,128,375,197
19570,Voinémont,54591,54,19,90,23,120,55,198,109
19571,Vroncourt,54592,54,20,70,25,106,50,181,90
19572,Waville,54593,54,30,125,30,150,95,275,155
19573,Xammes,54594,54,10,50,35,35,30,100,60
19574,Xermaménil,54595,54,22,143,41,175,120,336,165
19575,Xeuilley,54596,54,64,182,64,314,144,522,246
19576,Xirocourt,54597,54,60,108,36,112,120,268,168
19577,Xivry-Circourt,54598,54,56,80,16,80,68,164,136
19578,Xonville,54599,54,0,40,20,60,15,95,40
19579,Xousse,54600,54,16,24,0,36,12,48,40
19580,Xures,54601,54,20,30,5,40,20,65,50
19581,Han-devant-Pierrepont,54602,54,24,64,4,40,44,88,88
19582,Abainville,55001,55,20,67,21,130,34,185,87
19583,Abaucourt-Hautecourt,55002,55,20,24,8,40,20,68,44
19584,Aincreville,55004,55,15,15,0,30,10,40,30
19585,Amanty,55005,55,10,0,0,20,0,20,10
19586,Ambly-sur-Meuse,55007,55,35,65,20,74,60,154,100
19587,Amel-sur-l'Étang,55008,55,40,45,6,23,30,59,85
19588,Ancemont,55009,55,47,151,34,164,112,310,198
19589,Ancerville,55010,55,311,646,230,961,505,1696,957
19590,Andernay,55011,55,21,51,34,68,37,139,72
19591,Apremont-la-Forêt,55012,55,29,107,4,124,89,217,136
19592,Arrancy-sur-Crusne,55013,55,16,154,16,135,117,268,170
19593,Aubréville,55014,55,53,76,44,134,42,220,129
19594,Aulnois-en-Perthois,55015,55,20,160,10,205,100,315,180
19595,Autrécourt-sur-Aire,55017,55,16,12,12,41,9,62,28
19596,Autréville-Saint-Lambert,55018,55,8,16,0,8,12,20,24
19597,Avillers-Sainte-Croix,55021,55,10,10,5,15,10,30,20
19598,Avioth,55022,55,0,12,8,84,4,96,12
19599,Avocourt,55023,55,15,20,0,35,30,65,35
19600,Azannes-et-Soumazannes,55024,55,5,35,25,65,30,120,40
19601,Baâlon,55025,55,52,80,24,64,72,160,132
19602,Badonvilliers-Gérauvilliers,55026,55,20,40,15,35,40,90,60
19603,Bannoncourt,55027,55,20,40,10,60,30,100,60
19604,Bantheville,55028,55,30,30,10,30,25,65,60
19605,Bar-le-Duc,55029,55,2106,3313,1744,5093,2517,9354,5419
19606,Baudignécourt,55030,55,20,5,0,20,10,30,25
19607,Baudonvilliers,55031,55,40,55,15,215,55,285,95
19608,Baudrémont,55032,55,10,15,5,10,15,30,25
19609,Baulny,55033,55,5,0,0,0,0,0,5
19610,Bazeilles-sur-Othain,55034,55,5,25,15,40,30,85,30
19611,Bazincourt-sur-Saulx,55035,55,20,30,5,50,40,95,50
19612,Beauclair,55036,55,0,28,4,40,16,60,28
19613,Beaufort-en-Argonne,55037,55,20,20,10,50,30,90,40
19614,Beaulieu-en-Argonne,55038,55,10,10,0,10,10,20,20
19615,Beaumont-en-Verdunois,55039,55,0,0,0,0,0,0,0
19616,Beausite,55040,55,47,39,17,66,44,127,86
19617,Behonne,55041,55,90,100,35,325,60,420,190
19618,Belleray,55042,55,56,100,56,180,76,312,156
19619,Belleville-sur-Meuse,55043,55,416,636,350,1149,504,2003,1052
19620,Belrain,55044,55,8,8,4,4,8,16,16
19621,Belrupt-en-Verdunois,55045,55,24,135,41,213,132,386,159
19622,Beney-en-Woëvre,55046,55,10,25,20,45,25,90,35
19623,Béthelainville,55047,55,15,70,5,40,70,115,85
19624,Béthincourt,55048,55,12,8,0,4,8,12,20
19625,Beurey-sur-Saulx,55049,55,46,65,36,153,53,242,111
19626,Bezonvaux,55050,55,0,0,0,0,0,0,0
19627,Biencourt-sur-Orge,55051,55,4,21,0,39,32,71,25
19628,Billy-sous-Mangiennes,55053,55,28,100,52,120,52,224,128
19629,Bislée,55054,55,9,8,0,25,8,33,17
19630,Blanzée,55055,55,0,0,5,15,0,20,0
19631,Boinville-en-Woëvre,55057,55,4,20,8,20,20,48,24
19632,Boncourt-sur-Meuse,55058,55,30,85,15,145,70,230,115
19633,Bonnet,55059,55,36,52,20,76,24,120,88
19634,Bonzée,55060,55,45,85,10,160,55,225,130
19635,Le Bouchon-sur-Saulx,55061,55,28,64,32,84,40,156,92
19636,Bouconville-sur-Madt,55062,55,12,16,20,24,8,52,28
19637,Bouligny,55063,55,539,613,275,772,391,1438,1152
19638,Bouquemont,55064,55,32,47,10,37,10,57,79
19639,Boureuilles,55065,55,6,18,3,65,9,77,24
19640,Bovée-sur-Barboure,55066,55,20,56,8,28,48,84,76
19641,Boviolles,55067,55,10,29,25,30,28,83,39
19642,Brabant-en-Argonne,55068,55,30,40,5,30,20,55,70
19643,Brabant-le-Roi,55069,55,25,38,9,82,33,124,63
19644,Brabant-sur-Meuse,55070,55,12,44,12,32,24,68,56
19645,Brandeville,55071,55,20,52,12,60,40,112,72
19646,Braquis,55072,55,35,25,10,30,15,55,60
19647,Bras-sur-Meuse,55073,55,104,170,50,200,155,405,274
19648,Brauvilliers,55075,55,9,34,6,37,42,85,43
19649,Bréhéville,55076,55,30,31,0,65,35,100,61
19650,Breux,55077,55,28,56,36,96,44,176,84
19651,Brieulles-sur-Meuse,55078,55,48,80,12,128,60,200,128
19652,Brillon-en-Barrois,55079,55,50,145,59,253,110,422,195
19653,Brixey-aux-Chanoines,55080,55,15,10,5,40,10,55,25
19654,Brizeaux,55081,55,9,0,0,28,4,32,9
19655,Brocourt-en-Argonne,55082,55,4,4,8,12,13,33,8
19656,Brouennes,55083,55,15,30,25,50,35,110,45
19657,Broussey-en-Blois,55084,55,8,13,0,20,8,28,21
19658,Broussey-Raulecourt,55085,55,32,52,36,92,48,176,84
19659,Bure,55087,55,12,12,9,23,9,41,24
19660,Burey-en-Vaux,55088,55,30,25,20,50,30,100,55
19661,Burey-la-Côte,55089,55,16,12,8,16,12,36,28
19662,Buxières-sous-les-Côtes,55093,55,46,51,12,137,35,184,97
19663,Buzy-Darmont,55094,55,85,145,20,215,90,325,230
19664,Cesse,55095,55,8,44,8,24,44,76,52
19665,Chaillon,55096,55,4,36,4,56,16,76,40
19666,Chalaines,55097,55,40,76,40,104,64,208,116
19667,Champneuville,55099,55,16,28,8,48,20,76,44
19668,Champougny,55100,55,12,40,4,32,24,60,52
19669,Chardogne,55101,55,40,80,32,92,64,188,120
19670,Charny-sur-Meuse,55102,55,95,140,30,155,125,310,235
19671,Charpentry,55103,55,0,0,0,12,0,12,0
19672,Chassey-Beaupré,55104,55,22,27,9,15,15,39,49
19673,Châtillon-sous-les-Côtes,55105,55,24,39,16,33,24,73,63
19674,Chattancourt,55106,55,8,40,22,58,35,115,48
19675,Chaumont-devant-Damvillers,55107,55,0,25,0,15,15,30,25
19676,Chaumont-sur-Aire,55108,55,17,24,3,45,27,75,41
19677,Chauvency-le-Château,55109,55,25,70,25,70,60,155,95
19678,Chauvency-Saint-Hubert,55110,55,24,56,28,92,44,164,80
19679,Chauvoncourt,55111,55,53,83,27,184,61,272,136
19680,Cheppy,55113,55,12,36,12,28,32,72,48
19681,Chonville-Malaumont,55114,55,25,35,20,100,20,140,60
19682,Cierges-sous-Montfaucon,55115,55,14,10,5,20,5,30,24
19683,Le Claon,55116,55,12,17,8,12,8,28,29
19684,Clermont-en-Argonne,55117,55,149,273,65,587,223,875,422
19685,Cléry-le-Grand,55118,55,12,25,4,12,20,36,37
19686,Cléry-le-Petit,55119,55,70,45,20,25,20,65,115
19687,Combles-en-Barrois,55120,55,101,159,35,333,151,519,260
19688,Combres-sous-les-Côtes,55121,55,17,30,8,24,30,62,47
19689,Commercy,55122,55,790,1380,577,1683,1097,3357,2170
19690,Les Hauts-de-Chée,55123,55,92,180,40,276,164,480,272
19691,Consenvoye,55124,55,56,68,44,76,60,180,124
19692,Contrisson,55125,55,79,203,77,233,139,449,282
19693,Courcelles-en-Barrois,55127,55,5,5,5,10,5,20,10
19694,Courcelles-sur-Aire,55128,55,8,8,0,4,16,20,16
19695,Courouvre,55129,55,6,0,0,12,0,12,6
19696,Cousances-les-Forges,55132,55,178,386,179,551,301,1031,564
19697,Couvertpuis,55133,55,15,20,5,35,15,55,35
19698,Couvonges,55134,55,3,41,12,31,44,87,44
19699,Cuisy,55137,55,8,16,4,20,12,36,24
19700,Culey,55138,55,8,20,20,60,36,116,28
19701,Cumières-le-Mort-Homme,55139,55,0,0,0,0,0,0,0
19702,Cunel,55140,55,0,10,0,0,10,10,10
19703,Dagonville,55141,55,12,20,4,32,16,52,32
19704,Dainville-Bertheléville,55142,55,37,10,0,63,10,73,47
19705,Damloup,55143,55,9,39,0,24,40,64,48
19706,Dammarie-sur-Saulx,55144,55,103,100,35,135,75,245,203
19707,Damvillers,55145,55,100,160,65,245,80,390,260
19708,Dannevoux,55146,55,25,55,18,55,29,102,80
19709,Delouze-Rosières,55148,55,5,30,10,45,20,75,35
19710,Delut,55149,55,20,32,4,32,28,64,52
19711,Demange-aux-Eaux,55150,55,55,90,60,225,85,370,145
19712,Dieppe-sous-Douaumont,55153,55,35,60,15,50,30,95,95
19713,Dieue-sur-Meuse,55154,55,82,342,79,534,268,881,424
19714,Dombasle-en-Argonne,55155,55,56,100,52,128,88,268,156
19715,Dombras,55156,55,8,28,20,52,28,100,36
19716,Dommartin-la-Montagne,55157,55,0,15,5,25,10,40,15
19717,Dommary-Baroncourt,55158,55,110,195,56,179,170,405,305
19718,Dompcevrin,55159,55,70,85,10,130,50,190,155
19719,Dompierre-aux-Bois,55160,55,5,5,0,25,5,30,10
19720,Domremy-la-Canne,55162,55,4,4,0,16,0,16,8
19721,Doncourt-aux-Templiers,55163,55,12,24,8,28,12,48,36
19722,Douaumont,55164,55,0,0,0,0,0,0,0
19723,Doulcon,55165,55,35,125,20,170,110,300,160
19724,Dugny-sur-Meuse,55166,55,140,292,110,472,215,797,432
19725,Dun-sur-Meuse,55167,55,85,125,35,255,60,350,210
19726,Duzey,55168,55,5,10,10,15,10,35,15
19727,Écouviez,55169,55,24,136,48,164,120,332,160
19728,Écurey-en-Verdunois,55170,55,40,25,15,30,25,70,65
19729,Eix,55171,55,25,75,10,75,50,135,100
19730,Les Éparges,55172,55,13,20,3,15,6,24,33
19731,Épiez-sur-Meuse,55173,55,8,13,4,8,8,20,21
19732,Épinonville,55174,55,12,16,8,28,8,44,28
19733,Érize-la-Brûlée,55175,55,21,29,16,62,20,98,50
19734,Érize-la-Petite,55177,55,0,15,0,20,25,45,15
19735,Érize-Saint-Dizier,55178,55,10,40,15,60,60,135,50
19736,Erneville-aux-Bois,55179,55,24,32,28,48,32,108,56
19737,Esnes-en-Argonne,55180,55,10,50,0,40,40,80,60
19738,Étain,55181,55,523,969,397,993,662,2052,1492
19739,Éton,55182,55,22,41,12,55,29,96,63
19740,Étraye,55183,55,5,0,0,20,0,20,5
19741,Euville,55184,55,225,380,155,610,280,1045,605
19742,Èvres,55185,55,20,25,5,30,25,60,45
19743,Fains-Véel,55186,55,410,375,125,760,315,1200,785
19744,Flassigny,55188,55,0,20,5,25,10,40,20
19745,Fleury-devant-Douaumont,55189,55,0,0,0,0,0,0,0
19746,Foameix-Ornel,55191,55,16,70,16,55,50,121,86
19747,Fontaines-Saint-Clair,55192,55,12,8,8,12,4,24,20
19748,Forges-sur-Meuse,55193,55,26,8,21,38,8,67,34
19749,Foucaucourt-sur-Thabas,55194,55,0,25,0,30,15,45,25
19750,Fouchères-aux-Bois,55195,55,12,36,16,64,16,96,48
19751,Frémeréville-sous-les-Côtes,55196,55,12,44,16,36,28,80,56
19752,Fresnes-au-Mont,55197,55,5,40,0,64,45,109,45
19753,Fresnes-en-Woëvre,55198,55,105,156,65,201,127,393,261
19754,Froidos,55199,55,20,24,8,36,12,56,44
19755,Fromeréville-les-Vallons,55200,55,3,44,14,94,24,132,47
19756,Fromezey,55201,55,5,10,0,25,20,45,15
19757,Futeau,55202,55,35,25,25,60,5,90,60
19758,Génicourt-sur-Meuse,55204,55,16,76,28,84,52,164,92
19759,Gercourt-et-Drillancourt,55206,55,18,36,6,36,54,96,54
19760,Géry,55207,55,10,20,0,15,15,30,30
19761,Gesnes-en-Argonne,55208,55,8,16,0,25,9,34,24
19762,Gimécourt,55210,55,4,4,0,4,8,12,8
19763,Gincrey,55211,55,10,15,0,20,5,25,25
19764,Girauvoisin,55212,55,20,16,4,24,16,44,36
19765,Givrauval,55214,55,33,88,15,79,49,143,121
19766,Gondrecourt-le-Château,55215,55,167,204,70,412,167,649,371
19767,Gouraincourt,55216,55,16,12,16,4,8,28,28
19768,Goussaincourt,55217,55,16,28,8,44,32,84,44
19769,Gremilly,55218,55,0,20,0,10,10,20,20
19770,Grimaucourt-en-Woëvre,55219,55,8,24,12,20,24,56,32
19771,Grimaucourt-près-Sampigny,55220,55,5,21,5,30,10,45,26
19772,Guerpont,55221,55,36,56,24,96,36,156,92
19773,Gussainville,55222,55,0,5,0,20,15,35,5
19774,Haironville,55224,55,60,182,35,190,137,362,242
19775,Halles-sous-les-Côtes,55225,55,16,60,20,36,36,92,76
19776,Han-lès-Juvigny,55226,55,16,45,4,28,32,64,61
19777,Hannonville-sous-les-Côtes,55228,55,99,127,24,173,86,283,226
19778,Han-sur-Meuse,55229,55,32,80,25,54,53,132,112
19779,Harville,55232,55,20,21,9,24,24,57,41
19780,Haudainville,55236,55,59,226,95,317,185,597,285
19781,Haudiomont,55237,55,35,50,25,80,30,135,85
19782,Haumont-près-Samogneux,55239,55,0,0,0,0,0,0,0
19783,Heippes,55241,55,16,24,4,12,20,36,40
19784,Hennemont,55242,55,12,20,3,31,19,53,32
19785,Herbeuville,55243,55,0,38,4,101,16,121,38
19786,Herméville-en-Woëvre,55244,55,30,62,13,56,40,109,92
19787,Heudicourt-sous-les-Côtes,55245,55,15,40,15,70,30,115,55
19788,Hévilliers,55246,55,31,13,6,38,16,60,44
19789,Horville-en-Ornois,55247,55,10,5,5,10,10,25,15
19790,Houdelaincourt,55248,55,46,69,22,97,47,166,115
19791,Inor,55250,55,30,30,20,53,24,97,60
19792,Ippécourt,55251,55,29,26,0,21,13,34,55
19793,Iré-le-Sec,55252,55,15,37,24,37,18,79,52
19794,Les Islettes,55253,55,129,190,70,230,155,455,319
19795,Les Trois-Domaines,55254,55,25,35,0,40,25,65,60
19796,Jametz,55255,55,25,53,23,62,51,136,78
19797,Jonville-en-Woëvre,55256,55,12,39,8,33,33,74,51
19798,Jouy-en-Argonne,55257,55,3,13,0,15,15,30,16
19799,Geville,55258,55,72,188,64,176,116,356,260
19800,Julvécourt,55260,55,16,8,4,20,4,28,24
19801,Juvigny-en-Perthois,55261,55,18,21,3,47,13,63,39
19802,Juvigny-sur-Loison,55262,55,28,60,20,64,68,152,88
19803,Koeur-la-Grande,55263,55,10,40,10,75,25,110,50
19804,Koeur-la-Petite,55264,55,20,75,20,120,60,200,95
19805,Labeuville,55265,55,12,36,4,40,36,80,48
19806,Lachalade,55266,55,4,28,0,24,20,44,32
19807,Lachaussée,55267,55,10,60,20,95,55,170,70
19808,Lacroix-sur-Meuse,55268,55,48,180,84,229,115,428,228
19809,Lahaymeix,55269,55,0,35,0,25,35,60,35
19810,Lahayville,55270,55,0,8,0,12,8,20,8
19811,Laheycourt,55271,55,52,95,22,142,59,223,147
19812,Laimont,55272,55,34,106,26,139,99,264,140
19813,Lamorville,55274,55,33,54,27,105,26,158,87
19814,Lamouilly,55275,55,15,25,10,35,15,60,40
19815,Landrecourt-Lempire,55276,55,25,51,17,48,49,114,76
19816,Laneuville-au-Rupt,55278,55,25,60,10,60,30,100,85
19817,Laneuville-sur-Meuse,55279,55,50,110,40,165,55,260,160
19818,Lanhères,55280,55,10,15,0,30,10,40,25
19819,Latour-en-Woëvre,55281,55,20,28,8,24,16,48,48
19820,Lavallée,55282,55,6,20,6,24,13,43,26
19821,Lavincourt,55284,55,4,8,8,28,24,60,12
19822,Lavoye,55285,55,16,18,3,60,15,78,34
19823,Lemmes,55286,55,9,103,20,65,55,140,112
19824,Lérouville,55288,55,156,404,167,451,218,836,560
19825,Levoncourt,55289,55,0,9,6,21,0,27,9
19826,Lignières-sur-Aire,55290,55,12,16,12,4,12,28,28
19827,Ligny-en-Barrois,55291,55,598,829,330,1471,659,2460,1427
19828,Liny-devant-Dun,55292,55,15,35,10,75,40,125,50
19829,Lion-devant-Dun,55293,55,50,25,20,60,10,90,75
19830,Lisle-en-Barrois,55295,55,4,12,4,12,8,24,16
19831,Lisle-en-Rigault,55296,55,75,110,40,170,80,290,185
19832,Lissey,55297,55,26,29,3,30,18,51,55
19833,Loisey,55298,55,52,104,8,84,76,168,156
19834,Loison,55299,55,20,30,0,20,40,60,50
19835,Longeaux,55300,55,16,64,20,84,44,148,80
19836,Longchamps-sur-Aire,55301,55,22,26,9,35,14,58,48
19837,Longeville-en-Barrois,55302,55,175,255,95,495,140,730,430
19838,Loupmont,55303,55,19,0,10,25,3,38,19
19839,Louppy-le-Château,55304,55,25,30,5,35,50,90,55
19840,Louppy-sur-Loison,55306,55,20,36,16,40,20,76,56
19841,Louvemont-Côte-du-Poivre,55307,55,0,0,0,0,0,0,0
19842,Luzy-Saint-Martin,55310,55,16,24,12,48,12,72,40
19843,Maizeray,55311,55,5,0,0,10,0,10,5
19844,Maizey,55312,55,18,20,3,71,15,89,38
19845,Malancourt,55313,55,10,5,10,30,14,54,15
19846,Mandres-en-Barrois,55315,55,30,30,15,40,20,75,60
19847,Mangiennes,55316,55,80,108,32,92,88,212,188
19848,Manheulles,55317,55,6,25,12,56,19,87,31
19849,Marchéville-en-Woëvre,55320,55,0,30,3,25,16,44,30
19850,Marre,55321,55,8,34,8,59,26,93,42
19851,Marson-sur-Barboure,55322,55,5,15,10,15,10,35,20
19852,Martincourt-sur-Meuse,55323,55,20,12,8,0,16,24,32
19853,Marville,55324,55,60,85,45,215,94,354,145
19854,Maucourt-sur-Orne,55325,55,15,5,15,20,0,35,20
19855,Maulan,55326,55,4,30,12,33,25,70,34
19856,Mauvages,55327,55,12,60,50,86,32,168,72
19857,Maxey-sur-Vaise,55328,55,24,48,60,120,44,224,72
19858,Mécrin,55329,55,25,45,30,100,20,150,70
19859,Méligny-le-Grand,55330,55,16,24,20,28,8,56,40
19860,Méligny-le-Petit,55331,55,5,35,10,35,10,55,40
19861,Menaucourt,55332,55,36,37,9,97,28,134,73
19862,Ménil-aux-Bois,55333,55,5,10,0,15,10,25,15
19863,Ménil-la-Horgne,55334,55,8,68,12,48,48,108,76
19864,Ménil-sur-Saulx,55335,55,48,84,28,88,60,176,132
19865,Merles-sur-Loison,55336,55,15,35,20,50,30,100,50
19866,Milly-sur-Bradon,55338,55,44,40,8,60,24,92,84
19867,Mogeville,55339,55,4,22,0,16,29,45,26
19868,Mognéville,55340,55,61,62,21,106,65,192,123
19869,Moirey-Flabas-Crépion,55341,55,5,30,15,50,30,95,35
19870,Montblainville,55343,55,12,8,0,24,8,32,20
19871,Montbras,55344,55,9,6,0,3,0,3,15
19872,Mont-devant-Sassey,55345,55,5,15,28,35,10,73,20
19873,Montfaucon-d'Argonne,55346,55,36,75,15,93,45,153,111
19874,Les Monthairons,55347,55,20,120,30,115,105,250,140
19875,Montiers-sur-Saulx,55348,55,72,120,20,140,92,252,192
19876,Montigny-devant-Sassey,55349,55,35,15,15,45,15,75,50
19877,Montigny-lès-Vaucouleurs,55350,55,30,0,0,40,0,40,30
19878,Montmédy,55351,55,320,405,209,615,353,1177,725
19879,Montplonne,55352,55,23,20,9,42,20,71,43
19880,Montsec,55353,55,10,25,0,25,20,45,35
19881,Montzéville,55355,55,22,31,13,46,30,89,53
19882,Moranville,55356,55,0,30,5,45,25,75,30
19883,Morgemoulin,55357,55,12,27,4,28,21,53,39
19884,Chanteraine,55358,55,30,35,15,85,25,125,65
19885,Morley,55359,55,10,50,20,75,45,140,60
19886,Mouilly,55360,55,8,28,12,44,20,76,36
19887,Moulainville,55361,55,15,25,20,60,10,90,40
19888,Moulins-Saint-Hubert,55362,55,20,55,15,70,15,100,75
19889,Moulotte,55363,55,10,25,10,40,25,75,35
19890,Mouzay,55364,55,124,125,44,314,94,452,249
19891,Murvaux,55365,55,40,25,0,60,20,80,65
19892,Val-d'Ornain,55366,55,96,228,60,404,164,628,324
19893,Muzeray,55367,55,5,60,0,35,35,70,65
19894,Naives-en-Blois,55368,55,20,40,30,20,35,85,60
19895,Naives-Rosières,55369,55,94,160,52,312,117,481,254
19896,Naix-aux-Forges,55370,55,32,33,6,46,48,100,65
19897,Nançois-le-Grand,55371,55,8,20,8,16,16,40,28
19898,Nançois-sur-Ornain,55372,55,55,60,50,170,50,270,115
19899,Nant-le-Grand,55373,55,5,35,10,30,15,55,40
19900,Nant-le-Petit,55374,55,16,16,16,36,4,56,32
19901,Nantillois,55375,55,10,5,15,35,5,55,15
19902,Nantois,55376,55,0,15,12,24,12,48,15
19903,Nepvant,55377,55,20,24,4,20,20,44,44
19904,Nettancourt,55378,55,33,50,37,105,10,152,83
19905,Le Neufour,55379,55,5,10,5,35,10,50,15
19906,Neuville-en-Verdunois,55380,55,17,15,5,30,10,45,32
19907,Neuville-lès-Vaucouleurs,55381,55,25,50,30,35,30,95,75
19908,Neuville-sur-Ornain,55382,55,60,84,12,108,88,208,144
19909,Neuvilly-en-Argonne,55383,55,16,56,28,84,32,144,72
19910,Nicey-sur-Aire,55384,55,10,25,5,60,20,85,35
19911,Nixéville-Blercourt,55385,55,48,112,60,172,80,312,160
19912,Nonsard-Lamarche,55386,55,8,60,30,29,55,114,68
19913,Nouillonpont,55387,55,45,65,25,90,25,140,110
19914,Noyers-Auzécourt,55388,55,28,84,40,68,64,172,112
19915,Nubécourt,55389,55,28,54,24,67,41,132,82
19916,Olizy-sur-Chiers,55391,55,15,40,25,85,35,145,55
19917,Ornes,55394,55,0,0,0,0,0,0,0
19918,Osches,55395,55,10,15,10,25,5,40,25
19919,Ourches-sur-Meuse,55396,55,43,54,25,46,20,91,97
19920,Pagny-la-Blanche-Côte,55397,55,25,65,15,85,60,160,90
19921,Pagny-sur-Meuse,55398,55,96,290,96,348,188,632,386
19922,Pareid,55399,55,5,50,5,45,25,75,55
19923,Parfondrupt,55400,55,3,10,0,15,9,24,13
19924,Les Paroches,55401,55,60,95,20,180,65,265,155
19925,Peuvillers,55403,55,5,15,5,20,15,40,20
19926,Pierrefitte-sur-Aire,55404,55,30,80,30,105,40,175,110
19927,Pillon,55405,55,24,64,36,76,64,176,88
19928,Pintheville,55406,55,4,28,12,24,32,68,32
19929,Pont-sur-Meuse,55407,55,45,10,15,45,20,80,55
19930,Pouilly-sur-Meuse,55408,55,40,40,15,65,20,100,80
19931,Pretz-en-Argonne,55409,55,15,20,0,10,20,30,35
19932,Quincy-Landzécourt,55410,55,19,34,12,33,23,68,53
19933,Rambluzin-et-Benoite-Vaux,55411,55,8,20,4,33,12,49,28
19934,Rambucourt,55412,55,36,56,24,36,48,108,92
19935,Rancourt-sur-Ornain,55414,55,25,42,6,61,31,98,67
19936,Ranzières,55415,55,5,25,20,35,5,60,30
19937,Rarécourt,55416,55,34,38,16,63,23,102,72
19938,Récicourt,55419,55,20,30,10,55,40,105,50
19939,Récourt-le-Creux,55420,55,20,20,4,20,12,36,40
19940,Reffroy,55421,55,8,22,0,12,8,20,30
19941,Regnéville-sur-Meuse,55422,55,8,8,0,20,12,32,16
19942,Rembercourt-Sommaisne,55423,55,38,81,33,95,52,180,119
19943,Remennecourt,55424,55,20,0,10,20,5,35,20
19944,Remoiville,55425,55,18,36,6,36,22,64,54
19945,Resson,55426,55,33,95,23,153,58,234,128
19946,Revigny-sur-Ornain,55427,55,443,691,380,901,465,1746,1134
19947,Réville-aux-Bois,55428,55,10,10,25,50,15,90,20
19948,Riaville,55429,55,10,0,5,25,0,30,10
19949,Ribeaucourt,55430,55,36,12,0,36,6,42,48
19950,Richecourt,55431,55,9,10,3,18,9,30,19
19951,Rigny-la-Salle,55433,55,45,127,20,115,77,212,172
19952,Rigny-Saint-Martin,55434,55,0,15,5,35,10,50,15
19953,Robert-Espagne,55435,55,65,210,100,353,130,583,275
19954,Les Roises,55436,55,0,10,0,20,5,25,10
19955,Romagne-sous-les-Côtes,55437,55,0,30,3,35,25,63,30
19956,Romagne-sous-Montfaucon,55438,55,16,60,4,60,40,104,76
19957,Ronvaux,55439,55,20,30,15,30,10,55,50
19958,Raival,55442,55,30,66,5,86,60,151,96
19959,Rouvres-en-Woëvre,55443,55,20,92,45,97,78,220,112
19960,Rouvrois-sur-Meuse,55444,55,12,43,12,67,34,113,55
19961,Rouvrois-sur-Othain,55445,55,24,60,0,75,38,113,84
19962,Rumont,55446,55,5,20,30,10,15,55,25
19963,Rupt-aux-Nonains,55447,55,41,70,22,95,70,187,111
19964,Rupt-devant-Saint-Mihiel,55448,55,0,25,0,35,5,40,25
19965,Rupt-en-Woëvre,55449,55,34,49,34,89,69,192,83
19966,Rupt-sur-Othain,55450,55,9,18,0,16,7,23,27
19967,Saint-Amand-sur-Ornain,55452,55,6,12,0,42,18,60,18
19968,Saint-André-en-Barrois,55453,55,12,25,8,12,8,28,37
19969,Saint-Aubin-sur-Aire,55454,55,25,55,5,55,40,100,80
19970,Saint-Germain-sur-Meuse,55456,55,50,85,5,60,70,135,135
19971,Saint-Hilaire-en-Woëvre,55457,55,35,45,5,65,20,90,80
19972,Saint-Jean-lès-Buzy,55458,55,36,116,24,116,84,224,152
19973,Saint-Joire,55459,55,17,45,23,67,37,127,62
19974,Saint-Julien-sous-les-Côtes,55460,55,24,32,12,28,36,76,56
19975,Saint-Laurent-sur-Othain,55461,55,30,165,33,104,130,267,195
19976,Saint-Maurice-sous-les-Côtes,55462,55,38,113,20,124,64,208,151
19977,Saint-Mihiel,55463,55,556,742,457,1320,574,2351,1298
19978,Saint-Pierrevillers,55464,55,15,35,25,65,25,115,50
19979,Saint-Remy-la-Calonne,55465,55,4,25,34,32,8,74,29
19980,Salmagne,55466,55,25,65,15,145,55,215,90
19981,Sampigny,55467,55,46,179,96,222,122,440,225
19982,Samogneux,55468,55,8,24,12,32,16,60,32
19983,Sassey-sur-Meuse,55469,55,25,25,5,30,20,55,50
19984,Saudrupt,55470,55,25,45,15,69,45,129,70
19985,Saulmory-et-Villefranche,55471,55,34,3,12,24,3,39,37
19986,Saulvaux,55472,55,20,17,4,50,8,62,37
19987,Saulx-lès-Champlon,55473,55,24,36,12,44,8,64,60
19988,Sauvigny,55474,55,25,40,15,161,5,181,65
19989,Sauvoy,55475,55,10,15,0,30,5,35,25
19990,Savonnières-devant-Bar,55476,55,65,102,26,152,86,264,167
19991,Savonnières-en-Perthois,55477,55,55,115,15,175,75,265,170
19992,Seigneulles,55479,55,30,30,10,60,40,110,60
19993,Senon,55481,55,16,120,27,70,72,169,136
19994,Senoncourt-les-Maujouy,55482,55,0,7,6,34,15,55,7
19995,Septsarges,55484,55,0,12,0,20,12,32,12
19996,Sepvigny,55485,55,6,20,0,31,3,34,26
19997,Seuzey,55487,55,12,17,4,33,16,53,29
19998,Silmont,55488,55,30,35,0,65,25,90,65
19999,Sivry-la-Perche,55489,55,20,66,12,88,43,143,86
20000,Sivry-sur-Meuse,55490,55,99,53,32,109,52,193,152
20001,Sommedieue,55492,55,52,180,81,297,138,516,232
20002,Sommeilles,55493,55,21,49,20,76,14,110,70
20003,Sommelonne,55494,55,44,95,40,215,70,325,139
20004,Sorbey,55495,55,12,63,17,59,66,142,75
20005,Sorcy-Saint-Martin,55496,55,121,285,65,283,256,604,406
20006,Les Souhesmes-Rampont,55497,55,25,79,16,104,75,195,104
20007,Souilly,55498,55,24,107,24,88,91,203,131
20008,Spincourt,55500,55,115,235,100,225,160,485,350
20009,Stainville,55501,55,60,105,40,95,115,250,165
20010,Stenay,55502,55,382,570,305,825,456,1586,952
20011,Taillancourt,55503,55,15,45,5,50,30,85,60
20012,Tannois,55504,55,61,110,17,108,69,194,171
20013,Thierville-sur-Meuse,55505,55,339,576,238,827,505,1570,915
20014,Thillombois,55506,55,0,0,0,20,0,20,0
20015,Thillot,55507,55,20,80,16,52,60,128,100
20016,Thonne-la-Long,55508,55,12,101,28,53,75,156,113
20017,Thonne-le-Thil,55509,55,45,70,20,95,45,160,115
20018,Thonne-les-Près,55510,55,15,12,12,35,19,66,27
20019,Thonnelle,55511,55,16,36,12,56,36,104,52
20020,Tilly-sur-Meuse,55512,55,30,65,40,74,78,192,95
20021,Trémont-sur-Saulx,55514,55,51,155,31,211,113,355,206
20022,Trésauvaux,55515,55,6,12,3,22,6,31,18
20023,Tréveray,55516,55,110,135,45,185,130,360,245
20024,Seuil-d'Argonne,55517,55,68,112,36,188,88,312,180
20025,Cousances-lès-Triconville,55518,55,38,30,12,28,18,58,68
20026,Tronville-en-Barrois,55519,55,210,325,145,620,189,954,535
20027,Troussey,55520,55,48,112,48,136,80,264,160
20028,Troyon,55521,55,38,70,20,70,22,112,108
20029,Ugny-sur-Meuse,55522,55,16,32,8,28,20,56,48
20030,Vacherauville,55523,55,8,38,8,48,50,106,46
20031,Vadelaincourt,55525,55,10,30,15,25,15,55,40
20032,Vadonville,55526,55,30,68,31,64,35,130,98
20033,Varennes-en-Argonne,55527,55,120,75,100,210,50,360,195
20034,Varnéville,55528,55,0,10,0,20,15,35,10
20035,Valbois,55530,55,9,21,12,28,9,49,30
20036,Vassincourt,55531,55,20,75,20,85,60,165,95
20037,Vaubecourt,55532,55,30,70,55,90,50,195,100
20038,Vaucouleurs,55533,55,222,448,140,731,312,1183,670
20039,Vaudeville-le-Haut,55534,55,3,16,0,12,17,29,19
20040,Vaudoncourt,55535,55,4,21,8,12,20,40,25
20041,Vauquois,55536,55,0,0,0,10,5,15,0
20042,Vaux-devant-Damloup,55537,55,4,9,12,16,12,40,13
20043,Vaux-lès-Palameix,55540,55,4,20,0,16,12,28,24
20044,Vavincourt,55541,55,64,132,28,188,88,304,196
20045,Velaines,55543,55,176,162,40,326,159,525,338
20046,Velosnes,55544,55,5,65,10,35,60,105,70
20047,Verdun,55545,55,2592,3853,2478,5605,2938,11021,6445
20048,Verneuil-Grand,55546,55,44,36,20,84,28,132,80
20049,Verneuil-Petit,55547,55,15,40,5,30,40,75,55
20050,Véry,55549,55,16,32,4,44,12,60,48
20051,Vigneulles-lès-Hattonchâtel,55551,55,196,356,147,538,263,948,552
20052,Vigneul-sous-Montmédy,55552,55,8,20,8,12,32,52,28
20053,Vignot,55553,55,140,317,103,422,216,741,457
20054,Villécloye,55554,55,32,52,24,92,48,164,84
20055,Ville-devant-Belrain,55555,55,8,0,0,4,4,8,8
20056,Ville-devant-Chaumont,55556,55,5,5,5,15,10,30,10
20057,Ville-en-Woëvre,55557,55,0,25,15,60,40,115,25
20058,Villeroy-sur-Méholle,55559,55,0,0,0,15,5,20,0
20059,Villers-aux-Vents,55560,55,8,28,20,48,24,92,36
20060,Villers-devant-Dun,55561,55,12,4,4,16,0,20,16
20061,Villers-le-Sec,55562,55,15,20,10,75,15,100,35
20062,Villers-lès-Mangiennes,55563,55,12,12,12,16,8,36,24
20063,Villers-sous-Pareid,55565,55,20,10,5,30,5,40,30
20064,Villers-sur-Meuse,55566,55,17,90,25,68,70,163,107
20065,Ville-sur-Cousances,55567,55,35,45,5,40,15,60,80
20066,Ville-sur-Saulx,55568,55,45,60,10,105,65,180,105
20067,Villotte-devant-Louppy,55569,55,4,41,8,71,21,100,45
20068,Villotte-sur-Aire,55570,55,25,50,3,43,38,84,75
20069,Vilosnes-Haraumont,55571,55,26,70,16,62,16,94,96
20070,Vittarville,55572,55,0,15,0,45,15,60,15
20071,Void-Vacon,55573,55,158,390,142,534,300,976,548
20072,Vouthon-Bas,55574,55,5,5,10,25,5,40,10
20073,Vouthon-Haut,55575,55,6,12,6,24,10,40,18
20074,Waly,55577,55,20,4,4,24,16,44,24
20075,Warcq,55578,55,20,68,32,52,36,120,88
20076,Watronville,55579,55,12,34,10,36,14,60,46
20077,Wavrille,55580,55,3,12,6,12,3,21,15
20078,Willeroncourt,55581,55,12,24,3,50,6,59,36
20079,Wiseppe,55582,55,24,16,12,32,20,64,40
20080,Woël,55583,55,24,52,20,60,36,116,76
20081,Woimbey,55584,55,16,40,12,36,24,72,56
20082,Xivray-et-Marvoisin,55586,55,12,8,0,41,12,53,20
20083,Allaire,56001,56,413,978,291,1159,700,2150,1391
20084,Ambon,56002,56,178,407,147,683,307,1137,585
20085,Arradon,56003,56,1166,1139,355,1989,659,3003,2305
20086,Arzal,56004,56,180,403,156,464,329,949,583
20087,Arzon,56005,56,650,200,120,890,215,1225,850
20088,Augan,56006,56,240,384,160,512,256,928,624
20089,Auray,56007,56,2017,2893,1502,3991,2393,7886,4910
20090,Baden,56008,56,680,967,313,1756,651,2720,1647
20091,Bangor,56009,56,181,221,36,354,164,554,402
20092,Baud,56010,56,828,1567,527,1863,1289,3679,2395
20093,Béganne,56011,56,224,276,108,584,200,892,500
20094,Beignon,56012,56,92,560,118,418,393,929,652
20095,Belz,56013,56,713,614,262,1385,517,2164,1327
20096,Berné,56014,56,215,380,100,460,330,890,595
20097,Berric,56015,56,183,512,108,450,421,979,695
20098,Bieuzy,56016,56,100,176,32,284,164,480,276
20099,Bignan,56017,56,274,680,234,1048,505,1787,954
20100,Billiers,56018,56,160,200,44,248,172,464,360
20101,Billio,56019,56,45,90,30,149,75,254,135
20102,Bohal,56020,56,60,264,60,156,244,460,324
20103,Brandérion,56021,56,105,477,110,370,340,820,582
20104,Brandivy,56022,56,94,345,85,396,260,741,439
20105,Brech,56023,56,715,1666,470,2151,1322,3943,2381
20106,Bréhan,56024,56,326,463,108,753,344,1205,789
20107,Brignac,56025,56,32,12,9,81,9,99,44
20108,Bubry,56026,56,486,462,153,737,385,1275,948
20109,Buléon,56027,56,78,116,30,150,73,253,194
20110,Caden,56028,56,215,395,133,593,310,1036,610
20111,Calan,56029,56,74,315,85,312,283,680,389
20112,Camoël,56030,56,119,235,33,377,156,566,354
20113,Camors,56031,56,384,768,288,881,624,1793,1152
20114,Campénéac,56032,56,180,516,172,556,444,1172,696
20115,Carentoir,56033,56,389,564,204,973,484,1661,953
20116,Carnac,56034,56,1079,593,272,1701,450,2423,1672
20117,Caro,56035,56,180,288,124,372,192,688,468
20118,Caudan,56036,56,878,1445,535,2364,1042,3941,2323
20119,La Chapelle-Gaceline,56038,56,60,205,55,275,170,500,265
20120,La Chapelle-Neuve,56039,56,113,220,105,294,180,579,333
20121,Cléguer,56040,56,315,799,331,1185,637,2153,1114
20122,Cléguérec,56041,56,402,657,170,1047,483,1700,1059
20123,Colpo,56042,56,225,580,190,690,410,1290,805
20124,Concoret,56043,56,135,185,30,225,115,370,320
20125,Cournon,56044,56,100,180,40,315,140,495,280
20126,Le Cours,56045,56,50,205,45,209,130,384,255
20127,Crach,56046,56,574,634,218,1338,408,1964,1208
20128,Crédin,56047,56,161,367,104,368,311,783,528
20129,Le Croisty,56048,56,171,160,20,250,110,380,331
20130,Croixanvec,56049,56,17,29,12,77,12,101,46
20131,La Croix-Helléan,56050,56,132,272,68,204,188,460,404
20132,Cruguel,56051,56,100,144,32,240,100,372,244
20133,Damgan,56052,56,484,187,38,717,166,921,671
20134,Elven,56053,56,498,1609,558,1546,1292,3396,2107
20135,Erdeven,56054,56,541,721,189,1390,539,2118,1262
20136,Étel,56055,56,506,277,115,702,244,1061,783
20137,Évriguet,56056,56,40,30,5,90,5,100,70
20138,Le Faouët,56057,56,605,495,170,995,381,1546,1100
20139,Férel,56058,56,315,774,246,1041,579,1866,1089
20140,Les Forges,56059,56,60,90,85,185,54,324,150
20141,Les Fougerêts,56060,56,132,184,53,319,152,524,316
20142,La Gacilly,56061,56,279,427,174,718,355,1247,706
20143,Gâvres,56062,56,232,105,35,267,65,367,337
20144,Gestel,56063,56,208,769,158,1000,459,1617,977
20145,Glénac,56064,56,80,220,36,350,200,586,300
20146,Gourhel,56065,56,36,189,20,235,150,405,225
20147,Gourin,56066,56,715,773,278,1440,603,2321,1488
20148,Grand-Champ,56067,56,529,1399,359,1547,1114,3020,1928
20149,La Grée-Saint-Laurent,56068,56,34,79,37,99,45,181,113
20150,Groix,56069,56,600,287,102,873,240,1215,887
20151,Guégon,56070,56,454,453,149,830,350,1329,907
20152,Guéhenno,56071,56,136,164,84,264,152,500,300
20153,Gueltas,56072,56,64,112,72,160,92,324,176
20154,Guémené-sur-Scorff,56073,56,217,156,54,303,128,485,373
20155,Guénin,56074,56,95,502,153,443,431,1027,597
20156,Guer,56075,56,742,1627,711,1696,1023,3430,2369
20157,Guern,56076,56,274,290,60,465,190,715,564
20158,Le Guerno,56077,56,57,260,84,286,199,569,317
20159,Guidel,56078,56,1252,2942,757,3961,2126,6844,4194
20160,Guillac,56079,56,180,361,130,423,272,825,541
20161,Guilliers,56080,56,200,260,88,476,200,764,460
20162,Guiscriff,56081,56,442,364,156,928,283,1367,806
20163,Helléan,56082,56,35,100,48,114,65,227,135
20164,Hennebont,56083,56,2010,3539,1644,4936,2943,9523,5549
20165,Le Hézo,56084,56,92,169,72,208,209,489,261
20166,Hoedic,56085,56,21,20,0,52,20,72,41
20167,Île-d'Houat,56086,56,59,10,30,115,15,160,69
20168,Île-aux-Moines,56087,56,180,100,15,260,50,325,280
20169,Île-d'Arz,56088,56,88,35,0,75,30,105,123
20170,Inguiniel,56089,56,240,514,176,722,384,1282,754
20171,Inzinzac-Lochrist,56090,56,642,1544,557,2180,1354,4091,2186
20172,Josselin,56091,56,342,467,133,750,353,1236,809
20173,Kerfourn,56092,56,88,228,84,308,160,552,316
20174,Kergrist,56093,56,153,150,47,161,143,351,303
20175,Kervignac,56094,56,503,1824,616,1993,1497,4106,2327
20176,Landaul,56096,56,170,688,174,575,594,1343,858
20177,Landévant,56097,56,384,1012,252,1036,811,2099,1396
20178,Lanester,56098,56,3221,5156,2219,7051,3623,12893,8377
20179,Langoëlan,56099,56,65,95,30,145,50,225,160
20180,Langonnet,56100,56,416,328,164,570,268,1002,744
20181,Languidic,56101,56,1016,1978,596,2329,1520,4445,2994
20182,Lanouée,56102,56,249,505,120,607,319,1046,754
20183,Lantillac,56103,56,65,60,25,93,50,168,125
20184,Lanvaudan,56104,56,61,183,69,284,125,478,244
20185,Lanvénégen,56105,56,221,245,95,465,140,700,466
20186,Larmor-Baden,56106,56,226,134,25,347,91,463,360
20187,Larmor-Plage,56107,56,1871,1325,471,3319,1034,4824,3196
20188,Larré,56108,56,39,299,74,274,266,614,338
20189,Lauzach,56109,56,35,339,91,306,301,698,374
20190,Lignol,56110,56,201,142,81,267,131,479,343
20191,Limerzel,56111,56,200,325,95,438,275,808,525
20192,Lizio,56112,56,120,152,64,284,108,456,272
20193,Locmalo,56113,56,152,208,116,300,140,556,360
20194,Locmaria,56114,56,251,121,41,250,122,413,372
20195,Locmaria-Grand-Champ,56115,56,83,610,120,356,472,948,693
20196,Locmariaquer,56116,56,285,307,52,611,253,916,592
20197,Locminé,56117,56,611,909,485,1158,819,2462,1520
20198,Locmiquélic,56118,56,692,857,251,1543,665,2459,1549
20199,Locoal-Mendon,56119,56,363,841,242,1085,682,2009,1204
20200,Locqueltas,56120,56,70,543,175,555,332,1062,613
20201,Lorient,56121,56,8191,12292,9175,16871,10090,36136,20483
20202,Loyat,56122,56,225,390,145,500,335,980,615
20203,Malansac,56123,56,368,508,132,784,360,1276,876
20204,Malestroit,56124,56,559,417,140,817,283,1240,976
20205,Malguénac,56125,56,224,426,102,593,363,1058,650
20206,Marzan,56126,56,257,625,173,686,471,1330,882
20207,Mauron,56127,56,554,612,200,1215,441,1856,1166
20208,Melrand,56128,56,421,229,74,502,174,750,650
20209,Ménéac,56129,56,295,311,84,515,228,827,606
20210,Merlevenez,56130,56,297,870,199,1115,602,1916,1167
20211,Meslan,56131,56,221,364,90,434,221,745,585
20212,Meucon,56132,56,152,628,216,708,448,1372,780
20213,Missiriac,56133,56,127,279,62,346,232,640,406
20214,Mohon,56134,56,168,212,52,376,180,608,380
20215,Molac,56135,56,172,436,100,412,380,892,608
20216,Monteneuf,56136,56,108,180,68,212,176,456,288
20217,Monterblanc,56137,56,210,997,228,813,843,1884,1207
20218,Monterrein,56138,56,25,110,35,120,110,265,135
20219,Montertelot,56139,56,36,108,16,112,92,220,144
20220,Moréac,56140,56,375,1019,290,1223,744,2257,1394
20221,Moustoir-Ac,56141,56,130,595,120,480,474,1074,725
20222,Muzillac,56143,56,970,1080,350,1663,739,2752,2050
20223,Évellys,56144,56,486,867,251,1062,673,1986,1353
20224,Néant-sur-Yvel,56145,56,92,232,124,360,192,676,324
20225,Neulliac,56146,56,130,307,160,586,220,966,437
20226,Nivillac,56147,56,603,1027,314,1601,742,2657,1630
20227,Nostang,56148,56,145,380,120,445,395,960,525
20228,Noyal-Muzillac,56149,56,321,604,210,797,484,1491,925
20229,Noyal-Pontivy,56151,56,508,900,324,1166,644,2134,1408
20230,Le Palais,56152,56,314,486,207,918,389,1514,800
20231,Péaule,56153,56,333,610,212,865,500,1577,943
20232,Peillac,56154,56,292,428,104,624,424,1152,720
20233,Pénestin,56155,56,431,276,34,653,255,942,707
20234,Persquen,56156,56,60,76,24,124,60,208,136
20235,Plaudren,56157,56,149,463,198,572,367,1137,612
20236,Plescop,56158,56,487,1287,884,1810,1186,3880,1774
20237,Pleucadeuc,56159,56,188,464,128,514,349,991,652
20238,Pleugriffet,56160,56,175,307,112,387,199,698,482
20239,Ploemel,56161,56,335,727,296,950,463,1709,1062
20240,Ploemeur,56162,56,2999,3387,1020,7114,2344,10478,6386
20241,Ploërdut,56163,56,236,248,77,454,148,679,484
20242,Ploeren,56164,56,704,1600,577,2409,1092,4078,2304
20243,Ploërmel,56165,56,1081,2194,847,3051,1767,5665,3275
20244,Plouay,56166,56,857,1222,415,1987,806,3208,2079
20245,Plougoumelen,56167,56,200,580,130,1010,445,1585,780
20246,Plouharnel,56168,56,283,477,115,719,403,1237,760
20247,Plouhinec,56169,56,805,1115,330,2185,845,3360,1920
20248,Plouray,56170,56,247,210,55,428,130,613,457
20249,Pluherlin,56171,56,180,415,85,515,295,895,595
20250,Plumelec,56172,56,305,680,175,890,550,1615,985
20251,Pluméliau,56173,56,512,869,239,1099,721,2059,1381
20252,Plumelin,56174,56,151,784,242,689,606,1537,935
20253,Plumergat,56175,56,298,1258,250,1059,1040,2349,1556
20254,Pluneret,56176,56,394,1335,393,2059,1022,3474,1729
20255,Pluvigner,56177,56,978,1899,534,2336,1466,4336,2877
20256,Pontivy,56178,56,2041,3061,1754,4178,2088,8020,5102
20257,Pont-Scorff,56179,56,292,1012,246,1089,807,2142,1304
20258,Porcaro,56180,56,67,175,42,216,142,400,242
20259,Port-Louis,56181,56,635,445,210,940,310,1460,1080
20260,Priziac,56182,56,190,192,40,273,183,496,382
20261,Quelneuc,56183,56,105,90,45,240,75,360,195
20262,Questembert,56184,56,1031,1873,546,2475,1325,4346,2904
20263,Quéven,56185,56,1304,1973,590,3150,1259,4999,3277
20264,Quiberon,56186,56,1314,621,395,2001,497,2893,1935
20265,Quistinic,56188,56,205,352,73,502,304,879,557
20266,Radenac,56189,56,93,253,113,288,209,610,346
20267,Réguiny,56190,56,254,509,150,639,339,1128,763
20268,Réminiac,56191,56,51,82,39,107,43,189,133
20269,Riantec,56193,56,926,1117,309,1960,864,3133,2043
20270,Rieux,56194,56,386,663,205,1042,548,1795,1049
20271,La Roche-Bernard,56195,56,112,132,60,184,160,404,244
20272,Rochefort-en-Terre,56196,56,95,80,19,189,95,303,175
20273,Val d'Oust,56197,56,320,586,183,948,491,1622,906
20274,Rohan,56198,56,286,457,85,583,220,888,743
20275,Roudouallec,56199,56,100,173,60,268,136,464,273
20276,Ruffiac,56200,56,240,344,96,452,260,808,584
20277,Le Saint,56201,56,125,80,15,290,80,385,205
20278,Saint-Abraham,56202,56,48,160,36,172,124,332,208
20279,Saint-Aignan,56203,56,135,120,10,195,118,323,255
20280,Saint-Allouestre,56204,56,56,153,62,175,114,351,209
20281,Saint-Armel,56205,56,198,140,63,395,100,558,338
20282,Saint-Avé,56206,56,1069,2738,931,3814,1802,6547,3807
20283,Saint-Barthélemy,56207,56,208,288,104,360,252,716,496
20284,Saint-Brieuc-de-Mauron,56208,56,55,90,15,115,60,190,145
20285,Sainte-Brigitte,56209,56,33,25,30,80,10,120,58
20286,Saint-Caradec-Trégomel,56210,56,91,89,25,134,72,231,180
20287,Saint-Congard,56211,56,175,183,55,200,129,384,358
20288,Saint-Dolay,56212,56,330,618,193,730,458,1381,948
20289,Saint-Gérand,56213,56,87,272,135,300,216,651,359
20290,Saint-Gildas-de-Rhuys,56214,56,516,224,56,688,212,956,740
20291,Saint-Gonnery,56215,56,143,224,104,378,164,646,367
20292,Saint-Gorgon,56216,56,52,76,32,112,80,224,128
20293,Saint-Gravé,56218,56,92,200,76,256,136,468,292
20294,Saint-Guyomard,56219,56,128,382,113,329,320,762,510
20295,Sainte-Hélène,56220,56,150,284,79,449,229,757,434
20296,Saint-Jacut-les-Pins,56221,56,178,395,125,529,285,939,573
20297,Saint-Jean-Brévelay,56222,56,282,698,197,847,538,1582,980
20298,Saint-Jean-la-Poterie,56223,56,225,425,95,535,220,850,650
20299,Saint-Laurent-sur-Oust,56224,56,50,105,0,85,115,200,155
20300,Saint-Léry,56225,56,20,60,15,80,25,120,80
20301,Saint-Malo-de-Beignon,56226,56,37,175,39,78,137,254,212
20302,Saint-Malo-des-Trois-Fontaines,56227,56,68,136,25,150,93,268,204
20303,Saint-Marcel,56228,56,110,295,70,315,269,654,405
20304,Saint-Martin-sur-Oust,56229,56,284,284,64,484,216,764,568
20305,Saint-Nicolas-du-Tertre,56230,56,55,95,65,140,100,305,150
20306,Saint-Nolff,56231,56,366,968,171,1368,747,2286,1334
20307,Saint-Perreux,56232,56,130,335,80,425,215,720,465
20308,Saint-Philibert,56233,56,373,271,70,564,226,860,644
20309,Saint-Pierre-Quiberon,56234,56,542,305,80,964,210,1254,847
20310,Saint-Servant,56236,56,153,175,55,303,125,483,328
20311,Saint-Thuriau,56237,56,138,465,151,667,347,1165,603
20312,Saint-Tugdual,56238,56,55,70,45,165,40,250,125
20313,Saint-Vincent-sur-Oust,56239,56,173,345,108,404,289,801,518
20314,Sarzeau,56240,56,2011,1169,390,3073,919,4382,3180
20315,Sauzon,56241,56,136,188,70,319,173,562,324
20316,Séglien,56242,56,110,142,36,197,131,364,252
20317,Séné,56243,56,1203,1712,944,3478,1294,5716,2915
20318,Sérent,56244,56,375,720,280,990,630,1900,1095
20319,Silfiac,56245,56,100,95,30,155,70,255,195
20320,Le Sourn,56246,56,288,468,224,692,424,1340,756
20321,Sulniac,56247,56,239,1030,277,1045,776,2098,1269
20322,Surzur,56248,56,412,1134,285,1284,965,2534,1546
20323,Taupont,56249,56,245,560,140,845,410,1395,805
20324,Théhillac,56250,56,54,107,52,178,105,335,161
20325,Theix-Noyalo,56251,56,798,2024,484,2921,1357,4762,2822
20326,Le Tour-du-Parc,56252,56,164,264,45,500,244,789,428
20327,Tréal,56253,56,136,148,52,244,88,384,284
20328,Trédion,56254,56,124,309,96,384,268,748,433
20329,Treffléan,56255,56,148,618,177,663,491,1331,766
20330,Tréhorenteuc,56256,56,35,20,12,32,8,52,55
20331,La Trinité-Porhoët,56257,56,160,165,15,250,95,360,325
20332,La Trinité-sur-Mer,56258,56,361,180,100,747,135,982,541
20333,La Trinité-Surzur,56259,56,64,485,192,316,363,871,549
20334,Vannes,56260,56,7512,11200,6945,16652,8446,32043,18712
20335,La Vraie-Croix,56261,56,108,461,84,445,322,851,569
20336,Bono,56262,56,398,479,88,686,379,1153,877
20337,Sainte-Anne-d'Auray,56263,56,278,653,216,749,438,1403,931
20338,Kernascléden,56264,56,61,71,55,167,40,262,132
20339,Aboncourt,57001,57,65,85,50,115,60,225,150
20340,Aboncourt-sur-Seille,57002,57,8,24,8,16,20,44,32
20341,Abreschviller,57003,57,206,288,120,467,205,792,494
20342,Achain,57004,57,15,26,10,42,18,70,41
20343,Achen,57006,57,101,232,63,322,199,584,333
20344,Adaincourt,57007,57,0,34,4,40,21,65,34
20345,Adelange,57008,57,28,52,12,76,32,120,80
20346,Ajoncourt,57009,57,18,30,8,20,17,45,48
20347,Alaincourt-la-Côte,57010,57,13,40,12,15,30,57,53
20348,Albestroff,57011,57,30,94,48,214,56,318,124
20349,Algrange,57012,57,880,1361,848,1655,1207,3710,2241
20350,Alsting,57013,57,325,405,220,1135,485,1840,730
20351,Altrippe,57014,57,34,97,25,105,90,220,131
20352,Altviller,57015,57,37,128,43,223,108,374,165
20353,Alzing,57016,57,38,66,28,143,80,251,104
20354,Amanvillers,57017,57,156,564,236,772,472,1480,720
20355,Amelécourt,57018,57,10,45,10,40,35,85,55
20356,Amnéville,57019,57,1171,2556,1253,3347,2014,6614,3727
20357,Ancerville,57020,57,8,71,9,127,51,187,79
20358,Ancy-Dornot,57021,57,179,351,93,573,295,961,530
20359,Angevillers,57022,57,145,262,91,371,283,745,407
20360,Antilly,57024,57,4,16,30,57,28,115,20
20361,Anzeling,57025,57,25,130,45,205,90,340,155
20362,Apach,57026,57,87,222,131,299,232,662,309
20363,Arraincourt,57027,57,12,43,11,25,17,53,55
20364,Argancy,57028,57,125,296,111,505,209,825,421
20365,Arriance,57029,57,15,25,30,105,25,160,40
20366,Arry,57030,57,43,146,33,105,151,289,189
20367,Ars-Laquenexy,57031,57,120,151,106,358,90,554,271
20368,Ars-sur-Moselle,57032,57,545,1105,575,1590,910,3075,1650
20369,Arzviller,57033,57,73,154,25,122,135,282,227
20370,Aspach,57034,57,9,6,6,6,3,15,15
20371,Assenoncourt,57035,57,30,19,9,18,12,39,49
20372,Attilloncourt,57036,57,10,30,10,35,15,60,40
20373,Aube,57037,57,19,60,13,61,54,128,79
20374,Audun-le-Tiche,57038,57,937,1383,851,1895,1513,4259,2320
20375,Augny,57039,57,214,480,199,638,324,1161,694
20376,Aulnois-sur-Seille,57040,57,25,74,34,69,64,167,99
20377,Aumetz,57041,57,306,464,255,825,356,1436,770
20378,Avricourt,57042,57,95,142,60,262,60,382,237
20379,Ay-sur-Moselle,57043,57,185,288,109,552,264,925,473
20380,Azoudange,57044,57,12,22,12,19,18,49,34
20381,Bacourt,57045,57,20,25,5,35,20,60,45
20382,Baerenthal,57046,57,155,135,70,330,95,495,290
20383,Bambiderstroff,57047,57,104,243,104,331,181,616,347
20384,Bannay,57048,57,0,10,3,26,15,44,10
20385,Le Ban-Saint-Martin,57049,57,365,990,450,1365,825,2640,1355
20386,Barchain,57050,57,7,26,21,27,13,61,33
20387,Baronville,57051,57,45,105,30,110,95,235,150
20388,Barst,57052,57,52,124,40,224,124,388,176
20389,Bassing,57053,57,5,30,0,65,10,75,35
20390,Baudrecourt,57054,57,25,50,40,50,40,130,75
20391,Bazoncourt,57055,57,40,160,25,210,95,330,200
20392,Bébing,57056,57,39,20,4,77,22,103,59
20393,Béchy,57057,57,30,195,55,155,165,375,225
20394,Behren-lès-Forbach,57058,57,829,1664,972,1955,1019,3946,2493
20395,Bellange,57059,57,10,0,5,15,10,30,10
20396,Bénestroff,57060,57,70,170,45,145,125,315,240
20397,Béning-lès-Saint-Avold,57061,57,162,244,134,419,222,775,406
20398,Berg-sur-Moselle,57062,57,40,110,30,160,85,275,150
20399,Bérig-Vintrange,57063,57,19,22,38,88,21,147,41
20400,Berling,57064,57,52,68,36,72,52,160,120
20401,Bermering,57065,57,30,45,5,101,40,146,75
20402,Berthelming,57066,57,69,103,37,177,66,280,172
20403,Bertrange,57067,57,252,740,217,835,701,1753,992
20404,Berviller-en-Moselle,57069,57,60,116,32,168,116,316,176
20405,Bettange,57070,57,20,64,16,48,68,132,84
20406,Bettborn,57071,57,40,100,36,168,96,300,140
20407,Bettelainville,57072,57,36,148,60,244,136,440,184
20408,Betting,57073,57,146,143,50,297,117,464,289
20409,Bettviller,57074,57,80,190,100,260,180,540,270
20410,Beux,57075,57,10,70,20,80,80,180,80
20411,Beyren-lès-Sierck,57076,57,36,144,28,148,164,340,180
20412,Bezange-la-Petite,57077,57,6,25,0,38,12,50,31
20413,Bibiche,57079,57,52,144,36,148,80,264,196
20414,Bickenholtz,57080,57,8,12,8,16,24,48,20
20415,Bidestroff,57081,57,10,16,12,42,16,70,26
20416,Biding,57082,57,8,76,24,97,69,190,84
20417,Bining,57083,57,115,217,142,425,176,743,332
20418,Bioncourt,57084,57,40,108,24,100,72,196,148
20419,Bionville-sur-Nied,57085,57,24,78,50,112,63,225,102
20420,Belles-Forêts,57086,57,25,55,5,80,65,150,80
20421,Bisten-en-Lorraine,57087,57,27,31,9,86,51,146,58
20422,Bistroff,57088,57,12,51,45,93,62,200,63
20423,Bitche,57089,57,612,1136,474,1536,889,2899,1748
20424,Blanche-Église,57090,57,3,39,3,36,29,68,42
20425,Bliesbruck,57091,57,111,168,107,362,165,634,279
20426,Blies-Ébersing,57092,57,85,130,55,205,155,415,215
20427,Blies-Guersviller,57093,57,52,90,49,277,71,397,142
20428,Boucheporn,57095,57,29,137,56,183,125,364,166
20429,Boulange,57096,57,245,740,255,740,500,1495,985
20430,Boulay-Moselle,57097,57,421,1551,716,1604,1150,3470,1972
20431,Bourgaltroff,57098,57,30,75,15,95,35,145,105
20432,Bourdonnay,57099,57,25,50,5,95,35,135,75
20433,Bourscheid,57100,57,16,25,34,37,25,96,41
20434,Bousbach,57101,57,92,300,109,391,241,741,392
20435,Bousse,57102,57,385,709,209,974,725,1908,1094
20436,Bousseviller,57103,57,25,36,10,30,30,70,61
20437,Boust,57104,57,85,329,104,267,343,714,414
20438,Boustroff,57105,57,20,65,15,45,30,90,85
20439,Bouzonville,57106,57,520,958,339,1288,708,2335,1478
20440,Bréhain,57107,57,10,15,13,36,16,65,25
20441,Breidenbach,57108,57,30,80,35,135,75,245,110
20442,Breistroff-la-Grande,57109,57,30,143,48,185,144,377,173
20443,Brettnach,57110,57,80,105,40,120,100,260,185
20444,Bronvaux,57111,57,75,130,70,208,85,363,205
20445,Brouck,57112,57,5,30,0,20,20,40,35
20446,Brouderdorff,57113,57,105,249,61,219,259,539,354
20447,Brouviller,57114,57,30,103,26,134,75,235,133
20448,Brulange,57115,57,10,25,10,30,30,70,35
20449,Buchy,57116,57,4,36,12,40,36,88,40
20450,Buding,57117,57,60,175,55,190,105,350,235
20451,Budling,57118,57,10,55,10,60,55,125,65
20452,Buhl-Lorraine,57119,57,145,305,144,402,255,801,450
20453,Burlioncourt,57120,57,12,36,12,60,32,104,48
20454,Burtoncourt,57121,57,15,60,10,75,35,120,75
20455,Cappel,57122,57,88,124,36,294,82,412,212
20456,Carling,57123,57,386,638,364,1301,605,2270,1024
20457,Cattenom,57124,57,269,686,302,753,641,1696,955
20458,Chailly-lès-Ennery,57125,57,28,92,32,132,40,204,120
20459,Chambrey,57126,57,45,85,10,110,90,210,130
20460,Chanville,57127,57,10,44,10,30,48,88,54
20461,Charleville-sous-Bois,57128,57,28,67,16,68,30,114,95
20462,Charly-Oradour,57129,57,32,192,100,248,120,468,224
20463,Château-Bréhain,57130,57,25,15,0,25,10,35,40
20464,Château-Rouge,57131,57,20,75,30,110,30,170,95
20465,Château-Salins,57132,57,285,475,275,770,445,1490,760
20466,Château-Voué,57133,57,6,20,10,50,15,75,26
20467,Châtel-Saint-Germain,57134,57,274,390,168,648,300,1116,664
20468,Chémery-les-Deux,57136,57,29,158,30,155,126,311,187
20469,Cheminot,57137,57,88,225,70,189,153,412,313
20470,Chenois,57138,57,8,4,12,36,4,52,12
20471,Chérisey,57139,57,28,77,30,81,57,168,105
20472,Chesny,57140,57,30,155,45,170,175,390,185
20473,Chicourt,57141,57,12,8,4,29,12,45,20
20474,Chieulles,57142,57,36,104,44,140,84,268,140
20475,Clouange,57143,57,648,802,455,1166,653,2274,1450
20476,Cocheren,57144,57,499,693,349,1309,572,2230,1192
20477,Coincy,57145,57,20,70,30,134,55,219,90
20478,Coin-lès-Cuvry,57146,57,44,174,43,218,142,403,218
20479,Coin-sur-Seille,57147,57,45,75,35,145,30,210,120
20480,Colligny,57148,57,72,92,32,104,76,212,164
20481,Colmen,57149,57,30,50,5,90,45,140,80
20482,Condé-Northen,57150,57,40,168,80,200,160,440,208
20483,Conthil,57151,57,20,55,5,70,20,95,75
20484,Contz-les-Bains,57152,57,34,128,38,165,102,305,162
20485,Corny-sur-Moselle,57153,57,240,595,220,755,425,1400,835
20486,Coume,57154,57,85,140,95,250,90,435,225
20487,Courcelles-Chaussy,57155,57,227,810,258,903,631,1792,1037
20488,Courcelles-sur-Nied,57156,57,104,296,152,368,268,788,400
20489,Craincourt,57158,57,25,75,15,100,50,165,100
20490,Créhange,57159,57,450,963,397,1235,836,2468,1413
20491,Creutzwald,57160,57,1786,2668,1494,4830,2293,8617,4454
20492,Cutting,57161,57,20,21,20,34,21,75,41
20493,Cuvry,57162,57,75,220,64,263,154,481,295
20494,Dabo,57163,57,475,440,260,1000,375,1635,915
20495,Dalem,57165,57,76,116,64,264,72,400,192
20496,Dalhain,57166,57,5,40,10,50,20,80,45
20497,Dalstein,57167,57,20,100,36,88,100,224,120
20498,Danne-et-Quatre-Vents,57168,57,83,124,67,248,72,387,207
20499,Dannelbourg,57169,57,48,115,39,142,101,282,163
20500,Delme,57171,57,107,321,90,264,230,584,428
20501,Denting,57172,57,16,42,36,96,26,158,58
20502,Desseling,57173,57,28,24,16,16,16,48,52
20503,Destry,57174,57,4,25,12,32,12,56,29
20504,Diane-Capelle,57175,57,27,28,13,80,30,123,55
20505,Diebling,57176,57,235,305,140,640,315,1095,540
20506,Dieuze,57177,57,484,672,255,1092,421,1768,1156
20507,Diffembach-lès-Hellimer,57178,57,50,76,35,130,55,220,126
20508,Distroff,57179,57,133,425,173,564,397,1134,558
20509,Dolving,57180,57,35,85,75,120,70,265,120
20510,Domnom-lès-Dieuze,57181,57,10,10,5,40,20,65,20
20511,Donjeux,57182,57,10,15,15,45,25,85,25
20512,Donnelay,57183,57,24,32,9,67,18,94,56
20513,Ébersviller,57186,57,88,269,73,199,229,501,357
20514,Éblange,57187,57,45,120,5,135,90,230,165
20515,Éguelshardt,57188,57,65,105,25,115,80,220,170
20516,Eincheville,57189,57,35,50,35,80,30,145,85
20517,Elvange,57190,57,31,113,39,120,71,230,144
20518,Elzange,57191,57,65,171,70,311,110,491,236
20519,Enchenberg,57192,57,180,284,156,384,260,800,464
20520,Ennery,57193,57,178,481,185,649,390,1224,659
20521,Entrange,57194,57,95,353,90,411,306,807,448
20522,Epping,57195,57,65,95,35,177,112,324,160
20523,Erching,57196,57,33,80,56,118,84,258,113
20524,Ernestviller,57197,57,78,108,21,154,108,283,186
20525,Erstroff,57198,57,45,30,5,80,25,110,75
20526,Escherange,57199,57,50,135,55,155,175,385,185
20527,Les Étangs,57200,57,48,100,12,144,84,240,148
20528,Etting,57201,57,128,120,96,324,88,508,248
20529,Etzling,57202,57,168,209,75,510,193,778,377
20530,Évrange,57203,57,20,68,17,41,56,114,88
20531,Failly,57204,57,49,115,55,209,100,364,164
20532,Falck,57205,57,407,486,186,889,468,1543,893
20533,Fameck,57206,57,1922,3793,1501,3821,2820,8142,5715
20534,Farébersviller,57207,57,610,1545,630,1715,945,3290,2155
20535,Farschviller,57208,57,153,317,181,466,265,912,470
20536,Faulquemont,57209,57,793,1101,564,1965,927,3456,1894
20537,Fénétrange,57210,57,115,115,60,265,55,380,230
20538,Fèves,57211,57,85,224,90,320,213,623,309
20539,Féy,57212,57,80,215,45,204,155,404,295
20540,Filstroff,57213,57,103,150,46,310,116,472,253
20541,Fixem,57214,57,28,96,72,160,76,308,124
20542,Flastroff,57215,57,16,58,29,120,54,203,74
20543,Fleisheim,57216,57,4,56,16,28,40,84,60
20544,Flétrange,57217,57,79,225,55,412,180,647,304
20545,Fleury,57218,57,150,261,104,335,197,636,411
20546,Flévy,57219,57,84,140,60,184,108,352,224
20547,Flocourt,57220,57,24,44,0,24,40,64,68
20548,Florange,57221,57,1326,2515,1326,3655,2245,7226,3841
20549,Folkling,57222,57,157,211,92,565,164,821,368
20550,Folschviller,57224,57,557,1022,400,1374,682,2456,1579
20551,Fonteny,57225,57,8,21,8,45,30,83,29
20552,Fontoy,57226,57,436,593,308,992,544,1844,1029
20553,Forbach,57227,57,2588,4696,2596,7102,3798,13496,7284
20554,Fossieux,57228,57,20,56,21,36,34,91,76
20555,Foulcrey,57229,57,29,31,13,66,30,109,60
20556,Fouligny,57230,57,25,45,20,85,19,124,70
20557,Foville,57231,57,10,20,0,30,25,55,30
20558,Francaltroff,57232,57,112,188,116,204,128,448,300
20559,Fraquelfing,57233,57,13,12,6,19,9,34,25
20560,Frauenberg,57234,57,56,83,34,220,81,335,139
20561,Freistroff,57235,57,144,292,72,344,256,672,436
20562,Frémery,57236,57,0,9,4,31,26,61,9
20563,Frémestroff,57237,57,40,47,34,97,45,176,87
20564,Fresnes-en-Saulnois,57238,57,15,38,45,44,39,128,53
20565,Freybouse,57239,57,32,108,40,136,100,276,140
20566,Freyming-Merlebach,57240,57,1772,2926,1504,4487,2228,8219,4698
20567,Fribourg,57241,57,30,55,25,40,40,105,85
20568,Gandrange,57242,57,335,671,280,910,571,1761,1006
20569,Garrebourg,57244,57,75,90,35,200,85,320,165
20570,Gavisse,57245,57,35,131,47,168,143,358,166
20571,Gelucourt,57246,57,36,64,0,92,36,128,100
20572,Gerbécourt,57247,57,11,27,16,30,6,52,38
20573,Givrycourt,57248,57,16,20,12,24,20,56,36
20574,Glatigny,57249,57,10,49,24,105,44,173,59
20575,Goetzenbruck,57250,57,219,306,140,591,223,954,525
20576,Goin,57251,57,16,68,56,104,72,232,84
20577,Gomelange,57252,57,35,147,28,176,89,293,182
20578,Gondrexange,57253,57,42,85,36,174,68,278,127
20579,Gorze,57254,57,75,210,56,319,186,561,285
20580,Gosselming,57255,57,44,148,60,228,128,416,192
20581,Gravelotte,57256,57,52,212,93,250,197,540,264
20582,Grémecey,57257,57,12,25,8,20,21,49,37
20583,Gréning,57258,57,20,40,30,60,10,100,60
20584,Grindorff-Bizing,57259,57,38,40,26,130,28,184,78
20585,Grosbliederstroff,57260,57,449,580,299,1319,637,2255,1029
20586,Gros-Réderching,57261,57,119,293,160,420,230,810,412
20587,Grostenquin,57262,57,96,120,44,188,120,352,216
20588,Grundviller,57263,57,48,180,48,240,164,452,228
20589,Guebenhouse,57264,57,40,84,50,114,78,242,124
20590,Guébestroff,57265,57,5,15,5,30,0,35,20
20591,Guéblange-lès-Dieuze,57266,57,12,40,24,44,36,104,52
20592,Le Val-de-Guéblange,57267,57,125,160,95,315,180,590,285
20593,Guébling,57268,57,15,26,15,65,5,85,41
20594,Guénange,57269,57,1014,1558,792,2278,1354,4424,2572
20595,Val-de-Bride,57270,57,115,145,30,215,85,330,260
20596,Guenviller,57271,57,120,95,70,250,105,425,215
20597,Guermange,57272,57,6,20,6,23,16,45,26
20598,Guerstling,57273,57,70,70,20,180,75,275,140
20599,Guerting,57274,57,95,175,120,365,120,605,270
20600,Guessling-Hémering,57275,57,92,204,100,272,163,535,296
20601,Guinglange,57276,57,48,76,28,88,84,200,124
20602,Guinkirchen,57277,57,15,40,15,50,40,105,55
20603,Guinzeling,57278,57,9,17,0,19,16,35,26
20604,Guntzviller,57280,57,45,105,25,80,120,225,150
20605,Haboudange,57281,57,25,55,15,70,55,140,80
20606,Hagen,57282,57,4,54,80,67,107,254,58
20607,Hagondange,57283,57,1216,2041,1235,2919,1763,5917,3257
20608,Hallering,57284,57,6,16,3,42,16,61,22
20609,Halstroff,57286,57,40,68,44,96,52,192,108
20610,Basse-Ham,57287,57,340,559,205,752,370,1327,899
20611,Ham-sous-Varsberg,57288,57,317,550,237,1035,517,1789,867
20612,Hambach,57289,57,290,582,277,1001,515,1793,872
20613,Hampont,57290,57,30,15,25,90,20,135,45
20614,Hangviller,57291,57,40,65,20,100,45,165,105
20615,Hannocourt,57292,57,10,0,0,5,0,5,10
20616,Han-sur-Nied,57293,57,16,72,36,64,68,168,88
20617,Hanviller,57294,57,15,58,26,52,41,119,73
20618,Haraucourt-sur-Seille,57295,57,12,29,0,25,32,57,41
20619,Hargarten-aux-Mines,57296,57,92,248,120,404,240,764,340
20620,Harprich,57297,57,40,45,0,50,45,95,85
20621,Harreberg,57298,57,55,95,20,105,115,240,150
20622,Hartzviller,57299,57,120,210,95,310,165,570,330
20623,Haselbourg,57300,57,60,65,20,115,45,180,125
20624,Haspelschiedt,57301,57,59,46,22,89,30,141,105
20625,Hattigny,57302,57,8,60,36,48,64,148,68
20626,Hauconcourt,57303,57,120,120,45,184,95,324,240
20627,Haut-Clocher,57304,57,28,76,8,120,80,208,104
20628,Havange,57305,57,30,150,25,130,130,285,180
20629,Hayange,57306,57,1985,3546,1828,4941,2988,9757,5531
20630,Hayes,57307,57,15,70,10,60,75,145,85
20631,Hazembourg,57308,57,20,25,0,40,35,75,45
20632,Heining-lès-Bouzonville,57309,57,44,100,23,190,104,317,144
20633,Hellering-lès-Fénétrange,57310,57,15,50,10,80,40,130,65
20634,Hellimer,57311,57,68,136,56,196,108,360,204
20635,Helstroff,57312,57,29,155,56,123,120,299,184
20636,Hémilly,57313,57,15,30,15,68,20,103,45
20637,Héming,57314,57,30,125,15,185,150,350,155
20638,Henridorff,57315,57,96,158,38,214,95,347,254
20639,Henriville,57316,57,100,163,80,315,113,508,263
20640,Hérange,57317,57,8,20,0,25,25,50,28
20641,Hermelange,57318,57,15,75,25,80,55,160,90
20642,Herny,57319,57,40,132,52,132,108,292,172
20643,Hertzing,57320,57,25,45,15,75,25,115,70
20644,Hesse,57321,57,80,125,80,180,110,370,205
20645,Hestroff,57322,57,50,100,34,152,82,268,150
20646,Hettange-Grande,57323,57,753,1717,781,2212,1939,4932,2470
20647,Hilbesheim,57324,57,68,160,68,188,128,384,228
20648,Hilsprich,57325,57,85,218,92,269,144,505,303
20649,Hinckange,57326,57,20,84,28,112,64,204,104
20650,Holacourt,57328,57,5,20,10,25,15,50,25
20651,Holling,57329,57,35,150,30,150,85,265,185
20652,Holving,57330,57,162,238,99,504,209,812,400
20653,Hombourg-Budange,57331,57,70,115,55,195,110,360,185
20654,Hombourg-Haut,57332,57,1099,1409,752,2403,1048,4203,2508
20655,Hommarting,57333,57,100,230,65,295,170,530,330
20656,Hommert,57334,57,70,40,55,125,50,230,110
20657,Honskirch,57335,57,25,45,10,80,50,140,70
20658,L'Hôpital,57336,57,679,1178,705,1821,1011,3537,1857
20659,Hoste,57337,57,90,130,80,210,130,420,220
20660,Hottviller,57338,57,115,25,75,270,50,395,140
20661,Hultehouse,57339,57,34,58,41,124,57,222,92
20662,Hundling,57340,57,182,216,166,489,175,830,398
20663,Hunting,57341,57,40,192,68,248,180,496,232
20664,Ibigny,57342,57,20,5,20,40,0,60,25
20665,Illange,57343,57,258,354,141,700,378,1219,612
20666,Imling,57344,57,60,140,104,236,152,492,200
20667,Inglange,57345,57,8,101,33,162,73,268,109
20668,Insming,57346,57,70,148,65,165,137,367,218
20669,Insviller,57347,57,10,40,15,70,35,120,50
20670,Ippling,57348,57,103,139,65,210,146,421,242
20671,Jallaucourt,57349,57,5,60,20,40,30,90,65
20672,Jouy-aux-Arches,57350,57,128,329,122,509,259,890,457
20673,Jury,57351,57,30,250,70,375,175,620,280
20674,Jussy,57352,57,50,80,30,200,85,315,130
20675,Juvelize,57353,57,20,10,5,25,15,45,30
20676,Juville,57354,57,8,28,0,20,52,72,36
20677,Kalhausen,57355,57,85,225,50,289,215,554,310
20678,Kanfen,57356,57,69,279,58,317,322,697,348
20679,Kappelkinger,57357,57,45,90,30,165,70,265,135
20680,Kédange-sur-Canner,57358,57,85,290,145,335,225,705,375
20681,Kemplich,57359,57,20,52,8,48,44,100,72
20682,Kerbach,57360,57,108,248,104,508,172,784,356
20683,Kerling-lès-Sierck,57361,57,68,128,24,196,108,328,196
20684,Kerprich-aux-Bois,57362,57,45,38,0,25,30,55,83
20685,Kirsch-lès-Sierck,57364,57,15,90,30,95,80,205,105
20686,Kirschnaumen,57365,57,85,115,65,150,80,295,200
20687,Kirviller,57366,57,6,47,12,21,40,73,53
20688,Klang,57367,57,20,65,45,105,25,175,85
20689,Knutange,57368,57,400,720,390,990,685,2065,1120
20690,Koenigsmacker,57370,57,230,468,326,712,446,1484,698
20691,Haute-Kontz,57371,57,36,120,68,140,183,391,156
20692,Kuntzig,57372,57,142,315,75,375,309,759,457
20693,Lachambre,57373,57,54,216,84,237,207,528,270
20694,Lafrimbolle,57374,57,28,32,24,80,44,148,60
20695,Lagarde,57375,57,50,18,17,59,16,92,68
20696,Lambach,57376,57,53,91,62,164,76,302,144
20697,Landange,57377,57,13,60,12,61,41,114,73
20698,Landroff,57379,57,25,75,25,75,75,175,100
20699,Laneuveville-lès-Lorquin,57380,57,12,28,4,28,32,64,40
20700,Laneuveville-en-Saulnois,57381,57,16,91,38,82,34,154,107
20701,Langatte,57382,57,25,165,50,165,150,365,190
20702,Languimberg,57383,57,35,25,30,60,25,115,60
20703,Laning,57384,57,76,128,68,188,116,372,204
20704,Laquenexy,57385,57,76,303,82,334,267,683,379
20705,Laudrefang,57386,57,32,66,33,125,47,205,98
20706,Laumesfeld,57387,57,28,60,36,72,76,184,88
20707,Launstroff,57388,57,15,50,20,140,20,180,65
20708,Lelling,57389,57,40,125,45,180,95,320,165
20709,Lemberg,57390,57,245,320,135,520,230,885,565
20710,Lemoncourt,57391,57,10,20,5,10,20,35,30
20711,Lemud,57392,57,47,65,48,111,60,219,112
20712,Lengelsheim,57393,57,12,72,12,84,52,148,84
20713,Léning,57394,57,21,84,18,70,77,165,105
20714,Lesse,57395,57,40,45,10,65,35,110,85
20715,Lessy,57396,57,95,140,69,323,110,502,235
20716,Ley,57397,57,32,8,20,32,4,56,40
20717,Leyviller,57398,57,56,112,39,118,117,274,168
20718,Lezey,57399,57,20,25,10,15,25,50,45
20719,Lidrezing,57401,57,5,25,20,30,20,70,30
20720,Liederschiedt,57402,57,10,35,5,55,25,85,45
20721,Liéhon,57403,57,35,0,10,45,5,60,35
20722,Lindre-Basse,57404,57,36,48,12,92,48,152,84
20723,Lindre-Haute,57405,57,0,6,0,30,3,33,6
20724,Liocourt,57406,57,5,30,10,65,15,90,35
20725,Lixheim,57407,57,88,140,60,128,176,364,228
20726,Lixing-lès-Rouhling,57408,57,67,189,86,323,181,590,256
20727,Lixing-lès-Saint-Avold,57409,57,100,136,60,260,136,456,236
20728,Lhor,57410,57,35,45,5,35,30,70,80
20729,Lommerange,57411,57,40,55,19,133,40,192,95
20730,Longeville-lès-Metz,57412,57,506,738,681,1257,695,2633,1244
20731,Longeville-lès-Saint-Avold,57413,57,407,740,471,1300,631,2402,1147
20732,Lorquin,57414,57,115,215,135,368,150,653,330
20733,Lorry-lès-Metz,57415,57,225,387,122,649,301,1072,612
20734,Lorry-Mardigny,57416,57,60,179,33,192,132,357,239
20735,Lostroff,57417,57,5,20,0,40,10,50,25
20736,Loudrefing,57418,57,40,68,56,104,44,204,108
20737,Loupershouse,57419,57,122,201,62,275,205,542,323
20738,Loutzviller,57421,57,16,23,0,42,43,85,39
20739,Louvigny,57422,57,110,215,85,260,185,530,325
20740,Lubécourt,57423,57,0,22,13,28,8,49,22
20741,Lucy,57424,57,12,47,9,55,42,106,59
20742,Luppy,57425,57,34,168,40,151,143,334,202
20743,Luttange,57426,57,80,241,80,296,193,569,321
20744,Lutzelbourg,57427,57,76,110,48,156,146,350,186
20745,Macheren,57428,57,352,678,235,1130,419,1784,1030
20746,Mainvillers,57430,57,9,72,16,100,88,204,81
20747,Maizeroy,57431,57,15,80,15,120,75,210,95
20748,Maizery,57432,57,20,40,30,70,25,125,60
20749,Maizières-lès-Metz,57433,57,1300,2809,1326,3003,2330,6659,4109
20750,Maizières-lès-Vic,57434,57,72,139,36,148,110,294,211
20751,Malaucourt-sur-Seille,57436,57,15,20,10,65,10,85,35
20752,Malling,57437,57,70,170,30,165,185,380,240
20753,Malroy,57438,57,30,50,15,155,100,270,80
20754,Manderen,57439,57,36,104,28,168,104,300,140
20755,Manhoué,57440,57,56,32,8,24,28,60,88
20756,Manom,57441,57,253,488,362,862,498,1722,741
20757,Many,57442,57,12,93,24,61,84,169,105
20758,Marange-Silvange,57443,57,685,1370,620,1851,1080,3551,2055
20759,Marange-Zondrange,57444,57,12,78,38,89,77,204,90
20760,Marieulles,57445,57,44,191,60,240,132,432,235
20761,Marimont-lès-Bénestroff,57446,57,0,5,0,20,10,30,5
20762,Marly,57447,57,1472,1957,853,3788,1391,6032,3429
20763,Marsal,57448,57,24,57,17,62,66,145,81
20764,Marsilly,57449,57,18,156,17,197,98,312,174
20765,Marthille,57451,57,10,5,20,95,25,140,15
20766,La Maxe,57452,57,94,230,40,320,175,535,324
20767,Maxstadt,57453,57,30,70,30,150,45,225,100
20768,Mécleuves,57454,57,120,264,100,536,160,796,384
20769,Mégange,57455,57,13,41,16,49,32,97,54
20770,Meisenthal,57456,57,89,102,43,273,128,444,191
20771,Menskirch,57457,57,9,30,12,36,32,80,39
20772,Merschweiller,57459,57,12,44,20,73,38,131,56
20773,Merten,57460,57,230,240,105,670,280,1055,470
20774,Métairies-Saint-Quirin,57461,57,40,65,5,100,65,170,105
20775,Metting,57462,57,40,84,48,104,76,228,124
20776,Metz,57463,57,11225,25707,19669,32480,22208,74357,36932
20777,Metzeresche,57464,57,44,260,100,287,157,544,304
20778,Metzervisse,57465,57,105,616,215,659,562,1436,721
20779,Metzing,57466,57,40,95,135,225,115,475,135
20780,Mey,57467,57,5,70,10,130,60,200,75
20781,Mittelbronn,57468,57,61,138,94,213,110,417,199
20782,Mittersheim,57469,57,125,155,40,180,105,325,280
20783,Molring,57470,57,10,0,0,0,5,5,10
20784,Momerstroff,57471,57,20,65,25,80,95,200,85
20785,Moncheux,57472,57,20,40,0,50,25,75,60
20786,Moncourt,57473,57,10,15,5,25,5,35,25
20787,Mondelange,57474,57,797,1281,840,1814,1044,3698,2078
20788,Mondorff,57475,57,8,144,88,108,228,424,152
20789,Monneren,57476,57,16,123,20,121,84,225,139
20790,Montbronn,57477,57,197,328,173,511,322,1006,525
20791,Montdidier,57478,57,20,10,0,25,20,45,30
20792,Montenach,57479,57,30,80,75,117,126,318,110
20793,Montigny-lès-Metz,57480,57,3180,4174,2599,7099,3831,13529,7354
20794,Montois-la-Montagne,57481,57,291,476,293,949,422,1664,767
20795,Montoy-Flanville,57482,57,71,245,104,469,188,761,316
20796,Morhange,57483,57,439,866,345,1119,596,2060,1305
20797,Morsbach,57484,57,275,535,325,1095,465,1885,810
20798,Morville-lès-Vic,57485,57,8,40,16,52,24,92,48
20799,Morville-sur-Nied,57486,57,6,15,19,44,10,73,21
20800,Moulins-lès-Metz,57487,57,877,1125,466,1422,992,2880,2002
20801,Moussey,57488,57,95,135,60,230,80,370,230
20802,Mouterhouse,57489,57,41,52,39,98,53,190,93
20803,Moyenvic,57490,57,55,110,30,90,80,200,165
20804,Moyeuvre-Grande,57491,57,1093,1848,941,2281,1470,4692,2941
20805,Moyeuvre-Petite,57492,57,70,110,70,155,55,280,180
20806,Mulcey,57493,57,50,40,15,105,25,145,90
20807,Munster,57494,57,50,45,20,90,30,140,95
20808,Narbéfontaine,57495,57,16,24,4,56,16,76,40
20809,Nébing,57496,57,10,65,60,162,50,272,75
20810,Nelling,57497,57,20,75,20,115,55,190,95
20811,Neufchef,57498,57,482,540,260,782,456,1498,1022
20812,Neufgrange,57499,57,120,263,60,625,234,919,383
20813,Neufmoulins,57500,57,0,6,9,12,6,27,6
20814,Neufvillage,57501,57,0,10,0,15,10,25,10
20815,Neunkirchen-lès-Bouzonville,57502,57,40,75,35,133,65,233,115
20816,Niderhoff,57504,57,20,55,35,120,40,195,75
20817,Niderviller,57505,57,156,267,83,366,237,686,423
20818,Niederstinzel,57506,57,60,55,15,75,55,145,115
20819,Niedervisse,57507,57,25,50,38,53,46,137,75
20820,Nilvange,57508,57,751,936,610,1495,905,3010,1687
20821,Nitting,57509,57,65,75,20,215,75,310,140
20822,Noisseville,57510,57,131,216,90,344,165,599,347
20823,Norroy-le-Veneur,57511,57,120,200,105,495,90,690,320
20824,Nouilly,57512,57,29,172,87,185,142,414,201
20825,Nousseviller-lès-Bitche,57513,57,20,20,0,90,20,110,40
20826,Nousseviller-Saint-Nabor,57514,57,139,254,122,402,203,727,393
20827,Novéant-sur-Moselle,57515,57,215,354,211,588,257,1056,569
20828,Oberdorff,57516,57,44,46,47,109,49,205,90
20829,Obergailbach,57517,57,36,104,16,108,80,204,140
20830,Oberstinzel,57518,57,20,88,40,108,84,232,108
20831,Obervisse,57519,57,16,32,8,40,56,104,48
20832,Obreck,57520,57,7,6,0,18,0,18,13
20833,Oeting,57521,57,239,586,232,915,549,1696,825
20834,Ogy,57523,57,26,160,38,158,111,307,186
20835,Ommeray,57524,57,17,27,12,24,20,56,44
20836,Oriocourt,57525,57,15,10,0,10,10,20,25
20837,Ormersviller,57526,57,32,101,40,116,92,248,133
20838,Orny,57527,57,20,100,40,112,92,244,120
20839,Oron,57528,57,15,15,5,25,25,55,30
20840,Ottange,57529,57,316,529,409,836,572,1817,845
20841,Ottonville,57530,57,31,80,35,147,79,261,111
20842,Oudrenne,57531,57,55,150,61,272,124,457,205
20843,Pagny-lès-Goin,57532,57,0,70,70,40,45,155,70
20844,Pange,57533,57,85,220,40,330,205,575,305
20845,Peltre,57534,57,268,451,164,559,326,1049,719
20846,Petit-Réderching,57535,57,220,333,145,564,267,976,553
20847,Petit-Tenquin,57536,57,35,50,30,60,50,140,85
20848,Petite-Rosselle,57537,57,763,1392,626,2280,1131,4037,2155
20849,Pettoncourt,57538,57,45,75,25,90,50,165,120
20850,Pévange,57539,57,10,10,0,20,10,30,20
20851,Phalsbourg,57540,57,552,1190,470,1385,1044,2899,1742
20852,Philippsbourg,57541,57,120,130,35,225,100,360,250
20853,Piblange,57542,57,25,320,105,265,289,659,345
20854,Pierrevillers,57543,57,176,324,184,528,272,984,500
20855,Plaine-de-Walsch,57544,57,45,125,95,290,75,460,170
20856,Plappeville,57545,57,315,415,85,860,280,1225,730
20857,Plesnois,57546,57,81,198,52,279,143,474,279
20858,Pommérieux,57547,57,90,190,30,190,165,385,280
20859,Pontoy,57548,57,33,100,43,160,42,245,133
20860,Pontpierre,57549,57,55,175,60,304,145,509,230
20861,Porcelette,57550,57,388,492,228,923,430,1581,880
20862,Postroff,57551,57,30,45,20,55,50,125,75
20863,Pouilly,57552,57,161,115,30,241,90,361,276
20864,Pournoy-la-Chétive,57553,57,55,165,70,275,90,435,220
20865,Pournoy-la-Grasse,57554,57,44,152,16,224,104,344,196
20866,Prévocourt,57555,57,15,23,0,13,32,45,38
20867,Puttelange-aux-Lacs,57556,57,350,635,285,1111,593,1989,985
20868,Puttelange-lès-Thionville,57557,57,39,274,83,247,331,661,313
20869,Puttigny,57558,57,4,16,4,25,16,45,20
20870,Puzieux,57559,57,13,31,40,30,39,109,44
20871,Racrange,57560,57,55,150,35,263,104,402,205
20872,Rahling,57561,57,60,140,90,330,150,570,200
20873,Ranguevaux,57562,57,95,145,55,295,170,520,240
20874,Raville,57563,57,4,96,20,60,92,172,100
20875,Réchicourt-le-Château,57564,57,85,135,60,165,105,330,220
20876,Rédange,57565,57,150,201,80,385,145,610,351
20877,Réding,57566,57,274,570,268,868,431,1567,844
20878,Rémelfang,57567,57,20,35,10,30,35,75,55
20879,Rémelfing,57568,57,241,331,84,473,214,771,572
20880,Rémeling,57569,57,55,75,10,70,95,175,130
20881,Rémering,57570,57,25,85,20,205,100,325,110
20882,Rémering-lès-Puttelange,57571,57,120,336,124,332,256,712,456
20883,Rémilly,57572,57,260,517,205,578,424,1207,777
20884,Réning,57573,57,19,23,6,25,15,46,42
20885,Basse-Rentgen,57574,57,35,96,63,114,90,267,131
20886,Retonfey,57575,57,113,323,76,542,272,890,436
20887,Rettel,57576,57,70,159,47,175,199,421,229
20888,Reyersviller,57577,57,35,75,53,125,75,253,110
20889,Rezonville,57578,57,15,65,40,158,40,238,80
20890,Rhodes,57579,57,20,20,0,78,20,98,40
20891,Riche,57580,57,8,40,16,46,43,105,48
20892,Richeling,57581,57,32,88,56,116,60,232,120
20893,Richemont,57582,57,184,384,232,709,348,1289,568
20894,Richeval,57583,57,15,35,5,60,20,85,50
20895,Rimling,57584,57,56,134,52,184,150,386,190
20896,Ritzing,57585,57,16,26,26,50,33,109,42
20897,Rochonvillers,57586,57,19,52,13,48,42,103,71
20898,Rodalbe,57587,57,16,53,8,62,62,132,69
20899,Rodemack,57588,57,92,347,60,288,346,694,439
20900,Rohrbach-lès-Bitche,57589,57,211,444,188,748,415,1351,655
20901,Rolbing,57590,57,40,50,25,115,25,165,90
20902,Rombas,57591,57,1483,2295,1279,2970,1768,6017,3778
20903,Romelfing,57592,57,55,85,55,140,50,245,140
20904,Roncourt,57593,57,96,245,152,272,217,641,341
20905,Roppeviller,57594,57,15,45,0,70,5,75,60
20906,Rorbach-lès-Dieuze,57595,57,3,3,19,18,0,37,6
20907,Rosbruck,57596,57,93,126,79,232,152,463,219
20908,Rosselange,57597,57,417,484,276,930,403,1609,901
20909,Rouhling,57598,57,205,432,174,744,454,1372,637
20910,Roupeldange,57599,57,44,104,32,108,88,228,148
20911,Roussy-le-Village,57600,57,128,359,108,368,338,814,487
20912,Rozérieulles,57601,57,137,353,129,410,259,798,490
20913,Rurange-lès-Thionville,57602,57,140,747,225,699,619,1543,887
20914,Russange,57603,57,107,237,132,385,303,820,344
20915,Rustroff,57604,57,95,125,65,140,130,335,220
20916,Sailly-Achâtel,57605,57,8,77,34,40,78,152,85
20917,Saint-Avold,57606,57,2028,3394,1809,5481,2675,9965,5422
20918,Sainte-Barbe,57607,57,40,155,95,345,80,520,195
20919,Saint-Epvre,57609,57,20,21,0,24,30,54,41
20920,Saint-François-Lacroix,57610,57,5,80,30,90,100,220,85
20921,Saint-Georges,57611,57,20,25,35,85,40,160,45
20922,Saint-Hubert,57612,57,4,46,4,72,59,135,50
20923,Saint-Jean-de-Bassel,57613,57,16,48,8,70,28,106,64
20924,Saint-Jean-Kourtzerode,57614,57,16,95,96,52,136,284,111
20925,Saint-Jean-Rohrbach,57615,57,180,245,75,250,240,565,425
20926,Saint-Julien-lès-Metz,57616,57,412,497,376,1081,500,1957,909
20927,Saint-Jure,57617,57,12,94,20,92,57,169,106
20928,Saint-Louis,57618,57,120,130,65,260,75,400,250
20929,Saint-Louis-lès-Bitche,57619,57,80,85,40,220,85,345,165
20930,Sainte-Marie-aux-Chênes,57620,57,524,924,414,1224,864,2502,1448
20931,Saint-Médard,57621,57,20,15,5,15,35,55,35
20932,Saint-Privat-la-Montagne,57622,57,125,480,165,625,450,1240,605
20933,Saint-Quirin,57623,57,75,110,60,275,125,460,185
20934,Sainte-Ruffine,57624,57,52,108,36,228,92,356,160
20935,Salonnes,57625,57,8,48,28,60,32,120,56
20936,Sanry-lès-Vigy,57626,57,44,146,18,181,91,290,190
20937,Sanry-sur-Nied,57627,57,45,45,30,135,50,215,90
20938,Sarralbe,57628,57,600,1160,470,1335,920,2725,1760
20939,Sarraltroff,57629,57,85,175,60,315,70,445,260
20940,Sarrebourg,57630,57,1626,2596,1542,3689,1989,7220,4222
20941,Sarreguemines,57631,57,2745,4245,2373,7268,3862,13503,6990
20942,Sarreinsming,57633,57,164,280,92,496,260,848,444
20943,Saulny,57634,57,180,315,100,590,230,920,495
20944,Schalbach,57635,57,40,80,15,130,70,215,120
20945,Schmittviller,57636,57,40,55,15,130,95,240,95
20946,Schneckenbusch,57637,57,33,57,29,78,47,154,90
20947,Schoeneck,57638,57,261,505,289,1131,479,1899,766
20948,Schorbach,57639,57,88,86,27,213,73,313,174
20949,Schwerdorff,57640,57,56,96,72,176,56,304,152
20950,Schweyen,57641,57,45,65,20,150,50,220,110
20951,Scy-Chazelles,57642,57,283,534,251,1106,467,1824,817
20952,Secourt,57643,57,20,75,30,60,40,130,95
20953,Seingbouse,57644,57,278,431,154,687,318,1159,709
20954,Semécourt,57645,57,108,206,80,345,168,593,314
20955,Serémange-Erzange,57647,57,626,1014,395,1489,780,2664,1640
20956,Servigny-lès-Raville,57648,57,32,140,69,108,97,274,172
20957,Servigny-lès-Sainte-Barbe,57649,57,40,104,12,176,104,292,144
20958,Sierck-les-Bains,57650,57,188,388,268,480,380,1128,576
20959,Siersthal,57651,57,49,122,37,215,125,377,171
20960,Sillegny,57652,57,48,101,36,169,84,289,149
20961,Silly-en-Saulnois,57653,57,10,10,5,5,15,25,20
20962,Silly-sur-Nied,57654,57,42,135,55,268,133,456,177
20963,Solgne,57655,57,94,280,95,353,176,624,374
20964,Sorbey,57656,57,15,80,45,140,75,260,95
20965,Sotzeling,57657,57,0,0,6,0,6,12,0
20966,Soucht,57658,57,186,162,109,421,113,643,348
20967,Spicheren,57659,57,362,632,279,1214,640,2133,994
20968,Stiring-Wendel,57660,57,1725,2531,1340,4524,2128,7992,4256
20969,Sturzelbronn,57661,57,20,45,5,105,25,135,65
20970,Suisse,57662,57,8,21,9,29,25,63,29
20971,Talange,57663,57,992,1751,1015,2233,1416,4664,2743
20972,Tarquimpol,57664,57,20,10,15,10,5,30,30
20973,Tenteling,57665,57,64,188,104,433,196,733,252
20974,Terville,57666,57,856,1364,925,2095,1312,4332,2220
20975,Téterchen,57667,57,70,167,79,233,165,477,237
20976,Teting-sur-Nied,57668,57,148,400,148,424,312,884,548
20977,Théding,57669,57,343,605,280,865,425,1570,948
20978,Thicourt,57670,57,5,35,5,55,30,90,40
20979,Thimonville,57671,57,9,44,9,44,33,86,53
20980,Thionville,57672,57,4900,8405,5508,12410,8168,26086,13305
20981,Thonville,57673,57,0,4,0,21,8,29,4
20982,Tincry,57674,57,24,30,8,32,38,78,54
20983,Torcheville,57675,57,30,20,0,45,20,65,50
20984,Tragny,57676,57,9,49,0,22,33,55,58
20985,Trémery,57677,57,180,170,175,405,130,710,350
20986,Tressange,57678,57,243,434,187,732,359,1278,677
20987,Tritteling-Redlach,57679,57,33,150,24,160,116,300,183
20988,Troisfontaines,57680,57,198,233,110,394,240,744,431
20989,Tromborn,57681,57,60,84,44,96,104,244,144
20990,Turquestein-Blancrupt,57682,57,8,4,4,4,4,12,12
20991,Uckange,57683,57,996,1661,730,1830,1150,3710,2657
20992,Vahl-Ebersing,57684,57,51,121,53,158,86,297,172
20993,Vahl-lès-Bénestroff,57685,57,4,40,12,40,32,84,44
20994,Vahl-lès-Faulquemont,57686,57,31,36,31,88,31,150,67
20995,Vallerange,57687,57,50,45,0,55,50,105,95
20996,Valmestroff,57689,57,13,48,40,64,39,143,61
20997,Valmont,57690,57,430,784,273,1106,563,1942,1214
20998,Valmunster,57691,57,0,15,0,54,20,74,15
20999,Vannecourt,57692,57,25,25,0,20,5,25,50
21000,Vantoux,57693,57,78,194,64,327,105,496,272
21001,Vany,57694,57,25,86,12,91,88,191,111
21002,Varize,57695,57,35,156,20,155,121,296,191
21003,Varsberg,57696,57,128,196,76,340,172,588,324
21004,Vasperviller,57697,57,52,68,25,53,63,141,120
21005,Vatimont,57698,57,29,82,16,99,42,157,111
21006,Vaudreching,57700,57,110,135,60,200,70,330,245
21007,Vaux,57701,57,120,170,55,310,160,525,290
21008,Vaxy,57702,57,6,28,6,31,23,60,34
21009,Veckersviller,57703,57,20,60,30,110,35,175,80
21010,Veckring,57704,57,68,172,52,232,160,444,240
21011,Velving,57705,57,14,52,22,86,19,127,66
21012,Vergaville,57706,57,45,135,50,265,80,395,180
21013,Vernéville,57707,57,42,148,76,156,132,364,190
21014,Verny,57708,57,207,570,130,642,410,1182,777
21015,Vescheim,57709,57,10,85,55,65,65,185,95
21016,Vibersviller,57711,57,44,125,21,141,79,241,169
21017,Vic-sur-Seille,57712,57,135,317,55,482,210,747,452
21018,Vieux-Lixheim,57713,57,15,85,25,50,80,155,100
21019,Haute-Vigneulles,57714,57,63,125,25,133,90,248,188
21020,Vigny,57715,57,20,80,25,119,57,201,100
21021,Vigy,57716,57,134,480,88,474,313,875,614
21022,Viller,57717,57,25,60,0,50,70,120,85
21023,Villers-Stoncourt,57718,57,12,64,36,60,64,160,76
21024,Villers-sur-Nied,57719,57,5,60,0,25,15,40,65
21025,Villing,57720,57,49,80,55,185,105,345,129
21026,Vilsberg,57721,57,25,85,15,140,80,235,110
21027,Vionville,57722,57,25,40,0,70,50,120,65
21028,Virming,57723,57,40,68,32,96,56,184,108
21029,Vitry-sur-Orne,57724,57,260,736,334,860,606,1800,996
21030,Vittersbourg,57725,57,28,84,48,120,72,240,112
21031,Vittoncourt,57726,57,35,105,35,145,85,265,140
21032,Viviers,57727,57,8,24,12,48,28,88,32
21033,Voimhaut,57728,57,13,52,25,84,41,150,65
21034,Volmerange-lès-Boulay,57730,57,32,184,40,156,156,352,216
21035,Volmerange-les-Mines,57731,57,264,497,235,574,462,1271,761
21036,Volmunster,57732,57,93,161,73,246,173,492,254
21037,Volstroff,57733,57,165,452,195,535,423,1153,617
21038,Voyer,57734,57,25,98,37,137,95,269,123
21039,Vry,57736,57,29,156,30,189,109,328,185
21040,Vulmont,57737,57,10,0,0,5,10,15,10
21041,Waldhouse,57738,57,78,71,25,98,79,202,149
21042,Waldweistroff,57739,57,60,155,20,110,130,260,215
21043,Waldwisse,57740,57,65,209,84,263,200,547,274
21044,Walschbronn,57741,57,90,67,51,160,60,271,157
21045,Walscheid,57742,57,228,277,120,587,211,918,505
21046,Waltembourg,57743,57,25,62,17,61,38,116,87
21047,Wiesviller,57745,57,140,204,80,389,204,673,344
21048,Willerwald,57746,57,211,335,200,398,292,890,546
21049,Wintersbourg,57747,57,30,75,45,85,45,175,105
21050,Wittring,57748,57,125,150,105,290,100,495,275
21051,Voelfling-lès-Bouzonville,57749,57,20,25,5,65,35,105,45
21052,Woelfling-lès-Sarreguemines,57750,57,45,160,100,255,180,535,205
21053,Woippy,57751,57,1178,3669,1710,4004,2584,8298,4847
21054,Woustviller,57752,57,340,740,355,1101,635,2091,1080
21055,Wuisse,57753,57,5,10,5,25,20,50,15
21056,Xanrey,57754,57,15,30,0,30,40,70,45
21057,Xocourt,57755,57,4,22,12,8,29,49,26
21058,Xouaxange,57756,57,35,70,60,80,55,195,105
21059,Yutz,57757,57,2022,3755,1893,4890,3041,9824,5777
21060,Zarbeling,57759,57,5,15,0,15,20,35,20
21061,Zetting,57760,57,165,170,50,320,140,510,335
21062,Zilling,57761,57,30,55,60,105,40,205,85
21063,Zimming,57762,57,39,182,79,193,133,405,221
21064,Zommange,57763,57,8,0,4,16,4,24,8
21065,Zoufftgen,57764,57,63,286,82,193,415,690,349
21066,Diesen,57765,57,197,200,65,401,136,602,397
21067,Stuckange,57767,57,75,280,88,268,242,598,355
21068,Achun,58001,58,16,26,0,37,21,58,42
21069,Alligny-Cosne,58002,58,104,157,72,301,177,550,261
21070,Alligny-en-Morvan,58003,58,105,95,35,328,70,433,200
21071,Alluy,58004,58,65,65,10,200,50,260,130
21072,Amazy,58005,58,52,52,10,69,24,103,104
21073,Anlezy,58006,58,35,50,25,135,20,180,85
21074,Annay,58007,58,24,76,32,160,40,232,100
21075,Anthien,58008,58,10,40,10,90,30,130,50
21076,Arbourse,58009,58,17,25,4,34,24,62,42
21077,Arleuf,58010,58,126,165,55,311,95,461,291
21078,Armes,58011,58,32,54,26,136,64,226,86
21079,Arquian,58012,58,56,90,30,276,64,370,146
21080,Arthel,58013,58,10,35,10,35,10,55,45
21081,Arzembouy,58014,58,12,6,6,36,3,45,18
21082,Asnan,58015,58,35,20,5,55,15,75,55
21083,Asnois,58016,58,44,32,8,56,24,88,76
21084,Aunay-en-Bazois,58017,58,53,31,6,80,37,123,84
21085,Authiou,58018,58,12,9,0,12,8,20,21
21086,Avrée,58019,58,10,0,5,55,5,65,10
21087,Avril-sur-Loire,58020,58,4,48,21,108,34,163,52
21088,Azy-le-Vif,58021,58,13,51,9,94,29,132,64
21089,Balleray,58022,58,16,56,24,92,40,156,72
21090,Bazoches,58023,58,19,37,9,56,25,90,56
21091,Bazolles,58024,58,42,37,17,97,43,157,79
21092,Béard,58025,58,30,55,20,45,25,90,85
21093,Beaulieu,58026,58,34,25,22,38,25,85,59
21094,Beaumont-la-Ferrière,58027,58,9,38,0,38,23,61,47
21095,Beaumont-Sardolles,58028,58,30,25,5,55,20,80,55
21096,Beuvron,58029,58,10,20,15,25,15,55,30
21097,Biches,58030,58,56,45,16,110,29,155,101
21098,Billy-Chevannes,58031,58,36,88,36,116,64,216,124
21099,Billy-sur-Oisy,58032,58,64,84,40,120,88,248,148
21100,Bitry,58033,58,40,60,25,120,50,195,100
21101,Blismes,58034,58,35,20,25,70,10,105,55
21102,Bona,58035,58,41,60,21,100,47,168,101
21103,Bouhy,58036,58,73,42,25,195,50,270,115
21104,Brassy,58037,58,110,120,35,264,75,374,230
21105,Breugnon,58038,58,40,44,12,48,24,84,84
21106,Brèves,58039,58,45,44,25,102,28,155,89
21107,Brinay,58040,58,15,45,10,50,30,90,60
21108,Brinon-sur-Beuvron,58041,58,44,24,4,92,20,116,68
21109,Bulcy,58042,58,10,15,15,80,20,115,25
21110,Bussy-la-Pesle,58043,58,20,10,0,25,0,25,30
21111,La Celle-sur-Loire,58044,58,105,200,55,360,125,540,305
21112,La Celle-sur-Nièvre,58045,58,32,28,8,76,12,96,60
21113,Cercy-la-Tour,58046,58,409,277,110,682,250,1042,686
21114,Cervon,58047,58,99,151,53,214,94,361,250
21115,Cessy-les-Bois,58048,58,5,20,10,70,15,95,25
21116,Chalaux,58049,58,30,5,0,25,10,35,35
21117,Challement,58050,58,16,12,0,32,4,36,28
21118,Challuy,58051,58,164,316,100,600,224,924,480
21119,Champallement,58052,58,8,8,4,16,0,20,16
21120,Champlemy,58053,58,82,55,0,159,54,213,137
21121,Champlin,58054,58,15,5,0,10,10,20,20
21122,Champvert,58055,58,110,155,75,349,110,534,265
21123,Champvoux,58056,58,30,70,10,140,60,210,100
21124,Chantenay-Saint-Imbert,58057,58,195,273,89,332,200,621,468
21125,La Chapelle-Saint-André,58058,58,88,76,32,112,48,192,164
21126,La Charité-sur-Loire,58059,58,945,810,375,1583,705,2663,1755
21127,Charrin,58060,58,86,113,20,251,74,345,199
21128,Chasnay,58061,58,21,13,20,29,12,61,34
21129,Château-Chinon (Ville),58062,58,325,423,217,526,267,1010,748
21130,Château-Chinon (Campagne),58063,58,120,80,25,279,60,364,200
21131,Châteauneuf-Val-de-Bargis,58064,58,114,113,45,230,68,343,227
21132,Châtillon-en-Bazois,58065,58,212,125,38,324,100,462,337
21133,Châtin,58066,58,16,7,6,38,9,53,23
21134,Chaulgnes,58067,58,152,359,96,546,289,931,511
21135,Chaumard,58068,58,70,40,10,75,40,125,110
21136,Chaumot,58069,58,15,20,15,80,25,120,35
21137,Chazeuil,58070,58,8,16,4,24,8,36,24
21138,Chevannes-Changy,58071,58,55,20,15,45,5,65,75
21139,Chevenon,58072,58,54,95,85,275,70,430,149
21140,Chevroches,58073,58,15,20,5,65,20,90,35
21141,Chiddes,58074,58,88,44,26,92,38,156,132
21142,Chitry-les-Mines,58075,58,40,21,16,70,34,120,61
21143,Chougny,58076,58,15,15,0,35,15,50,30
21144,Ciez,58077,58,88,84,32,136,36,204,172
21145,Cizely,58078,58,5,15,5,15,15,35,20
21146,Clamecy,58079,58,681,775,425,1264,531,2220,1456
21147,La Collancelle,58080,58,52,36,12,56,36,104,88
21148,Colméry,58081,58,75,20,30,180,29,239,95
21149,Corancy,58082,58,99,40,20,105,35,160,139
21150,Corbigny,58083,58,248,215,125,593,185,903,463
21151,Corvol-d'Embernard,58084,58,25,0,0,45,0,45,25
21152,Corvol-l'Orgueilleux,58085,58,132,173,60,181,135,376,305
21153,Cosne-Cours-sur-Loire,58086,58,2121,1830,909,3786,1396,6091,3951
21154,Cossaye,58087,58,101,167,70,270,125,465,268
21155,Coulanges-lès-Nevers,58088,58,670,713,227,1340,519,2086,1383
21156,Couloutre,58089,58,68,20,16,72,24,112,88
21157,Courcelles,58090,58,48,36,12,64,40,116,84
21158,Crux-la-Ville,58092,58,70,50,35,176,70,281,120
21159,Cuncy-lès-Varzy,58093,58,32,18,0,44,24,68,50
21160,Dampierre-sous-Bouhy,58094,58,150,65,35,140,55,230,215
21161,Decize,58095,58,1160,912,518,1893,739,3150,2072
21162,Devay,58096,58,48,136,56,168,100,324,184
21163,Diennes-Aubigny,58097,58,25,15,15,20,20,55,40
21164,Dirol,58098,58,25,25,15,40,10,65,50
21165,Dommartin,58099,58,15,30,25,60,30,115,45
21166,Dompierre-sur-Nièvre,58101,58,20,56,16,68,44,128,76
21167,Donzy,58102,58,282,307,58,527,205,790,589
21168,Dornecy,58103,58,88,85,39,174,64,277,173
21169,Dornes,58104,58,196,360,112,424,284,820,556
21170,Druy-Parigny,58105,58,35,78,50,110,57,217,113
21171,Dun-les-Places,58106,58,62,49,27,125,50,202,111
21172,Dun-sur-Grandry,58107,58,32,20,4,92,28,124,52
21173,Empury,58108,58,27,0,3,25,0,28,27
21174,Entrains-sur-Nohain,58109,58,168,160,84,280,144,508,328
21175,Epiry,58110,58,25,30,16,79,24,119,55
21176,Fâchin,58111,58,55,5,0,60,0,60,60
21177,La Fermeté,58112,58,52,192,32,272,152,456,244
21178,Fertrève,58113,58,10,26,5,79,5,89,36
21179,Fléty,58114,58,20,15,15,25,30,70,35
21180,Fleury-sur-Loire,58115,58,24,39,17,82,46,145,63
21181,Flez-Cuzy,58116,58,25,21,8,49,8,65,46
21182,Fourchambault,58117,58,750,1017,442,1372,705,2519,1767
21183,Fours,58118,58,156,97,29,252,89,370,253
21184,Frasnay-Reugny,58119,58,12,12,0,16,20,36,24
21185,Gâcogne,58120,58,60,40,5,95,30,130,100
21186,Garchizy,58121,58,383,840,285,1280,708,2273,1223
21187,Garchy,58122,58,75,90,35,170,55,260,165
21188,Germenay,58123,58,30,25,0,70,20,90,55
21189,Germigny-sur-Loire,58124,58,24,200,68,300,176,544,224
21190,Gien-sur-Cure,58125,58,28,4,8,36,8,52,32
21191,Gimouille,58126,58,15,115,35,165,140,340,130
21192,Giry,58127,58,41,25,10,111,20,141,66
21193,Glux-en-Glenne,58128,58,20,10,5,35,10,50,30
21194,Gouloux,58129,58,55,5,20,75,20,115,60
21195,Grenois,58130,58,37,9,0,33,6,39,46
21196,Guérigny,58131,58,349,525,173,821,450,1444,874
21197,Guipy,58132,58,40,65,10,90,60,160,105
21198,Héry,58133,58,12,8,4,8,16,28,20
21199,Imphy,58134,58,594,618,263,1204,608,2075,1212
21200,Isenay,58135,58,25,20,0,55,10,65,45
21201,Jailly,58136,58,13,3,0,18,6,24,16
21202,Lamenay-sur-Loire,58137,58,12,12,16,16,4,36,24
21203,Langeron,58138,58,36,115,56,75,98,229,151
21204,Lanty,58139,58,29,10,12,42,9,63,39
21205,Larochemillay,58140,58,85,15,10,85,25,120,100
21206,Lavault-de-Frétoy,58141,58,22,9,0,15,6,21,31
21207,Limanton,58142,58,57,27,17,85,22,124,84
21208,Limon,58143,58,8,40,16,48,36,100,48
21209,Livry,58144,58,76,165,39,231,129,399,241
21210,Lormes,58145,58,227,210,59,460,198,717,437
21211,Lucenay-lès-Aix,58146,58,164,189,67,342,139,548,353
21212,Lurcy-le-Bourg,58147,58,52,80,8,128,48,184,132
21213,Luthenay-Uxeloup,58148,58,88,164,24,204,140,368,252
21214,Luzy,58149,58,495,255,150,765,180,1095,750
21215,Lys,58150,58,24,22,8,32,16,56,46
21216,La Machine,58151,58,699,618,230,1286,492,2008,1317
21217,Magny-Cours,58152,58,212,288,128,420,268,816,500
21218,Magny-Lormes,58153,58,16,4,4,16,12,32,20
21219,La Maison-Dieu,58154,58,30,29,0,49,15,64,59
21220,La Marche,58155,58,125,88,19,169,81,269,213
21221,Marcy,58156,58,20,26,3,76,9,88,46
21222,Marigny-l'Église,58157,58,69,74,23,127,61,211,143
21223,Mars-sur-Allier,58158,58,30,67,38,104,35,177,97
21224,Marigny-sur-Yonne,58159,58,37,25,4,59,16,79,62
21225,Marzy,58160,58,491,815,197,1352,631,2180,1306
21226,Maux,58161,58,19,30,15,70,20,105,49
21227,Menestreau,58162,58,20,25,0,60,10,70,45
21228,Menou,58163,58,50,20,0,85,20,105,70
21229,Mesves-sur-Loire,58164,58,90,163,65,273,110,448,253
21230,Metz-le-Comte,58165,58,50,45,0,50,25,75,95
21231,Mhère,58166,58,73,10,0,109,35,144,83
21232,Millay,58168,58,80,75,19,147,47,213,155
21233,Moissy-Moulinot,58169,58,0,10,5,20,0,25,10
21234,Monceaux-le-Comte,58170,58,28,25,6,47,14,67,53
21235,Montapas,58171,58,54,40,16,107,35,158,94
21236,Montambert,58172,58,24,28,28,40,20,88,52
21237,Montaron,58173,58,70,15,5,60,0,65,85
21238,Montenoison,58174,58,12,12,12,76,12,100,24
21239,Mont-et-Marré,58175,58,55,15,5,65,10,80,70
21240,Montigny-aux-Amognes,58176,58,68,132,64,204,100,368,200
21241,Montigny-en-Morvan,58177,58,108,48,32,116,24,172,156
21242,Montigny-sur-Canne,58178,58,32,20,28,44,32,104,52
21243,Montreuillon,58179,58,68,32,12,120,40,172,100
21244,Montsauche-les-Settons,58180,58,136,68,40,252,60,352,204
21245,Moraches,58181,58,17,22,9,51,13,73,39
21246,Moulins-Engilbert,58182,58,319,195,96,539,145,780,514
21247,Mouron-sur-Yonne,58183,58,15,15,15,35,15,65,30
21248,Moussy,58184,58,25,10,0,55,15,70,35
21249,Moux-en-Morvan,58185,58,85,57,62,232,59,353,142
21250,Murlin,58186,58,8,30,12,29,17,58,38
21251,Myennes,58187,58,105,115,35,175,100,310,220
21252,Nannay,58188,58,20,12,4,46,12,62,32
21253,Narcy,58189,58,80,140,50,185,100,335,220
21254,Neuffontaines,58190,58,16,9,6,38,6,50,25
21255,Neuilly,58191,58,24,24,0,44,28,72,48
21256,Neuville-lès-Decize,58192,58,9,53,35,60,55,150,62
21257,Neuvy-sur-Loire,58193,58,265,395,120,424,290,834,660
21258,Nevers,58194,58,5533,7214,4341,10883,5352,20576,12747
21259,La Nocle-Maulaix,58195,58,75,35,5,130,30,165,110
21260,Nolay,58196,58,36,88,20,144,88,252,124
21261,Nuars,58197,58,27,30,4,43,30,77,57
21262,Oisy,58198,58,65,60,10,125,30,165,125
21263,Onlay,58199,58,65,20,5,35,25,65,85
21264,Ouagne,58200,58,44,15,9,34,31,74,59
21265,Oudan,58201,58,35,20,10,55,30,95,55
21266,Ougny,58202,58,5,0,5,25,0,30,5
21267,Oulon,58203,58,10,5,0,45,5,50,15
21268,Ourouër,58204,58,50,80,30,75,75,180,130
21269,Ouroux-en-Morvan,58205,58,136,78,27,281,53,361,214
21270,Parigny-la-Rose,58206,58,5,5,0,15,5,20,10
21271,Parigny-les-Vaux,58207,58,105,265,90,295,225,610,370
21272,Pazy,58208,58,60,55,0,135,55,190,115
21273,Perroy,58209,58,44,16,32,68,16,116,60
21274,Planchez,58210,58,95,30,45,105,25,175,125
21275,Poil,58211,58,25,45,0,85,10,95,70
21276,Poiseux,58212,58,48,104,28,108,64,200,152
21277,Pougny,58213,58,35,105,20,205,95,320,140
21278,Pougues-les-Eaux,58214,58,343,482,219,854,382,1455,825
21279,Pouilly-sur-Loire,58215,58,381,321,155,574,236,965,702
21280,Pouques-Lormes,58216,58,52,20,4,64,20,88,72
21281,Pousseaux,58217,58,30,65,10,65,40,115,95
21282,Prémery,58218,58,438,314,95,708,205,1008,752
21283,Préporché,58219,58,28,20,8,100,44,152,48
21284,Raveau,58220,58,84,144,56,260,144,460,228
21285,Rémilly,58221,58,36,24,4,64,24,92,60
21286,Rix,58222,58,27,17,12,62,22,96,44
21287,Rouy,58223,58,100,139,65,169,130,364,239
21288,Ruages,58224,58,25,5,15,20,15,50,30
21289,Saincaize-Meauce,58225,58,32,85,33,117,84,234,117
21290,Saint-Agnan,58226,58,52,12,16,52,16,84,64
21291,Saint-Amand-en-Puisaye,58227,58,308,192,120,420,148,688,500
21292,Saint-Andelain,58228,58,109,90,30,157,90,277,199
21293,Saint-André-en-Morvan,58229,58,34,24,39,143,22,204,58
21294,Saint-Aubin-des-Chaumes,58230,58,15,5,21,30,15,66,20
21295,Saint-Aubin-les-Forges,58231,58,50,100,40,170,70,280,150
21296,Saint-Benin-d'Azy,58232,58,175,320,95,405,210,710,495
21297,Saint-Benin-des-Bois,58233,58,35,30,5,60,35,100,65
21298,Saint-Bonnot,58234,58,16,24,4,28,24,56,40
21299,Saint-Brisson,58235,58,80,45,10,130,20,160,125
21300,Sainte-Colombe-des-Bois,58236,58,27,21,3,37,16,56,48
21301,Saint-Didier,58237,58,5,0,0,15,5,20,5
21302,Saint-Éloi,58238,58,258,510,160,848,375,1383,768
21303,Saint-Firmin,58239,58,59,35,25,45,15,85,94
21304,Saint-Franchy,58240,58,15,15,0,55,0,55,30
21305,Saint-Germain-Chassenay,58241,58,75,60,10,130,50,190,135
21306,Saint-Germain-des-Bois,58242,58,19,12,0,41,18,59,31
21307,Saint-Gratien-Savigny,58243,58,8,12,8,33,16,57,20
21308,Saint-Hilaire-en-Morvan,58244,58,40,40,12,88,36,136,80
21309,Saint-Hilaire-Fontaine,58245,58,64,44,0,40,36,76,108
21310,Saint-Honoré-les-Bains,58246,58,146,125,50,343,105,498,271
21311,Saint-Jean-aux-Amognes,58247,58,44,124,64,152,116,332,168
21312,Saint-Laurent-l'Abbaye,58248,58,30,45,5,100,25,130,75
21313,Saint-Léger-de-Fougeret,58249,58,64,20,15,80,20,115,84
21314,Saint-Léger-des-Vignes,58250,58,364,434,95,742,277,1114,798
21315,Saint-Loup,58251,58,48,92,76,168,96,340,140
21316,Saint-Malo-en-Donziois,58252,58,44,4,8,52,16,76,48
21317,Sainte-Marie,58253,58,20,25,0,30,15,45,45
21318,Saint-Martin-d'Heuille,58254,58,45,145,25,255,110,390,190
21319,Saint-Martin-du-Puy,58255,58,70,35,15,115,35,165,105
21320,Saint-Martin-sur-Nohain,58256,58,70,80,20,140,60,220,150
21321,Saint-Maurice,58257,58,6,3,0,24,3,27,9
21322,Saint-Ouen-sur-Loire,58258,58,30,125,65,205,120,390,155
21323,Saint-Parize-en-Viry,58259,58,25,10,37,63,20,120,35
21324,Saint-Parize-le-Châtel,58260,58,120,355,80,555,225,860,475
21325,Saint-Père,58261,58,199,238,75,444,188,707,437
21326,Saint-Péreuse,58262,58,45,40,5,105,25,135,85
21327,Saint-Pierre-du-Mont,58263,58,25,45,30,80,20,130,70
21328,Saint-Pierre-le-Moûtier,58264,58,335,425,145,625,275,1045,760
21329,Saint-Quentin-sur-Nohain,58265,58,18,13,3,28,21,52,31
21330,Saint-Révérien,58266,58,66,15,0,60,15,75,81
21331,Saint-Saulge,58267,58,175,125,69,185,85,339,300
21332,Saint-Seine,58268,58,40,35,15,90,25,130,75
21333,Saint-Sulpice,58269,58,45,85,40,180,80,300,130
21334,Saint-Vérain,58270,58,65,60,25,135,50,210,125
21335,Saizy,58271,58,22,24,3,41,12,56,46
21336,Sardy-lès-Épiry,58272,58,36,10,16,62,10,88,46
21337,Sauvigny-les-Bois,58273,58,235,323,96,550,265,911,558
21338,Savigny-Poil-Fol,58274,58,30,20,9,63,10,82,50
21339,Saxi-Bourdon,58275,58,60,80,10,105,65,180,140
21340,Sémelay,58276,58,65,40,10,80,50,140,105
21341,Sermages,58277,58,30,50,20,80,25,125,80
21342,Sermoise-sur-Loire,58278,58,143,345,103,598,261,962,488
21343,Sichamps,58279,58,12,39,0,51,48,99,51
21344,Sougy-sur-Loire,58280,58,88,152,48,256,112,416,240
21345,Suilly-la-Tour,58281,58,136,141,25,247,75,347,277
21346,Surgy,58282,58,108,50,5,147,20,172,158
21347,Taconnay,58283,58,12,0,0,48,12,60,12
21348,Talon,58284,58,12,4,24,16,0,40,16
21349,Tamnay-en-Bazois,58285,58,44,16,12,41,21,74,60
21350,Tannay,58286,58,128,63,47,205,69,321,191
21351,Tazilly,58287,58,58,32,10,93,20,123,90
21352,Teigny,58288,58,15,30,5,50,20,75,45
21353,Ternant,58289,58,10,66,15,101,20,136,76
21354,Thaix,58290,58,6,13,0,30,0,30,19
21355,Thianges,58291,58,20,20,4,88,32,124,40
21356,Tintury,58292,58,45,30,5,80,25,110,75
21357,Toury-Lurcy,58293,58,60,65,30,200,40,270,125
21358,Toury-sur-Jour,58294,58,25,20,10,45,10,65,45
21359,Tracy-sur-Loire,58295,58,115,188,50,308,177,535,303
21360,Tresnay,58296,58,31,48,10,41,41,92,79
21361,Trois-Vèvres,58297,58,36,36,28,92,40,160,72
21362,Tronsanges,58298,58,40,95,50,115,100,265,135
21363,Trucy-l'Orgueilleux,58299,58,32,32,15,90,22,127,64
21364,Urzy,58300,58,202,384,132,615,283,1030,586
21365,Vandenesse,58301,58,61,31,13,110,64,187,92
21366,Varennes-lès-Narcy,58302,58,112,216,80,336,128,544,328
21367,Varennes-Vauzelles,58303,58,1556,1675,803,3620,1363,5786,3231
21368,Varzy,58304,58,140,180,120,405,180,705,320
21369,Vauclaix,58305,58,9,22,6,31,26,63,31
21370,Verneuil,58306,58,65,56,40,90,35,165,121
21371,Vielmanay,58307,58,45,35,5,40,45,90,80
21372,Vignol,58308,58,10,15,10,10,10,30,25
21373,Villapourçon,58309,58,131,35,10,180,45,235,166
21374,Villiers-le-Sec,58310,58,8,12,0,20,12,32,20
21375,Ville-Langy,58311,58,48,43,9,129,25,163,91
21376,Villiers-sur-Yonne,58312,58,30,75,5,123,65,193,105
21377,Vitry-Laché,58313,58,26,10,5,25,15,45,36
21378,Abancourt,59001,59,68,108,56,128,76,260,176
21379,Abscon,59002,59,539,1214,517,1154,840,2511,1753
21380,Aibes,59003,59,16,112,36,116,104,256,128
21381,Aix,59004,59,65,275,135,294,254,683,340
21382,Allennes-les-Marais,59005,59,190,923,370,1274,660,2304,1113
21383,Amfroipret,59006,59,20,72,28,60,52,140,92
21384,Anhiers,59007,59,120,266,100,255,180,535,386
21385,Aniche,59008,59,833,3243,1424,2745,2014,6183,4076
21386,Villeneuve-d'Ascq,59009,59,3960,16858,9019,17392,11689,38100,20818
21387,Anneux,59010,59,55,62,35,55,63,153,117
21388,Annoeullin,59011,59,733,2625,1030,3169,1906,6105,3358
21389,Anor,59012,59,337,967,334,1078,616,2028,1304
21390,Anstaing,59013,59,124,429,91,391,287,769,553
21391,Anzin,59014,59,1229,3735,1878,3602,2460,7940,4964
21392,Arleux,59015,59,293,664,349,953,569,1871,957
21393,Armbouts-Cappel,59016,59,220,560,155,946,464,1565,780
21394,Armentières,59017,59,2324,7239,3542,6514,4950,15006,9563
21395,Arnèke,59018,59,279,410,125,444,280,849,689
21396,Artres,59019,59,68,233,120,356,188,664,301
21397,Assevent,59021,59,156,508,188,624,380,1192,664
21398,Attiches,59022,59,170,566,238,735,499,1472,736
21399,Aubencheul-au-Bac,59023,59,50,90,70,175,95,340,140
21400,Auberchicourt,59024,59,573,1016,435,1342,741,2518,1589
21401,Aubers,59025,59,174,384,134,611,211,956,558
21402,Aubigny-au-Bac,59026,59,124,337,84,407,252,743,461
21403,Aubry-du-Hainaut,59027,59,144,305,88,539,298,925,449
21404,Auby,59028,59,834,2069,859,2317,1242,4418,2903
21405,Auchy-lez-Orchies,59029,59,120,484,152,388,388,928,604
21406,Audignies,59031,59,20,84,12,116,80,208,104
21407,Aulnoy-lez-Valenciennes,59032,59,725,1645,1110,1970,1250,4330,2370
21408,Aulnoye-Aymeries,59033,59,1186,2264,949,2725,1586,5260,3450
21409,Avelin,59034,59,170,638,274,1041,485,1800,808
21410,Avesnelles,59035,59,404,582,234,762,348,1344,986
21411,Avesnes-sur-Helpe,59036,59,509,1301,659,1263,723,2645,1810
21412,Avesnes-les-Aubert,59037,59,446,932,424,1044,660,2128,1378
21413,Avesnes-le-Sec,59038,59,224,396,108,372,324,804,620
21414,Awoingt,59039,59,64,273,84,249,201,534,337
21415,Bachant,59041,59,220,615,320,700,400,1420,835
21416,Bachy,59042,59,126,463,157,559,258,974,589
21417,Bailleul,59043,59,1635,3161,1834,4720,2383,8937,4796
21418,Baisieux,59044,59,440,1288,455,1368,1048,2871,1728
21419,Baives,59045,59,4,44,20,56,32,108,48
21420,Bambecque,59046,59,85,240,35,200,190,425,325
21421,Banteux,59047,59,40,52,60,128,44,232,92
21422,Bantigny,59048,59,28,150,40,181,68,289,178
21423,Bantouzelle,59049,59,45,130,50,145,55,250,175
21424,Bas-Lieu,59050,59,56,64,52,132,52,236,120
21425,La Bassée,59051,59,678,1735,761,1775,1336,3872,2413
21426,Bauvin,59052,59,487,1323,545,1784,1025,3354,1810
21427,Bavay,59053,59,385,720,435,1209,534,2178,1105
21428,Bavinchove,59054,59,104,212,124,304,176,604,316
21429,Bazuel,59055,59,70,90,40,250,65,355,160
21430,Beaucamps-Ligny,59056,59,77,223,70,296,137,503,300
21431,Beaudignies,59057,59,60,155,35,185,130,350,215
21432,Beaufort,59058,59,96,228,104,352,196,652,324
21433,Beaumont-en-Cambrésis,59059,59,55,126,45,140,85,270,181
21434,Beaurain,59060,59,0,70,8,50,57,115,70
21435,Beaurepaire-sur-Sambre,59061,59,35,75,10,55,80,145,110
21436,Beaurieux,59062,59,12,44,17,28,38,83,56
21437,Beauvois-en-Cambrésis,59063,59,185,625,210,720,360,1290,810
21438,Bellaing,59064,59,193,183,115,413,160,688,376
21439,Bellignies,59065,59,130,195,85,240,170,495,325
21440,Bérelles,59066,59,5,30,5,55,35,95,35
21441,Bergues,59067,59,489,755,497,1190,640,2327,1244
21442,Berlaimont,59068,59,513,667,274,929,526,1729,1180
21443,Bermerain,59069,59,79,125,133,250,120,503,204
21444,Bermeries,59070,59,38,88,19,83,90,192,126
21445,Bersée,59071,59,205,565,210,790,430,1430,770
21446,Bersillies,59072,59,28,48,20,108,44,172,76
21447,Berthen,59073,59,12,123,43,210,106,359,135
21448,Bertry,59074,59,286,572,231,679,410,1320,858
21449,Béthencourt,59075,59,75,220,50,236,150,436,295
21450,Bettignies,59076,59,15,65,55,145,35,235,80
21451,Bettrechies,59077,59,17,62,12,74,44,130,79
21452,Beugnies,59078,59,65,170,95,200,120,415,235
21453,Beuvrages,59079,59,649,1957,887,1751,1275,3913,2606
21454,Beuvry-la-Forêt,59080,59,245,675,230,1015,495,1740,920
21455,Bévillers,59081,59,44,99,44,208,90,342,143
21456,Bierne,59082,59,88,515,167,606,364,1137,603
21457,Bissezeele,59083,59,8,48,21,92,44,157,56
21458,Blaringhem,59084,59,170,610,280,605,455,1340,780
21459,Blécourt,59085,59,40,109,10,105,73,188,149
21460,Boeschepe,59086,59,188,558,182,762,442,1386,746
21461,Boëseghem,59087,59,50,175,85,305,100,490,225
21462,Bois-Grenier,59088,59,131,434,79,531,314,924,565
21463,Bollezeele,59089,59,170,390,105,445,245,795,560
21464,Bondues,59090,59,1225,2492,890,3355,1573,5818,3717
21465,Borre,59091,59,24,200,60,184,120,364,224
21466,Bouchain,59092,59,533,894,397,1377,708,2482,1427
21467,Boulogne-sur-Helpe,59093,59,47,97,26,97,63,186,144
21468,Bourbourg,59094,59,800,1799,904,2046,1249,4199,2599
21469,Bourghelles,59096,59,144,424,180,572,292,1044,568
21470,Boursies,59097,59,56,132,0,76,95,171,188
21471,Bousbecque,59098,59,379,1304,555,1579,912,3046,1683
21472,Bousies,59099,59,164,416,188,620,328,1136,580
21473,Bousignies,59100,59,40,80,24,96,56,176,120
21474,Bousignies-sur-Roc,59101,59,55,100,50,150,60,260,155
21475,Boussières-en-Cambrésis,59102,59,40,85,90,125,65,280,125
21476,Boussières-sur-Sambre,59103,59,64,141,41,120,97,258,205
21477,Boussois,59104,59,343,893,256,1028,622,1906,1236
21478,Bouvignies,59105,59,168,396,140,552,296,988,564
21479,Bouvines,59106,59,72,148,63,244,92,399,220
21480,Bray-Dunes,59107,59,624,995,362,1756,804,2922,1619
21481,Briastre,59108,59,65,210,85,210,130,425,275
21482,Brillon,59109,59,54,195,60,265,155,480,249
21483,Brouckerque,59110,59,94,333,122,512,183,817,427
21484,Broxeele,59111,59,35,109,44,73,90,207,144
21485,Bruay-sur-l'Escaut,59112,59,971,3631,1384,3327,2385,7096,4602
21486,Bruille-lez-Marchiennes,59113,59,55,401,119,319,348,786,456
21487,Bruille-Saint-Amand,59114,59,132,342,202,582,266,1050,474
21488,Brunémont,59115,59,72,234,51,142,177,370,306
21489,Bry,59116,59,16,124,28,136,104,268,140
21490,Bugnicourt,59117,59,100,228,80,292,216,588,328
21491,Busigny,59118,59,220,665,300,800,450,1550,885
21492,Buysscheure,59119,59,42,163,40,171,110,321,205
21493,Caëstre,59120,59,228,540,200,504,416,1120,768
21494,Cagnoncles,59121,59,45,155,60,215,105,380,200
21495,Cambrai,59122,59,4091,7788,4487,9837,5669,19993,11879
21496,Camphin-en-Carembault,59123,59,128,400,148,568,356,1072,528
21497,Camphin-en-Pévèle,59124,59,124,684,190,643,505,1338,808
21498,Cantaing-sur-Escaut,59125,59,43,99,46,105,60,211,142
21499,Cantin,59126,59,160,312,124,512,244,880,472
21500,Capelle,59127,59,5,45,25,65,40,130,50
21501,Capinghem,59128,59,180,562,196,639,370,1205,742
21502,Cappelle-en-Pévèle,59129,59,175,718,160,648,561,1369,893
21503,Cappelle-Brouck,59130,59,75,295,125,363,270,758,370
21504,Cappelle-la-Grande,59131,59,738,2070,970,2565,1485,5020,2808
21505,Carnières,59132,59,70,290,85,460,175,720,360
21506,Carnin,59133,59,83,239,109,320,160,589,322
21507,Cartignies,59134,59,172,384,108,364,236,708,556
21508,Cassel,59135,59,264,549,245,730,394,1369,813
21509,Le Cateau-Cambrésis,59136,59,817,1781,869,2025,1180,4074,2598
21510,Catillon-sur-Sambre,59137,59,95,196,47,250,179,476,291
21511,Cattenières,59138,59,84,180,84,184,128,396,264
21512,Caudry,59139,59,1504,4146,1769,4408,2695,8872,5650
21513,Caullery,59140,59,60,124,32,117,73,222,184
21514,Cauroir,59141,59,52,184,44,200,136,380,236
21515,Cerfontaine,59142,59,36,125,76,234,133,443,161
21516,La Chapelle-d'Armentières,59143,59,852,2132,922,2676,1556,5154,2984
21517,Château-l'Abbaye,59144,59,40,280,92,284,192,568,320
21518,Chemy,59145,59,52,209,76,268,152,496,261
21519,Chéreng,59146,59,306,677,295,1208,448,1951,983
21520,Choisies,59147,59,10,0,25,15,0,40,10
21521,Clairfayts,59148,59,15,115,39,117,80,236,130
21522,Clary,59149,59,184,316,84,348,264,696,500
21523,Cobrieux,59150,59,21,111,48,212,77,337,132
21524,Colleret,59151,59,215,361,150,560,280,990,576
21525,Comines,59152,59,1076,3425,1367,3536,2616,7519,4501
21526,Condé-sur-l'Escaut,59153,59,1356,2641,1160,2600,1716,5476,3997
21527,Coudekerque-Branche,59155,59,2725,5416,2377,6874,4042,13293,8141
21528,Courchelettes,59156,59,401,651,253,929,407,1589,1052
21529,Cousolre,59157,59,260,505,290,735,435,1460,765
21530,Coutiches,59158,59,201,809,294,958,658,1910,1010
21531,Craywick,59159,59,15,278,67,146,184,397,293
21532,Crespin,59160,59,440,1358,519,1245,874,2638,1798
21533,Crèvecoeur-sur-l'Escaut,59161,59,98,181,52,192,119,363,279
21534,Crochte,59162,59,47,167,50,231,121,402,214
21535,Croix,59163,59,2286,5378,2862,5919,4135,12916,7664
21536,Croix-Caluyau,59164,59,20,50,25,105,45,175,70
21537,Cuincy,59165,59,865,1687,540,2204,1178,3922,2552
21538,Curgies,59166,59,135,265,125,398,245,768,400
21539,Cuvillers,59167,59,19,53,24,40,32,96,72
21540,Cysoing,59168,59,495,1357,478,1600,932,3010,1852
21541,Damousies,59169,59,25,35,30,55,45,130,60
21542,Dechy,59170,59,625,1273,640,1555,940,3135,1898
21543,Dehéries,59171,59,0,15,0,25,10,35,15
21544,Denain,59172,59,1875,6468,2616,5231,3631,11478,8343
21545,Deûlémont,59173,59,100,490,165,605,290,1060,590
21546,Dimechaux,59174,59,36,101,24,132,60,216,137
21547,Dimont,59175,59,36,68,44,128,44,216,104
21548,Doignies,59176,59,16,104,32,96,72,200,120
21549,Dompierre-sur-Helpe,59177,59,87,179,87,285,167,539,266
21550,Douai,59178,59,4438,9423,5671,11337,7089,24097,13861
21551,Douchy-les-Mines,59179,59,1009,3367,1180,2877,2193,6250,4376
21552,Le Doulieu,59180,59,64,404,148,540,274,962,468
21553,Dourlers,59181,59,60,140,44,224,120,388,200
21554,Drincham,59182,59,16,78,16,70,48,134,94
21555,Dunkerque,59183,59,10712,21088,11424,28199,15632,55255,31800
21556,Ebblinghem,59184,59,40,180,50,219,150,419,220
21557,Écaillon,59185,59,220,500,160,635,360,1155,720
21558,Eccles,59186,59,25,15,5,25,15,45,40
21559,Éclaibes,59187,59,19,100,15,115,60,190,119
21560,Écuélin,59188,59,4,44,8,44,40,92,48
21561,Eecke,59189,59,77,320,138,382,211,731,397
21562,Élesmes,59190,59,96,192,76,464,144,684,288
21563,Élincourt,59191,59,84,160,112,176,92,380,244
21564,Émerchicourt,59192,59,74,230,39,253,191,483,304
21565,Emmerin,59193,59,285,795,290,1015,760,2065,1080
21566,Englefontaine,59194,59,134,287,133,411,223,767,421
21567,Englos,59195,59,68,157,53,164,119,336,225
21568,Ennetières-en-Weppes,59196,59,197,310,124,380,217,721,507
21569,Ennevelin,59197,59,148,587,198,775,400,1373,735
21570,Eppe-Sauvage,59198,59,55,55,5,100,55,160,110
21571,Erchin,59199,59,125,165,50,240,120,410,290
21572,Eringhem,59200,59,40,175,5,125,140,270,215
21573,Erquinghem-le-Sec,59201,59,46,174,30,132,134,296,220
21574,Erquinghem-Lys,59202,59,396,1245,609,1656,903,3168,1641
21575,Erre,59203,59,110,385,170,535,285,990,495
21576,Escarmain,59204,59,56,103,52,143,50,245,159
21577,Escaudain,59205,59,949,2766,1142,2478,1660,5280,3715
21578,Escaudoeuvres,59206,59,295,815,364,1216,574,2154,1110
21579,Escautpont,59207,59,486,1188,454,1223,797,2474,1674
21580,Escobecques,59208,59,64,57,9,84,37,130,121
21581,Esnes,59209,59,80,184,65,265,93,423,264
21582,Esquelbecq,59210,59,181,519,195,696,377,1268,700
21583,Esquerchin,59211,59,105,225,65,275,180,520,330
21584,Estaires,59212,59,553,1788,644,1879,1208,3731,2341
21585,Estourmel,59213,59,38,101,37,128,99,264,139
21586,Estrées,59214,59,135,295,65,385,215,665,430
21587,Estreux,59215,59,60,235,45,425,180,650,295
21588,Eswars,59216,59,36,96,48,144,52,244,132
21589,Eth,59217,59,60,80,12,112,56,180,140
21590,Étroeungt,59218,59,177,374,85,437,244,766,551
21591,Estrun,59219,59,30,195,70,199,195,464,225
21592,Faches-Thumesnil,59220,59,2305,4743,1932,4862,3383,10177,7048
21593,Famars,59221,59,273,583,395,807,428,1630,856
21594,Faumont,59222,59,110,578,182,823,380,1385,688
21595,Le Favril,59223,59,60,148,52,148,88,288,208
21596,Féchain,59224,59,245,375,125,550,305,980,620
21597,Feignies,59225,59,721,1997,800,2151,1297,4248,2718
21598,Felleries,59226,59,85,355,120,475,220,815,440
21599,Fenain,59227,59,595,1439,559,1736,1003,3298,2034
21600,Férin,59228,59,200,405,100,415,325,840,605
21601,Féron,59229,59,80,115,60,200,85,345,195
21602,Ferrière-la-Grande,59230,59,500,1438,625,1681,933,3239,1938
21603,Ferrière-la-Petite,59231,59,88,255,156,332,213,701,343
21604,La Flamengrie,59232,59,18,105,17,134,79,230,123
21605,Flaumont-Waudrechies,59233,59,40,105,55,97,65,217,145
21606,Flers-en-Escrebieux,59234,59,543,1677,839,1553,1123,3515,2220
21607,Flesquières,59236,59,32,52,40,96,56,192,84
21608,Flêtre,59237,59,100,320,100,244,224,568,420
21609,Flines-lès-Mortagne,59238,59,148,424,184,524,324,1032,572
21610,Flines-lez-Raches,59239,59,531,1407,452,2007,1062,3521,1938
21611,Floursies,59240,59,20,25,15,50,15,80,45
21612,Floyon,59241,59,59,121,29,141,101,271,180
21613,Fontaine-au-Bois,59242,59,92,164,72,236,128,436,256
21614,Fontaine-au-Pire,59243,59,99,266,109,359,236,704,365
21615,Fontaine-Notre-Dame,59244,59,95,460,145,620,385,1150,555
21616,Forest-en-Cambrésis,59246,59,53,117,58,139,99,296,170
21617,Forest-sur-Marque,59247,59,95,289,173,477,254,904,384
21618,Fourmies,59249,59,1497,3343,1340,3868,2004,7212,4840
21619,Fournes-en-Weppes,59250,59,308,565,209,662,390,1261,873
21620,Frasnoy,59251,59,32,96,36,136,60,232,128
21621,Frelinghien,59252,59,250,620,230,790,495,1515,870
21622,Fresnes-sur-Escaut,59253,59,740,2079,1019,2221,1414,4654,2819
21623,Fressain,59254,59,92,213,80,316,180,576,305
21624,Fressies,59255,59,85,180,30,145,135,310,265
21625,Fretin,59256,59,351,878,350,1011,674,2035,1229
21626,Fromelles,59257,59,130,165,135,380,95,610,295
21627,Genech,59258,59,147,665,245,851,421,1517,812
21628,Ghissignies,59259,59,24,180,16,168,132,316,204
21629,Ghyvelde,59260,59,266,1077,403,1447,848,2698,1343
21630,Glageon,59261,59,155,560,190,614,285,1089,715
21631,Godewaersvelde,59262,59,161,516,159,708,367,1234,677
21632,Goeulzin,59263,59,135,270,60,388,160,608,405
21633,Gognies-Chaussée,59264,59,68,164,108,300,132,540,232
21634,Gommegnies,59265,59,243,581,222,695,500,1417,824
21635,Gondecourt,59266,59,418,997,416,1313,718,2447,1415
21636,Gonnelieu,59267,59,25,82,15,138,56,209,107
21637,La Gorgue,59268,59,521,1645,627,1632,1228,3487,2166
21638,Gouzeaucourt,59269,59,112,484,204,468,284,956,596
21639,Grand-Fayt,59270,59,30,150,40,165,120,325,180
21640,Grande-Synthe,59271,59,1684,6702,2726,6169,4042,12937,8386
21641,Grand-Fort-Philippe,59272,59,679,1234,574,1712,953,3239,1913
21642,Gravelines,59273,59,976,3007,1406,3540,2230,7176,3983
21643,La Groise,59274,59,32,140,88,156,76,320,172
21644,Gruson,59275,59,155,330,45,370,245,660,485
21645,Guesnain,59276,59,576,1235,475,1541,802,2818,1811
21646,Gussignies,59277,59,35,85,25,125,70,220,120
21647,Hallennes-lez-Haubourdin,59278,59,386,1005,451,1292,821,2564,1391
21648,Halluin,59279,59,1634,5844,2502,6094,4217,12813,7478
21649,Hamel,59280,59,59,163,48,295,147,490,222
21650,Hantay,59281,59,81,421,61,291,313,665,502
21651,Hardifort,59282,59,25,81,38,131,58,227,106
21652,Hargnies,59283,59,56,152,56,216,116,388,208
21653,Hasnon,59284,59,273,967,406,1106,890,2402,1240
21654,Haspres,59285,59,290,740,225,855,660,1740,1030
21655,Haubourdin,59286,59,1337,3769,1868,4190,2843,8901,5106
21656,Haucourt-en-Cambrésis,59287,59,31,46,9,66,27,102,77
21657,Haulchin,59288,59,367,590,279,613,429,1321,957
21658,Haussy,59289,59,200,368,180,464,312,956,568
21659,Haut-Lieu,59290,59,48,108,20,108,96,224,156
21660,Hautmont,59291,59,1445,4299,1870,3932,2572,8374,5744
21661,Haveluy,59292,59,282,846,482,844,534,1860,1128
21662,Haverskerque,59293,59,145,355,145,475,285,905,500
21663,Haynecourt,59294,59,35,90,35,95,60,190,125
21664,Hazebrouck,59295,59,2814,5352,2661,6551,3726,12938,8166
21665,Hecq,59296,59,9,108,34,72,93,199,117
21666,Hélesmes,59297,59,151,551,225,534,410,1169,702
21667,Hem,59299,59,1915,5619,2125,5516,3713,11354,7534
21668,Hem-Lenglet,59300,59,50,145,15,225,130,370,195
21669,Hergnies,59301,59,277,1201,474,1296,985,2755,1478
21670,Hérin,59302,59,357,1084,420,1263,813,2496,1441
21671,Herlies,59303,59,138,635,252,812,406,1470,773
21672,Herrin,59304,59,29,92,49,104,80,233,121
21673,Herzeele,59305,59,136,443,156,453,334,943,579
21674,Hestrud,59306,59,40,55,49,125,49,223,95
21675,Holque,59307,59,85,225,85,310,175,570,310
21676,Hondeghem,59308,59,50,260,74,331,169,574,310
21677,Hondschoote,59309,59,390,1167,265,1295,787,2347,1557
21678,Hon-Hergies,59310,59,75,200,135,250,175,560,275
21679,Honnechy,59311,59,45,183,66,108,96,270,228
21680,Honnecourt-sur-Escaut,59312,59,55,200,110,220,145,475,255
21681,Hordain,59313,59,145,356,115,475,323,913,501
21682,Hornaing,59314,59,360,1095,335,1075,675,2085,1455
21683,Houdain-lez-Bavay,59315,59,60,220,65,330,225,620,280
21684,Houplin-Ancoisne,59316,59,320,865,386,1212,624,2222,1185
21685,Houplines,59317,59,645,2250,895,2275,1666,4836,2895
21686,Houtkerque,59318,59,116,328,84,220,272,576,444
21687,Hoymille,59319,59,373,758,177,1272,597,2046,1131
21688,Illies,59320,59,90,414,160,344,290,794,504
21689,Inchy,59321,59,104,151,79,214,101,394,255
21690,Iwuy,59322,59,325,900,415,1020,675,2110,1225
21691,Jenlain,59323,59,92,269,75,365,227,667,361
21692,Jeumont,59324,59,969,2847,1089,2954,1767,5810,3816
21693,Jolimetz,59325,59,110,190,95,295,160,550,300
21694,Killem,59326,59,72,292,124,308,223,655,364
21695,Lallaing,59327,59,823,1721,690,1803,1081,3574,2544
21696,Lambersart,59328,59,3521,7168,3369,8307,5525,17201,10689
21697,Lambres-lez-Douai,59329,59,756,1240,471,1540,868,2879,1996
21698,Landas,59330,59,238,620,200,846,456,1502,858
21699,Landrecies,59331,59,505,805,420,1165,515,2100,1310
21700,Lannoy,59332,59,164,390,376,455,318,1149,554
21701,Larouillies,59333,59,20,64,4,124,44,172,84
21702,Lauwin-Planque,59334,59,126,434,164,651,247,1062,560
21703,Lecelles,59335,59,305,676,280,1008,482,1770,981
21704,Lécluse,59336,59,149,346,129,360,266,755,495
21705,Lederzeele,59337,59,58,159,66,194,102,362,217
21706,Ledringhem,59338,59,35,211,40,185,195,420,246
21707,Leers,59339,59,982,2341,922,3367,1787,6076,3323
21708,Leffrinckoucke,59340,59,548,917,358,1704,695,2757,1465
21709,Lesdain,59341,59,35,75,40,170,85,295,110
21710,Lez-Fontaine,59342,59,40,60,16,72,60,148,100
21711,Lesquin,59343,59,662,1949,881,2104,1558,4543,2611
21712,Leval,59344,59,189,682,288,753,526,1567,871
21713,Lewarde,59345,59,285,620,219,830,515,1564,905
21714,Lezennes,59346,59,304,777,398,1018,606,2022,1081
21715,Liessies,59347,59,48,128,60,196,96,352,176
21716,Lieu-Saint-Amand,59348,59,109,369,73,453,239,765,478
21717,Ligny-en-Cambrésis,59349,59,261,569,176,417,446,1039,830
21718,Lille,59350,59,15679,53548,62378,46888,47187,156453,69227
21719,Limont-Fontaine,59351,59,65,125,55,255,85,395,190
21720,Linselles,59352,59,830,2094,908,2672,1531,5111,2924
21721,Locquignol,59353,59,54,63,41,114,52,207,117
21722,Loffre,59354,59,65,185,55,325,135,515,250
21723,Lompret,59356,59,267,565,170,878,322,1370,832
21724,La Longueville,59357,59,170,535,237,671,457,1365,705
21725,Looberghe,59358,59,88,325,92,340,342,774,413
21726,Loon-Plage,59359,59,659,1685,746,1854,1206,3806,2344
21727,Loos,59360,59,1807,5613,3410,5454,4033,12897,7420
21728,Lourches,59361,59,248,1290,400,955,712,2067,1538
21729,Louvignies-Quesnoy,59363,59,150,215,100,310,150,560,365
21730,Louvil,59364,59,115,180,85,280,140,505,295
21731,Louvroil,59365,59,653,2106,851,1679,1229,3759,2759
21732,Lynde,59366,59,60,180,65,265,165,495,240
21733,Lys-lez-Lannoy,59367,59,1093,3640,1630,4138,2828,8596,4733
21734,La Madeleine,59368,59,2203,4935,3871,5770,5177,14818,7138
21735,Maing,59369,59,472,1047,389,1131,836,2356,1519
21736,Mairieux,59370,59,75,145,65,309,150,524,220
21737,Le Maisnil,59371,59,28,184,76,208,148,432,212
21738,Malincourt,59372,59,56,112,36,188,108,332,168
21739,Marbaix,59374,59,50,125,70,160,100,330,175
21740,Marchiennes,59375,59,483,1240,493,1406,950,2849,1723
21741,Marcoing,59377,59,204,455,191,507,376,1074,659
21742,Marcq-en-Baroeul,59378,59,4860,9925,4316,11899,7768,23983,14785
21743,Marcq-en-Ostrevent,59379,59,116,180,108,152,148,408,296
21744,Maresches,59381,59,45,210,75,345,170,590,255
21745,Maretz,59382,59,135,400,150,485,275,910,535
21746,Marly,59383,59,1460,2837,1385,3380,2161,6926,4297
21747,Maroilles,59384,59,185,335,105,485,265,855,520
21748,Marpent,59385,59,255,780,280,855,525,1660,1035
21749,Marquette-lez-Lille,59386,59,687,2756,1082,3169,2208,6459,3443
21750,Marquette-en-Ostrevant,59387,59,213,475,195,455,405,1055,688
21751,Marquillies,59388,59,183,536,154,488,433,1075,719
21752,Masnières,59389,59,212,748,232,768,644,1644,960
21753,Masny,59390,59,511,1082,450,1232,747,2429,1593
21754,Mastaing,59391,59,116,176,112,316,124,552,292
21755,Maubeuge,59392,59,3293,7960,3797,9017,5061,17875,11253
21756,Maulde,59393,59,60,233,111,315,192,618,293
21757,Maurois,59394,59,50,95,75,85,65,225,145
21758,Mazinghien,59395,59,30,85,25,120,35,180,115
21759,Mecquignies,59396,59,60,184,54,200,116,370,244
21760,Merckeghem,59397,59,70,200,25,145,185,355,270
21761,Mérignies,59398,59,190,745,253,1093,539,1885,935
21762,Merris,59399,59,56,235,77,322,191,590,291
21763,Merville,59400,59,892,2878,1206,2687,1981,5874,3770
21764,Méteren,59401,59,207,561,246,733,374,1353,768
21765,Millam,59402,59,60,236,56,264,164,484,296
21766,Millonfosse,59403,59,47,151,63,275,90,428,198
21767,Moeuvres,59405,59,16,152,25,122,91,238,168
21768,Monceau-Saint-Waast,59406,59,75,120,50,120,90,260,195
21769,Monchaux-sur-Écaillon,59407,59,50,115,45,240,80,365,165
21770,Moncheaux,59408,59,180,360,140,460,304,904,540
21771,Monchecourt,59409,59,189,664,293,865,527,1685,853
21772,Mons-en-Baroeul,59410,59,1972,5973,2998,5424,4169,12591,7945
21773,Mons-en-Pévèle,59411,59,310,505,170,770,330,1270,815
21774,Montay,59412,59,16,112,28,120,68,216,128
21775,Montigny-en-Cambrésis,59413,59,80,135,75,200,90,365,215
21776,Montigny-en-Ostrevent,59414,59,631,1066,547,1445,789,2781,1697
21777,Montrécourt,59415,59,24,72,16,88,36,140,96
21778,Morbecque,59416,59,283,594,230,844,426,1500,877
21779,Mortagne-du-Nord,59418,59,105,505,160,495,325,980,610
21780,Mouchin,59419,59,132,336,132,524,276,932,468
21781,Moustier-en-Fagne,59420,59,0,20,0,12,16,28,20
21782,Mouvaux,59421,59,1707,3218,1249,4303,2479,8031,4925
21783,Naves,59422,59,74,163,44,194,102,340,237
21784,Neuf-Berquin,59423,59,70,320,145,465,230,840,390
21785,Neuf-Mesnil,59424,59,88,416,136,424,248,808,504
21786,Neuville-en-Avesnois,59425,59,20,80,20,95,85,200,100
21787,Neuville-en-Ferrain,59426,59,1219,2669,878,3290,1977,6145,3888
21788,La Neuville,59427,59,96,140,68,232,144,444,236
21789,Neuville-Saint-Rémy,59428,59,452,936,403,1178,702,2283,1388
21790,Neuville-sur-Escaut,59429,59,290,720,260,890,528,1678,1010
21791,Neuvilly,59430,59,130,305,130,350,215,695,435
21792,Nieppe,59431,59,708,1821,829,2410,1434,4673,2529
21793,Niergnies,59432,59,28,96,25,226,80,331,124
21794,Nieurlet,59433,59,72,248,109,264,201,574,320
21795,Nivelle,59434,59,79,290,175,485,250,910,369
21796,Nomain,59435,59,329,499,253,974,370,1597,828
21797,Noordpeene,59436,59,72,220,72,228,192,492,292
21798,Noyelles-lès-Seclin,59437,59,85,215,49,294,176,519,300
21799,Noyelles-sur-Escaut,59438,59,25,185,71,243,158,472,210
21800,Noyelles-sur-Sambre,59439,59,30,70,20,95,81,196,100
21801,Noyelles-sur-Selle,59440,59,85,145,95,285,100,480,230
21802,Obies,59441,59,56,164,100,248,152,500,220
21803,Obrechies,59442,59,30,38,26,90,33,149,68
21804,Ochtezeele,59443,59,16,116,36,116,80,232,132
21805,Odomez,59444,59,80,261,57,276,177,510,341
21806,Ohain,59445,59,140,315,180,413,180,773,455
21807,Oisy,59446,59,50,170,20,195,160,375,220
21808,Onnaing,59447,59,890,2275,1078,2523,1781,5382,3165
21809,Oost-Cappel,59448,59,85,125,50,110,100,260,210
21810,Orchies,59449,59,701,2066,1244,2549,1545,5338,2767
21811,Ors,59450,59,76,168,60,216,120,396,244
21812,Orsinval,59451,59,45,130,55,220,110,385,175
21813,Ostricourt,59452,59,615,1571,615,1565,1020,3200,2186
21814,Oudezeele,59453,59,98,194,43,171,139,353,292
21815,Oxelaëre,59454,59,45,145,65,160,115,340,190
21816,Paillencourt,59455,59,124,263,47,235,259,541,387
21817,Pecquencourt,59456,59,792,1561,848,1548,1082,3478,2353
21818,Pérenchies,59457,59,790,2297,903,2226,1781,4910,3087
21819,Péronne-en-Mélantois,59458,59,35,264,108,365,125,598,299
21820,Petite-Forêt,59459,59,429,1286,503,1734,857,3094,1715
21821,Petit-Fayt,59461,59,24,64,24,74,62,160,88
21822,Phalempin,59462,59,446,1033,490,1516,873,2879,1479
21823,Pitgam,59463,59,84,216,92,396,176,664,300
21824,Poix-du-Nord,59464,59,236,603,246,675,406,1327,839
21825,Pommereuil,59465,59,96,176,128,252,144,524,272
21826,Pont-à-Marcq,59466,59,218,808,281,730,662,1673,1026
21827,Pont-sur-Sambre,59467,59,255,611,410,736,454,1600,866
21828,Potelle,59468,59,49,62,20,140,35,195,111
21829,Pradelles,59469,59,24,140,28,112,96,236,164
21830,Prémesques,59470,59,175,625,131,804,415,1350,800
21831,Préseau,59471,59,150,447,198,689,359,1246,597
21832,Preux-au-Bois,59472,59,46,192,60,257,197,514,238
21833,Preux-au-Sart,59473,59,28,72,36,80,64,180,100
21834,Prisches,59474,59,120,305,85,325,195,605,425
21835,Prouvy,59475,59,197,605,214,756,388,1358,802
21836,Proville,59476,59,351,648,245,1319,538,2102,999
21837,Provin,59477,59,318,1211,423,1168,915,2506,1529
21838,Quaëdypre,59478,59,80,295,90,415,230,735,375
21839,Quarouble,59479,59,405,705,325,1030,550,1905,1110
21840,Quérénaing,59480,59,116,220,88,324,200,612,336
21841,Le Quesnoy,59481,59,615,1215,554,1426,834,2814,1830
21842,Quesnoy-sur-Deûle,59482,59,632,1809,686,2106,1288,4080,2441
21843,Quiévelon,59483,59,10,25,20,60,30,110,35
21844,Quiévrechain,59484,59,657,1776,831,1635,1232,3698,2433
21845,Quiévy,59485,59,315,450,190,485,335,1010,765
21846,Râches,59486,59,240,762,293,786,533,1612,1002
21847,Radinghem-en-Weppes,59487,59,122,330,114,505,212,831,452
21848,Raillencourt-Sainte-Olle,59488,59,238,512,250,861,408,1519,750
21849,Raimbeaucourt,59489,59,525,820,380,1430,665,2475,1345
21850,Rainsars,59490,59,40,36,5,81,20,106,76
21851,Raismes,59491,59,1464,3509,1628,3638,2278,7544,4973
21852,Ramillies,59492,59,50,173,34,150,132,316,223
21853,Ramousies,59493,59,39,35,19,44,39,102,74
21854,Raucourt-au-Bois,59494,59,15,40,10,65,45,120,55
21855,Recquignies,59495,59,167,674,253,737,496,1486,841
21856,Rejet-de-Beaulieu,59496,59,30,80,10,90,60,160,110
21857,Renescure,59497,59,290,470,225,725,375,1325,760
21858,Reumont,59498,59,50,115,40,130,65,235,165
21859,Rexpoëde,59499,59,206,653,224,534,417,1175,859
21860,Ribécourt-la-Tour,59500,59,40,76,32,140,76,248,116
21861,Rieulay,59501,59,146,355,95,471,240,806,501
21862,Rieux-en-Cambrésis,59502,59,152,322,134,446,253,833,474
21863,Robersart,59503,59,14,45,0,50,60,110,59
21864,Roeulx,59504,59,362,1143,338,1113,728,2179,1505
21865,Rombies-et-Marchipont,59505,59,35,250,45,230,210,485,285
21866,Romeries,59506,59,75,130,55,105,75,235,205
21867,Ronchin,59507,59,1675,5021,2443,5246,3832,11521,6696
21868,Roncq,59508,59,1286,3638,1410,4461,2549,8420,4924
21869,Roost-Warendin,59509,59,740,1580,660,2060,1040,3760,2320
21870,Rosult,59511,59,141,493,201,682,372,1255,634
21871,Roubaix,59512,59,6468,32467,14221,21701,18800,54722,38935
21872,Roucourt,59513,59,16,116,40,184,88,312,132
21873,Rousies,59514,59,471,899,556,1343,709,2608,1370
21874,Rouvignies,59515,59,60,190,65,215,120,400,250
21875,Rubrouck,59516,59,50,270,105,280,245,630,320
21876,Les Rues-des-Vignes,59517,59,54,193,62,271,126,459,247
21877,Ruesnes,59518,59,39,62,62,148,50,260,101
21878,Rumegies,59519,59,120,426,171,622,305,1098,546
21879,Rumilly-en-Cambrésis,59520,59,155,405,105,513,280,898,560
21880,Sailly-lez-Cambrai,59521,59,51,93,34,123,93,250,144
21881,Sailly-lez-Lannoy,59522,59,166,406,125,654,230,1009,572
21882,Sainghin-en-Mélantois,59523,59,268,589,238,942,470,1650,857
21883,Sainghin-en-Weppes,59524,59,594,1497,591,1724,1140,3455,2091
21884,Sains-du-Nord,59525,59,285,710,310,1024,535,1869,995
21885,Saint-Amand-les-Eaux,59526,59,1859,4146,1996,5041,3111,10148,6005
21886,Saint-André-lez-Lille,59527,59,1562,2876,1742,3022,2526,7290,4438
21887,Saint-Aubert,59528,59,145,420,155,435,380,970,565
21888,Saint-Aubin,59529,59,23,87,42,102,60,204,110
21889,Saint-Aybert,59530,59,9,91,49,105,66,220,100
21890,Saint-Benin,59531,59,22,83,32,99,53,184,105
21891,Saint-Georges-sur-l'Aa,59532,59,15,80,30,105,60,195,95
21892,Saint-Hilaire-lez-Cambrai,59533,59,188,414,136,474,301,911,602
21893,Saint-Hilaire-sur-Helpe,59534,59,44,172,104,284,152,540,216
21894,Saint-Jans-Cappel,59535,59,190,394,117,573,307,997,584
21895,Sainte-Marie-Cappel,59536,59,57,275,60,236,168,464,332
21896,Saint-Martin-sur-Écaillon,59537,59,52,116,64,168,124,356,168
21897,Saint-Momelin,59538,59,35,125,60,179,75,314,160
21898,Saint-Pierre-Brouck,59539,59,45,320,105,325,190,620,365
21899,Saint-Python,59541,59,134,249,51,326,150,527,383
21900,Saint-Remy-Chaussée,59542,59,45,160,55,110,135,300,205
21901,Saint-Remy-du-Nord,59543,59,105,252,135,421,227,783,357
21902,Saint-Saulve,59544,59,1241,2715,1363,3570,1989,6922,3956
21903,Saint-Souplet,59545,59,130,355,145,395,215,755,485
21904,Saint-Sylvestre-Cappel,59546,59,124,290,75,351,218,644,414
21905,Saint-Vaast-en-Cambrésis,59547,59,115,275,93,252,180,525,390
21906,Saint-Waast,59548,59,31,171,58,134,149,341,202
21907,Salesches,59549,59,34,70,23,75,89,187,104
21908,Salomé,59550,59,320,747,316,917,633,1866,1067
21909,Saméon,59551,59,136,432,140,494,315,949,568
21910,Sancourt,59552,59,20,40,20,85,25,130,60
21911,Santes,59553,59,527,1614,569,1888,1204,3661,2141
21912,Sars-et-Rosières,59554,59,33,155,36,140,161,337,188
21913,Sars-Poteries,59555,59,112,427,209,399,234,842,539
21914,Sassegnies,59556,59,35,35,35,125,25,185,70
21915,Saultain,59557,59,233,496,266,758,403,1427,729
21916,Saulzoir,59558,59,185,398,210,618,352,1180,583
21917,Sebourg,59559,59,160,520,164,636,400,1200,680
21918,Seclin,59560,59,980,3398,1454,3577,2654,7685,4378
21919,Sémeries,59562,59,60,130,45,200,120,365,190
21920,Semousies,59563,59,24,76,36,76,56,168,100
21921,La Sentinelle,59564,59,340,790,380,1041,615,2036,1130
21922,Sepmeries,59565,59,72,192,56,196,148,400,264
21923,Sequedin,59566,59,399,931,347,1307,701,2355,1330
21924,Séranvillers-Forenville,59567,59,25,109,26,99,91,216,134
21925,Sercus,59568,59,20,162,21,108,117,246,182
21926,Sin-le-Noble,59569,59,1746,4176,1963,4723,2838,9524,5922
21927,Socx,59570,59,93,231,50,356,154,560,324
21928,Solesmes,59571,59,470,1154,422,1474,785,2681,1624
21929,Solre-le-Château,59572,59,234,481,190,574,368,1132,715
21930,Solrinnes,59573,59,8,34,25,42,28,95,42
21931,Somain,59574,59,1340,3662,1577,3705,2392,7674,5002
21932,Sommaing,59575,59,60,105,44,101,76,221,165
21933,Spycker,59576,59,196,469,132,521,335,988,665
21934,Staple,59577,59,55,168,76,264,106,446,223
21935,Steenbecque,59578,59,190,425,177,453,345,975,615
21936,Steene,59579,59,93,404,107,378,259,744,497
21937,Steenvoorde,59580,59,451,945,347,1332,829,2508,1396
21938,Steenwerck,59581,59,326,905,333,1043,739,2115,1231
21939,Strazeele,59582,59,64,292,108,236,256,600,356
21940,Taisnières-en-Thiérache,59583,59,32,72,43,178,70,291,104
21941,Taisnières-sur-Hon,59584,59,89,270,60,284,287,631,359
21942,Templemars,59585,59,432,679,353,1071,520,1944,1111
21943,Templeuve-en-Pévèle,59586,59,715,1412,538,1991,1050,3579,2127
21944,Terdeghem,59587,59,44,176,56,180,136,372,220
21945,Téteghem-Coudekerque-Village,59588,59,852,1896,666,3472,1155,5293,2748
21946,Thiant,59589,59,245,671,381,797,535,1713,916
21947,Thiennes,59590,59,92,240,96,256,184,536,332
21948,Thivencelle,59591,59,50,260,86,193,192,471,310
21949,Thumeries,59592,59,431,1028,340,1236,810,2386,1459
21950,Thun-l'Évêque,59593,59,72,206,84,206,165,455,278
21951,Thun-Saint-Amand,59594,59,85,350,115,345,250,710,435
21952,Thun-Saint-Martin,59595,59,42,104,34,180,102,316,146
21953,Tilloy-lez-Marchiennes,59596,59,35,132,55,254,35,344,167
21954,Tilloy-lez-Cambrai,59597,59,78,112,30,195,73,298,190
21955,Toufflers,59598,59,465,1051,390,1250,725,2365,1516
21956,Tourcoing,59599,59,7578,29345,13295,23767,19854,56916,36923
21957,Tourmignies,59600,59,45,210,75,375,130,580,255
21958,Trélon,59601,59,305,719,301,831,462,1594,1024
21959,Tressin,59602,59,150,430,90,415,310,815,580
21960,Trith-Saint-Léger,59603,59,616,1541,825,2012,1118,3955,2157
21961,Troisvilles,59604,59,80,245,80,215,200,495,325
21962,Uxem,59605,59,117,366,99,472,290,861,483
21963,Valenciennes,59606,59,4146,10359,8166,10979,8616,27761,14505
21964,Vendegies-au-Bois,59607,59,20,115,30,179,135,344,135
21965,Vendegies-sur-Écaillon,59608,59,70,250,100,435,220,755,320
21966,Vendeville,59609,59,82,430,194,563,323,1080,512
21967,Verchain-Maugré,59610,59,136,208,60,276,220,556,344
21968,Verlinghem,59611,59,229,640,196,813,427,1436,869
21969,Vertain,59612,59,64,144,60,140,120,320,208
21970,Vicq,59613,59,135,424,145,493,300,938,559
21971,Viesly,59614,59,240,389,175,430,254,859,629
21972,Vieux-Berquin,59615,59,264,692,257,722,456,1435,956
21973,Vieux-Condé,59616,59,1180,2497,996,3263,1804,6063,3677
21974,Vieux-Mesnil,59617,59,50,150,95,220,120,435,200
21975,Vieux-Reng,59618,59,55,230,105,285,185,575,285
21976,Villereau,59619,59,30,200,105,355,195,655,230
21977,Villers-au-Tertre,59620,59,60,150,59,160,123,342,210
21978,Villers-en-Cauchies,59622,59,149,355,165,385,225,775,504
21979,Villers-Guislain,59623,59,116,172,64,228,124,416,288
21980,Villers-Outréaux,59624,59,288,536,167,661,386,1214,824
21981,Villers-Plouich,59625,59,45,116,29,98,95,222,161
21982,Villers-Pol,59626,59,152,279,140,360,225,725,431
21983,Villers-Sire-Nicole,59627,59,128,219,137,246,192,575,347
21984,Volckerinckhove,59628,59,44,164,44,192,128,364,208
21985,Vred,59629,59,178,325,115,423,257,795,503
21986,Wahagnies,59630,59,335,660,260,810,510,1580,995
21987,Walincourt-Selvigny,59631,59,280,519,195,620,372,1187,799
21988,Wallers,59632,59,734,1420,630,1690,990,3310,2154
21989,Wallers-en-Fagne,59633,59,20,60,15,95,80,190,80
21990,Wallon-Cappel,59634,59,57,233,69,293,157,519,290
21991,Wambaix,59635,59,40,95,25,105,85,215,135
21992,Wambrechies,59636,59,881,2467,1132,3149,2062,6343,3348
21993,Wandignies-Hamage,59637,59,136,324,96,424,284,804,460
21994,Wannehain,59638,59,75,417,61,269,298,628,492
21995,Wargnies-le-Grand,59639,59,80,268,68,340,292,700,348
21996,Wargnies-le-Petit,59640,59,49,210,60,269,175,504,259
21997,Warhem,59641,59,130,560,135,820,410,1365,690
21998,Warlaing,59642,59,44,164,44,140,148,332,208
21999,Warneton,59643,59,26,61,24,60,29,113,87
22000,Wasnes-au-Bac,59645,59,48,164,52,180,140,372,212
22001,Wasquehal,59646,59,2078,5727,2377,6196,4410,12983,7805
22002,Watten,59647,59,221,627,273,817,440,1530,848
22003,Wattignies,59648,59,1611,3823,1896,4001,2586,8483,5434
22004,Wattignies-la-Victoire,59649,59,15,65,25,80,45,150,80
22005,Wattrelos,59650,59,3945,11740,4991,12028,8224,25243,15685
22006,Wavrechain-sous-Denain,59651,59,146,398,170,512,297,979,544
22007,Wavrechain-sous-Faulx,59652,59,31,102,9,96,99,204,133
22008,Wavrin,59653,59,580,2050,774,2648,1554,4976,2630
22009,Waziers,59654,59,833,2284,971,2117,1332,4420,3117
22010,Wemaers-Cappel,59655,59,25,99,4,52,57,113,124
22011,Wervicq-Sud,59656,59,486,1524,503,1543,1112,3158,2010
22012,West-Cappel,59657,59,39,182,43,133,126,302,221
22013,Wicres,59658,59,68,148,20,100,108,228,216
22014,Wignehies,59659,59,295,760,324,939,510,1773,1055
22015,Willems,59660,59,265,950,235,970,585,1790,1215
22016,Willies,59661,59,13,25,15,60,35,110,38
22017,Winnezeele,59662,59,160,344,108,344,252,704,504
22018,Wormhout,59663,59,678,1288,547,1795,1028,3370,1966
22019,Wulverdinghe,59664,59,20,105,10,70,90,170,125
22020,Wylder,59665,59,5,110,30,75,75,180,115
22021,Zegerscappel,59666,59,93,466,141,460,312,913,559
22022,Zermezeele,59667,59,9,64,9,40,59,108,73
22023,Zuydcoote,59668,59,136,404,120,596,288,1004,540
22024,Zuytpeene,59669,59,39,145,48,133,106,287,184
22025,Don,59670,59,140,350,120,370,315,805,490
22026,Abancourt,60001,60,52,161,106,153,120,379,213
22027,Abbecourt,60002,60,49,166,100,375,85,560,215
22028,Abbeville-Saint-Lucien,60003,60,20,120,15,200,120,335,140
22029,Achy,60004,60,33,100,19,109,92,220,133
22030,Acy-en-Multien,60005,60,52,228,68,256,200,524,280
22031,Les Ageux,60006,60,114,259,96,421,201,718,373
22032,Agnetz,60007,60,180,810,265,1069,650,1984,990
22033,Airion,60008,60,36,116,16,160,80,256,152
22034,Allonne,60009,60,90,363,163,502,365,1030,453
22035,Amblainville,60010,60,159,460,96,500,380,976,619
22036,Amy,60011,60,16,101,43,112,80,235,117
22037,Andeville,60012,60,251,791,378,1085,515,1978,1042
22038,Angicourt,60013,60,120,316,75,643,231,949,436
22039,Angivillers,60014,60,12,55,16,42,20,78,67
22040,Angy,60015,60,120,296,96,432,232,760,416
22041,Ansacq,60016,60,8,79,16,95,59,170,87
22042,Ansauvillers,60017,60,90,315,185,340,235,760,405
22043,Antheuil-Portes,60019,60,60,115,30,130,75,235,175
22044,Antilly,60020,60,16,41,31,84,25,140,57
22045,Appilly,60021,60,50,160,55,120,140,315,210
22046,Apremont,60022,60,150,145,45,225,100,370,295
22047,Armancourt,60023,60,42,122,63,186,100,349,164
22048,Arsy,60024,60,49,167,54,317,118,489,216
22049,Attichy,60025,60,215,384,144,508,317,969,599
22050,Auchy-la-Montagne,60026,60,57,168,59,152,114,325,225
22051,Auger-Saint-Vincent,60027,60,43,107,38,129,108,275,150
22052,Aumont-en-Halatte,60028,60,40,87,35,268,70,373,127
22053,Auneuil,60029,60,268,745,292,921,536,1749,1013
22054,Auteuil,60030,60,44,160,48,224,104,376,204
22055,Autheuil-en-Valois,60031,60,15,99,30,70,93,193,114
22056,Autrêches,60032,60,53,193,91,220,132,443,246
22057,Avilly-Saint-Léonard,60033,60,97,200,45,333,132,510,297
22058,Avrechy,60034,60,56,316,88,424,252,764,372
22059,Avricourt,60035,60,30,60,40,75,40,155,90
22060,Avrigny,60036,60,45,83,20,96,82,198,128
22061,Baboeuf,60037,60,40,165,20,130,165,315,205
22062,Bachivillers,60038,60,24,132,24,164,105,293,156
22063,Bacouël,60039,60,42,122,66,90,95,251,164
22064,Bailleul-le-Soc,60040,60,38,161,77,160,139,376,199
22065,Bailleul-sur-Thérain,60041,60,140,535,250,730,335,1315,675
22066,Bailleval,60042,60,119,337,107,539,259,905,456
22067,Bailly,60043,60,70,160,60,235,105,400,230
22068,Balagny-sur-Thérain,60044,60,85,462,165,416,397,978,547
22069,Barbery,60045,60,20,144,47,169,118,334,164
22070,Bargny,60046,60,12,118,16,68,89,173,130
22071,Baron,60047,60,29,210,49,252,180,481,239
22072,Baugy,60048,60,26,57,15,102,56,173,83
22073,Bazancourt,60049,60,8,8,22,67,12,101,16
22074,Bazicourt,60050,60,33,63,24,132,22,178,96
22075,Beaudéduit,60051,60,35,50,50,40,40,130,85
22076,Beaugies-sous-Bois,60052,60,12,48,8,16,28,52,60
22077,Beaulieu-les-Fontaines,60053,60,24,176,56,132,136,324,200
22078,Beaumont-les-Nonains,60054,60,16,94,19,138,54,211,110
22079,Beaurains-lès-Noyon,60055,60,45,80,16,99,78,193,125
22080,Beaurepaire,60056,60,0,0,15,30,0,45,0
22081,Beauvais,60057,60,5740,13582,7523,15249,9833,32605,19322
22082,Beauvoir,60058,60,25,68,24,54,51,129,93
22083,Béhéricourt,60059,60,45,40,10,75,40,125,85
22084,Belle-Église,60060,60,50,160,65,210,120,395,210
22085,Belloy,60061,60,4,25,0,42,13,55,29
22086,Berlancourt,60062,60,30,90,50,100,50,200,120
22087,Berneuil-en-Bray,60063,60,85,185,40,310,145,495,270
22088,Berneuil-sur-Aisne,60064,60,92,308,72,308,252,632,400
22089,Berthecourt,60065,60,145,410,185,570,320,1075,555
22090,Béthancourt-en-Valois,60066,60,6,37,19,89,46,154,43
22091,Béthisy-Saint-Martin,60067,60,92,268,88,412,248,748,360
22092,Béthisy-Saint-Pierre,60068,60,335,815,375,925,590,1890,1150
22093,Betz,60069,60,74,309,129,366,263,758,383
22094,Bienville,60070,60,40,95,40,175,70,285,135
22095,Biermont,60071,60,34,40,20,40,40,100,74
22096,Bitry,60072,60,12,71,16,117,51,184,83
22097,Blacourt,60073,60,36,173,72,164,165,401,209
22098,Blaincourt-lès-Précy,60074,60,59,285,95,502,245,842,344
22099,Blancfossé,60075,60,20,35,12,12,28,52,55
22100,Blargies,60076,60,82,129,42,132,90,264,211
22101,Blicourt,60077,60,25,80,40,150,50,240,105
22102,Blincourt,60078,60,10,15,5,45,20,70,25
22103,Boissy-Fresnoy,60079,60,48,324,109,282,258,649,372
22104,Boissy-le-Bois,60080,60,5,70,5,80,55,140,75
22105,Bonlier,60081,60,46,81,43,141,49,233,127
22106,Bonneuil-les-Eaux,60082,60,77,223,41,242,185,468,300
22107,Bonneuil-en-Valois,60083,60,103,250,100,343,225,668,353
22108,Bonnières,60084,60,24,40,10,85,5,100,64
22109,Bonvillers,60085,60,30,41,10,76,55,141,71
22110,Boran-sur-Oise,60086,60,194,523,177,665,425,1267,717
22111,Borest,60087,60,36,88,24,128,56,208,124
22112,Bornel,60088,60,300,1237,599,1650,907,3156,1537
22113,Boubiers,60089,60,15,125,30,186,81,297,140
22114,Bouconvillers,60090,60,40,124,32,100,84,216,164
22115,Bouillancy,60091,60,38,98,17,99,106,222,136
22116,Boullarre,60092,60,4,76,12,60,64,136,80
22117,Boulogne-la-Grasse,60093,60,56,164,44,108,100,252,220
22118,Boursonne,60094,60,29,76,12,85,66,163,105
22119,Boury-en-Vexin,60095,60,29,63,12,108,72,192,92
22120,Boutavent,60096,60,21,26,16,8,22,46,47
22121,Boutencourt,60097,60,20,92,20,110,40,170,112
22122,Bouvresse,60098,60,20,35,20,61,26,107,55
22123,Braisnes-sur-Aronde,60099,60,22,41,8,55,21,84,63
22124,Brasseuse,60100,60,8,24,8,16,20,44,32
22125,Brégy,60101,60,20,164,80,172,140,392,184
22126,Brenouille,60102,60,100,515,310,735,430,1475,615
22127,Bresles,60103,60,420,1011,565,1247,808,2620,1431
22128,Breteuil,60104,60,587,1225,567,1231,706,2504,1812
22129,Brétigny,60105,60,12,143,56,109,69,234,155
22130,Breuil-le-Sec,60106,60,189,623,200,775,464,1439,812
22131,Breuil-le-Vert,60107,60,317,652,322,1092,452,1866,969
22132,Briot,60108,60,32,62,9,62,66,137,94
22133,Brombos,60109,60,40,80,28,76,36,140,120
22134,Broquiers,60110,60,13,52,19,51,65,135,65
22135,Broyes,60111,60,14,40,20,60,30,110,54
22136,Brunvillers-la-Motte,60112,60,16,88,36,104,100,240,104
22137,Bucamps,60113,60,12,59,8,32,57,97,71
22138,Buicourt,60114,60,30,30,15,40,30,85,60
22139,Bulles,60115,60,80,256,84,264,208,556,336
22140,Bury,60116,60,273,798,257,925,675,1857,1071
22141,Bussy,60117,60,12,98,13,72,81,166,110
22142,Caisnes,60118,60,60,176,52,128,120,300,236
22143,Cambronne-lès-Ribécourt,60119,60,165,581,135,650,411,1196,746
22144,Cambronne-lès-Clermont,60120,60,92,320,80,372,240,692,412
22145,Campagne,60121,60,8,36,28,64,16,108,44
22146,Campeaux,60122,60,60,92,57,164,81,302,152
22147,Campremy,60123,60,24,172,64,104,116,284,196
22148,Candor,60124,60,45,72,4,71,57,132,117
22149,Canly,60125,60,56,188,120,256,172,548,244
22150,Cannectancourt,60126,60,40,145,55,155,115,325,185
22151,Canny-sur-Matz,60127,60,8,108,37,102,78,217,116
22152,Canny-sur-Thérain,60128,60,8,59,12,76,42,130,67
22153,Carlepont,60129,60,106,389,146,511,267,924,495
22154,Catenoy,60130,60,99,232,88,342,219,649,331
22155,Catheux,60131,60,10,20,15,40,25,80,30
22156,Catigny,60132,60,25,34,15,51,26,92,59
22157,Catillon-Fumechon,60133,60,52,97,31,193,91,315,149
22158,Cauffry,60134,60,204,632,299,832,469,1600,836
22159,Cauvigny,60135,60,77,479,102,531,317,950,556
22160,Cempuis,60136,60,28,147,32,171,133,336,175
22161,Cernoy,60137,60,15,80,35,80,75,190,95
22162,Chamant,60138,60,83,200,94,308,153,555,283
22163,Chambly,60139,60,810,2875,1231,2642,2214,6087,3685
22164,Chambors,60140,60,15,65,15,140,70,225,80
22165,Chantilly,60141,60,1241,1971,1577,3231,2264,7072,3212
22166,La Chapelle-en-Serval,60142,60,180,880,235,935,715,1885,1060
22167,Chaumont-en-Vexin,60143,60,336,656,351,955,548,1854,992
22168,Chavençon,60144,60,4,40,17,60,29,106,44
22169,Chelles,60145,60,39,135,20,214,100,334,174
22170,Chepoix,60146,60,32,132,40,96,120,256,164
22171,Chevincourt,60147,60,56,187,76,321,144,541,243
22172,Chèvreville,60148,60,20,90,60,186,65,311,110
22173,Chevrières,60149,60,168,444,192,656,392,1240,612
22174,Chiry-Ourscamp,60150,60,102,299,105,336,243,684,401
22175,Choisy-au-Bac,60151,60,415,786,200,1283,548,2031,1201
22176,Choisy-la-Victoire,60152,60,5,60,45,59,65,169,65
22177,Choqueuse-les-Bénards,60153,60,10,15,25,25,20,70,25
22178,Cinqueux,60154,60,155,288,167,653,212,1032,443
22179,Cires-lès-Mello,60155,60,323,885,448,1165,689,2302,1208
22180,Clairoix,60156,60,240,500,212,704,404,1320,740
22181,Clermont,60157,60,856,2711,1514,2751,2246,6511,3567
22182,Coivrel,60158,60,44,56,24,76,60,160,100
22183,Compiègne,60159,60,4393,9808,6915,10872,7140,24927,14201
22184,Conchy-les-Pots,60160,60,35,230,88,190,155,433,265
22185,Conteville,60161,60,24,4,28,20,0,48,28
22186,Corbeil-Cerf,60162,60,12,112,16,140,60,216,124
22187,Cormeilles,60163,60,20,144,64,120,92,276,164
22188,Le Coudray-Saint-Germer,60164,60,80,324,80,220,240,540,404
22189,Le Coudray-sur-Thelle,60165,60,29,160,39,150,98,287,189
22190,Coudun,60166,60,149,219,73,343,189,605,368
22191,Couloisy,60167,60,28,112,52,228,80,360,140
22192,Courcelles-Epayelles,60168,60,25,57,20,32,43,95,82
22193,Courcelles-lès-Gisors,60169,60,85,225,30,300,195,525,310
22194,Courteuil,60170,60,114,135,59,253,83,395,249
22195,Courtieux,60171,60,13,34,10,59,34,103,47
22196,Coye-la-Forêt,60172,60,393,952,372,1334,807,2513,1345
22197,Cramoisy,60173,60,52,149,136,147,147,430,201
22198,Crapeaumesnil,60174,60,20,58,16,40,37,93,78
22199,Creil,60175,60,2155,11397,4656,7964,7219,19839,13552
22200,Crépy-en-Valois,60176,60,1597,3979,1547,4579,2873,8999,5576
22201,Cressonsacq,60177,60,36,144,32,144,92,268,180
22202,Crèvecoeur-le-Grand,60178,60,427,929,413,980,525,1918,1356
22203,Crèvecoeur-le-Petit,60179,60,24,28,24,24,24,72,52
22204,Crillon,60180,60,34,124,41,127,100,268,158
22205,Crisolles,60181,60,56,269,55,401,201,657,325
22206,Le Crocq,60182,60,5,55,40,50,45,135,60
22207,Croissy-sur-Celle,60183,60,30,75,20,81,58,159,105
22208,Croutoy,60184,60,24,52,4,51,42,97,76
22209,Crouy-en-Thelle,60185,60,60,284,132,324,248,704,344
22210,Cuignières,60186,60,20,60,32,80,44,156,80
22211,Cuigy-en-Bray,60187,60,125,245,70,325,175,570,370
22212,Cuise-la-Motte,60188,60,193,474,204,678,419,1301,667
22213,Cuts,60189,60,93,218,46,299,170,515,311
22214,Cuvergnon,60190,60,30,75,55,95,35,185,105
22215,Cuvilly,60191,60,36,204,60,156,160,376,240
22216,Cuy,60192,60,6,56,6,68,51,125,62
22217,Daméraucourt,60193,60,25,55,25,75,45,145,80
22218,Dargies,60194,60,25,60,39,95,45,179,85
22219,Delincourt,60195,60,35,115,25,225,95,345,150
22220,Le Déluge,60196,60,50,135,35,174,125,334,185
22221,Dieudonné,60197,60,55,230,65,315,145,525,285
22222,Dives,60198,60,43,108,16,82,95,193,151
22223,Doméliers,60199,60,45,55,20,75,30,125,100
22224,Domfront,60200,60,10,45,10,55,25,90,55
22225,Dompierre,60201,60,16,71,13,81,36,130,87
22226,Duvy,60203,60,65,105,50,165,80,295,170
22227,Écuvilly,60204,60,24,88,32,92,56,180,112
22228,Élencourt,60205,60,4,20,4,20,12,36,24
22229,Élincourt-Sainte-Marguerite,60206,60,60,213,70,343,160,573,273
22230,Éméville,60207,60,45,70,30,85,70,185,115
22231,Énencourt-Léage,60208,60,10,35,20,55,20,95,45
22232,Énencourt-le-Sec,60209,60,20,55,5,50,65,120,75
22233,Épineuse,60210,60,20,70,5,90,50,145,90
22234,Éragny-sur-Epte,60211,60,45,150,60,200,110,370,195
22235,Ercuis,60212,60,130,425,160,450,344,954,555
22236,Ermenonville,60213,60,92,252,80,260,208,548,344
22237,Ernemont-Boutavent,60214,60,21,84,0,46,29,75,105
22238,Erquery,60215,60,72,124,24,196,100,320,196
22239,Erquinvillers,60216,60,15,49,10,33,54,97,64
22240,Escames,60217,60,40,44,20,76,44,140,84
22241,Esches,60218,60,84,409,160,425,319,904,493
22242,Escles-Saint-Pierre,60219,60,13,45,0,37,28,65,58
22243,Espaubourg,60220,60,25,175,25,175,105,305,200
22244,Esquennoy,60221,60,100,185,55,280,95,430,285
22245,Essuiles,60222,60,12,160,76,152,164,392,172
22246,Estrées-Saint-Denis,60223,60,453,935,396,1155,606,2157,1388
22247,Étavigny,60224,60,0,55,12,34,35,81,55
22248,Étouy,60225,60,56,195,66,264,146,476,251
22249,Ève,60226,60,25,66,42,131,56,229,91
22250,Évricourt,60227,60,20,52,20,52,48,120,72
22251,Fay-les-Étangs,60228,60,20,116,56,132,121,309,136
22252,Le Fayel,60229,60,0,70,20,105,45,170,70
22253,Le Fay-Saint-Quentin,60230,60,45,140,60,190,115,365,185
22254,Feigneux,60231,60,16,116,52,184,68,304,132
22255,Ferrières,60232,60,52,164,32,112,136,280,216
22256,Feuquières,60233,60,128,435,157,470,234,861,563
22257,Fitz-James,60234,60,182,543,263,824,470,1557,725
22258,Flavacourt,60235,60,63,188,20,216,127,363,251
22259,Flavy-le-Meldeux,60236,60,0,60,20,50,70,140,60
22260,Fléchy,60237,60,30,20,5,30,10,45,50
22261,Fleurines,60238,60,210,496,97,627,370,1094,706
22262,Fleury,60239,60,49,143,49,146,122,317,192
22263,Fontaine-Bonneleau,60240,60,55,51,29,69,29,127,106
22264,Fontaine-Chaalis,60241,60,20,110,25,128,85,238,130
22265,Fontaine-Lavaganne,60242,60,42,173,12,81,137,230,215
22266,Fontaine-Saint-Lucien,60243,60,12,36,0,52,44,96,48
22267,Fontenay-Torcy,60244,60,5,10,15,65,25,105,15
22268,Formerie,60245,60,361,448,185,739,302,1226,809
22269,Fouilleuse,60247,60,0,47,8,21,57,86,47
22270,Fouilloy,60248,60,30,50,10,50,50,110,80
22271,Foulangues,60249,60,5,60,10,85,45,140,65
22272,Fouquenies,60250,60,70,66,20,151,58,229,136
22273,Fouquerolles,60251,60,20,52,60,132,32,224,72
22274,Fournival,60252,60,20,112,92,148,120,360,132
22275,Francastel,60253,60,17,120,43,125,100,268,137
22276,Francières,60254,60,25,185,85,150,130,365,210
22277,Fréniches,60255,60,20,85,45,115,70,230,105
22278,Fresneaux-Montchevreuil,60256,60,52,204,80,248,184,512,256
22279,Fresne-Léguillon,60257,60,34,109,29,154,87,270,143
22280,Fresnières,60258,60,30,45,10,19,35,64,75
22281,Fresnoy-en-Thelle,60259,60,72,292,84,316,200,600,364
22282,Fresnoy-la-Rivière,60260,60,45,140,75,250,120,445,185
22283,Fresnoy-le-Luat,60261,60,36,199,20,136,142,298,235
22284,Le Frestoy-Vaux,60262,60,24,60,36,60,64,160,84
22285,Frétoy-le-Château,60263,60,40,75,10,75,60,145,115
22286,Frocourt,60264,60,13,176,37,155,112,304,189
22287,Froissy,60265,60,120,163,67,301,122,490,283
22288,Le Gallet,60267,60,8,44,8,33,47,88,52
22289,Gannes,60268,60,36,92,36,108,69,213,128
22290,Gaudechart,60269,60,24,100,48,112,76,236,124
22291,Genvry,60270,60,30,90,20,80,75,175,120
22292,Gerberoy,60271,60,15,15,5,45,5,55,30
22293,Gilocourt,60272,60,45,225,40,195,154,389,270
22294,Giraumont,60273,60,30,108,28,233,67,328,138
22295,Glaignes,60274,60,32,74,12,152,51,215,106
22296,Glatigny,60275,60,8,61,4,72,63,139,69
22297,Godenvillers,60276,60,12,90,4,20,68,92,102
22298,Goincourt,60277,60,195,265,100,490,180,770,460
22299,Golancourt,60278,60,36,66,48,140,52,240,102
22300,Gondreville,60279,60,6,29,19,91,28,138,35
22301,Gourchelles,60280,60,42,25,20,59,5,84,67
22302,Gournay-sur-Aronde,60281,60,90,165,40,160,115,315,255
22303,Gouvieux,60282,60,1201,2183,690,3037,1667,5394,3384
22304,Gouy-les-Groseillers,60283,60,5,0,0,5,5,10,5
22305,Grandfresnoy,60284,60,242,485,149,493,378,1020,727
22306,Grandvillers-aux-Bois,60285,60,15,85,30,105,80,215,100
22307,Grandvilliers,60286,60,491,624,263,910,421,1594,1115
22308,Grandrû,60287,60,36,87,33,101,68,202,123
22309,Grémévillers,60288,60,29,121,47,145,83,275,150
22310,Grez,60289,60,24,80,30,59,70,159,104
22311,Guignecourt,60290,60,31,81,12,133,77,222,112
22312,Guiscard,60291,60,187,523,129,439,349,917,710
22313,Gury,60292,60,16,73,17,69,44,130,89
22314,Hadancourt-le-Haut-Clocher,60293,60,15,80,65,150,65,280,95
22315,Hainvillers,60294,60,10,35,5,5,30,40,45
22316,Halloy,60295,60,28,100,27,139,90,256,128
22317,Hannaches,60296,60,15,50,10,40,35,85,65
22318,Le Hamel,60297,60,24,52,8,60,20,88,76
22319,Hanvoile,60298,60,57,150,16,181,146,343,207
22320,Hardivillers,60299,60,80,125,65,195,90,350,205
22321,Hardivillers-en-Vexin,60300,60,13,25,16,32,26,74,38
22322,Haucourt,60301,60,6,27,13,41,22,76,33
22323,Haudivillers,60302,60,70,225,65,300,140,505,295
22324,Hautbos,60303,60,0,51,24,24,57,105,51
22325,Haute-Épine,60304,60,24,96,12,80,68,160,120
22326,Hautefontaine,60305,60,24,50,8,105,69,182,74
22327,Hécourt,60306,60,20,32,28,32,36,96,52
22328,Heilles,60307,60,40,140,80,260,92,432,180
22329,Hémévillers,60308,60,34,111,60,110,90,260,145
22330,Hénonville,60309,60,48,219,56,252,171,479,267
22331,Herchies,60310,60,84,155,35,209,101,345,239
22332,La Hérelle,60311,60,27,57,30,50,40,120,84
22333,Héricourt-sur-Thérain,60312,60,5,45,10,55,25,90,50
22334,Hermes,60313,60,259,677,340,755,449,1544,936
22335,Hétomesnil,60314,60,32,100,28,80,56,164,132
22336,Hodenc-en-Bray,60315,60,50,155,45,140,90,275,205
22337,Hodenc-l'Évêque,60316,60,19,80,10,95,40,145,99
22338,Hondainville,60317,60,36,168,76,272,136,484,204
22339,Houdancourt,60318,60,64,174,48,152,168,368,238
22340,La Houssoye,60319,60,40,190,65,165,145,375,230
22341,Ivors,60320,60,0,67,29,77,47,153,67
22342,Ivry-le-Temple,60321,60,30,200,45,235,185,465,230
22343,Jaméricourt,60322,60,12,88,16,104,84,204,100
22344,Janville,60323,60,65,155,95,250,100,445,220
22345,Jaulzy,60324,60,35,265,120,323,155,598,300
22346,Jaux,60325,60,184,470,240,779,430,1449,654
22347,Jonquières,60326,60,55,145,15,269,100,384,200
22348,Jouy-sous-Thelle,60327,60,110,332,105,280,242,627,442
22349,Juvignies,60328,60,36,68,30,115,40,185,104
22350,Laberlière,60329,60,15,55,10,40,75,125,70
22351,Laboissière-en-Thelle,60330,60,92,348,80,420,264,764,440
22352,Labosse,60331,60,35,115,30,165,105,300,150
22353,Labruyère,60332,60,60,120,32,148,92,272,180
22354,Lachapelle-aux-Pots,60333,60,192,434,164,462,265,891,626
22355,Lachapelle-Saint-Pierre,60334,60,33,244,83,303,180,566,277
22356,Lachapelle-sous-Gerberoy,60335,60,12,24,9,59,13,81,36
22357,Lachaussée-du-Bois-d'Écu,60336,60,32,52,12,72,56,140,84
22358,Lachelle,60337,60,40,156,44,225,124,393,196
22359,Lacroix-Saint-Ouen,60338,60,509,946,345,1605,836,2786,1455
22360,Lafraye,60339,60,24,120,28,116,92,236,144
22361,Lagny,60340,60,60,140,45,160,135,340,200
22362,Lagny-le-Sec,60341,60,120,610,131,552,569,1252,730
22363,Laigneville,60342,60,420,1104,420,1389,822,2631,1524
22364,Lalande-en-Son,60343,60,25,216,45,277,156,478,241
22365,Lalandelle,60344,60,25,135,50,150,120,320,160
22366,Lamécourt,60345,60,15,60,15,40,65,120,75
22367,Lamorlaye,60346,60,1281,1897,826,3434,1402,5662,3178
22368,Lannoy-Cuillère,60347,60,8,72,40,88,60,188,80
22369,Larbroye,60348,60,36,168,36,148,124,308,204
22370,Lassigny,60350,60,124,408,164,396,328,888,532
22371,Lataule,60351,60,7,20,3,40,15,58,27
22372,Lattainville,60352,60,5,30,5,80,20,105,35
22373,Lavacquerie,60353,60,25,60,5,60,40,105,85
22374,Laverrière,60354,60,5,15,0,15,10,25,20
22375,Laversines,60355,60,72,324,92,360,256,708,396
22376,Lavilletertre,60356,60,27,108,22,161,94,277,135
22377,Léglantiers,60357,60,40,175,55,155,130,340,215
22378,Lévignen,60358,60,76,242,88,264,174,526,318
22379,Lhéraule,60359,60,15,55,25,60,35,120,70
22380,Liancourt,60360,60,642,1646,837,1570,1276,3683,2288
22381,Liancourt-Saint-Pierre,60361,60,61,136,52,163,118,333,197
22382,Libermont,60362,60,19,41,22,59,29,110,60
22383,Lierville,60363,60,32,80,12,72,56,140,112
22384,Lieuvillers,60364,60,53,164,60,143,151,354,217
22385,Lihus,60365,60,26,102,43,95,81,219,128
22386,Litz,60366,60,35,95,55,105,75,235,130
22387,Loconville,60367,60,25,90,35,130,55,220,115
22388,Longueil-Annel,60368,60,362,572,284,724,470,1478,934
22389,Longueil-Sainte-Marie,60369,60,152,528,206,509,463,1178,680
22390,Lormaison,60370,60,84,392,96,412,289,797,476
22391,Loueuse,60371,60,28,32,16,40,24,80,60
22392,Luchy,60372,60,32,200,72,136,168,376,232
22393,Machemont,60373,60,110,155,70,210,145,425,265
22394,Maignelay-Montigny,60374,60,225,785,285,880,570,1735,1010
22395,Maimbeville,60375,60,5,120,55,125,85,265,125
22396,Maisoncelle-Saint-Pierre,60376,60,24,48,4,64,28,96,72
22397,Maisoncelle-Tuilerie,60377,60,20,75,25,75,90,190,95
22398,Marest-sur-Matz,60378,60,20,128,32,148,84,264,148
22399,Mareuil-la-Motte,60379,60,35,185,105,170,145,420,220
22400,Mareuil-sur-Ourcq,60380,60,148,512,128,400,372,900,660
22401,Margny-aux-Cerises,60381,60,38,63,36,21,62,119,101
22402,Margny-lès-Compiègne,60382,60,728,1842,1093,1935,1854,4882,2570
22403,Margny-sur-Matz,60383,60,30,165,45,140,165,350,195
22404,Marolles,60385,60,80,140,84,240,84,408,220
22405,Marquéglise,60386,60,36,144,24,128,160,312,180
22406,Marseille-en-Beauvaisis,60387,60,127,436,210,360,233,803,563
22407,Martincourt,60388,60,0,50,15,50,25,90,50
22408,Maucourt,60389,60,8,100,16,60,80,156,108
22409,Maulers,60390,60,10,110,25,59,90,174,120
22410,Maysel,60391,60,8,43,16,115,30,161,51
22411,Mélicocq,60392,60,65,165,65,255,120,440,230
22412,Mello,60393,60,45,190,70,180,170,420,235
22413,Ménévillers,60394,60,4,24,16,36,20,72,28
22414,Méru,60395,60,929,4494,1709,3785,2895,8389,5423
22415,Méry-la-Bataille,60396,60,72,152,76,180,140,396,224
22416,Le Mesnil-Conteville,60397,60,8,28,8,36,16,60,36
22417,Le Mesnil-en-Thelle,60398,60,225,556,200,835,421,1456,781
22418,Le Mesnil-Saint-Firmin,60399,60,20,37,8,37,37,82,57
22419,Le Mesnil-sur-Bulles,60400,60,10,65,65,70,40,175,75
22420,Le Mesnil-Théribus,60401,60,80,225,95,230,145,470,305
22421,Le Meux,60402,60,132,582,217,678,440,1335,714
22422,Milly-sur-Thérain,60403,60,139,386,170,608,241,1019,525
22423,Mogneville,60404,60,89,466,133,409,338,880,555
22424,Moliens,60405,60,88,322,140,284,251,675,410
22425,Monceaux,60406,60,65,176,79,247,177,503,241
22426,Monceaux-l'Abbaye,60407,60,35,80,20,55,50,125,115
22427,Monchy-Humières,60408,60,47,167,48,198,222,468,214
22428,Monchy-Saint-Éloi,60409,60,197,508,188,683,318,1189,705
22429,Mondescourt,60410,60,40,60,30,85,45,160,100
22430,Monneville,60411,60,50,230,30,250,205,485,280
22431,Montagny-en-Vexin,60412,60,52,182,44,205,160,409,234
22432,Montagny-Sainte-Félicité,60413,60,40,105,50,145,80,275,145
22433,Montataire,60414,60,1019,3970,1649,3630,2555,7834,4989
22434,Montépilloy,60415,60,15,38,0,47,30,77,53
22435,Montgérain,60416,60,16,46,18,28,48,94,62
22436,Montiers,60418,60,20,101,8,117,109,234,121
22437,Montjavoult,60420,60,55,74,25,144,83,252,129
22438,Mont-l'Évêque,60421,60,20,100,24,196,72,292,120
22439,Montlognon,60422,60,9,55,12,59,32,103,64
22440,Montmacq,60423,60,150,170,104,455,175,734,320
22441,Montmartin,60424,60,4,72,20,76,68,164,76
22442,Montreuil-sur-Brêche,60425,60,40,128,50,170,113,333,168
22443,Montreuil-sur-Thérain,60426,60,16,68,16,92,56,164,84
22444,Monts,60427,60,35,30,5,85,15,105,65
22445,Le Mont-Saint-Adrien,60428,60,85,125,70,260,75,405,210
22446,Morangles,60429,60,16,120,60,152,80,292,136
22447,Morienval,60430,60,92,242,102,376,223,701,334
22448,Morlincourt,60431,60,61,101,42,139,84,265,162
22449,Mortefontaine,60432,60,29,204,60,262,176,498,233
22450,Mortefontaine-en-Thelle,60433,60,24,265,76,272,224,572,289
22451,Mortemer,60434,60,30,60,30,50,50,130,90
22452,Morvillers,60435,60,35,117,38,158,80,276,152
22453,Mory-Montcrux,60436,60,6,32,10,36,13,59,38
22454,Mouchy-le-Châtel,60437,60,8,28,12,20,20,52,36
22455,Moulin-sous-Touvent,60438,60,10,75,10,60,50,120,85
22456,Mouy,60439,60,432,1398,690,1465,1107,3262,1830
22457,Moyenneville,60440,60,47,151,66,192,127,385,198
22458,Moyvillers,60441,60,52,157,32,196,141,369,209
22459,Muidorge,60442,60,8,55,4,37,43,84,63
22460,Muirancourt,60443,60,43,155,42,153,104,299,198
22461,Mureaumont,60444,60,30,40,24,33,25,82,70
22462,Nampcel,60445,60,21,41,18,106,26,150,62
22463,Nanteuil-le-Haudouin,60446,60,211,1213,408,995,938,2341,1424
22464,Néry,60447,60,45,139,64,268,161,493,184
22465,Neufchelles,60448,60,30,143,25,75,113,213,173
22466,Neufvy-sur-Aronde,60449,60,12,99,34,60,51,145,111
22467,Neuilly-en-Thelle,60450,60,249,870,438,980,636,2054,1119
22468,Neuilly-sous-Clermont,60451,60,128,433,156,523,349,1028,561
22469,Neuville-Bosc,60452,60,15,124,58,177,109,344,139
22470,La Neuville-d'Aumont,60453,60,12,91,20,69,82,171,103
22471,La Neuville-en-Hez,60454,60,52,264,92,360,200,652,316
22472,La Neuville-Garnier,60455,60,15,65,15,115,60,190,80
22473,La Neuville-Roy,60456,60,70,270,90,255,235,580,340
22474,La Neuville-Saint-Pierre,60457,60,12,60,0,44,56,100,72
22475,La Neuville-sur-Oudeuil,60458,60,20,100,20,110,75,205,120
22476,La Neuville-sur-Ressons,60459,60,16,49,18,81,22,121,65
22477,La Neuville-Vault,60460,60,4,56,24,52,28,104,60
22478,Nivillers,60461,60,29,26,9,69,30,108,55
22479,Noailles,60462,60,263,828,395,672,662,1729,1091
22480,Nogent-sur-Oise,60463,60,1743,5598,2278,5050,3679,11007,7341
22481,Nointel,60464,60,74,235,80,414,205,699,309
22482,Noirémont,60465,60,6,60,13,46,41,100,66
22483,Noroy,60466,60,20,60,4,48,72,124,80
22484,Nourard-le-Franc,60468,60,35,70,30,149,50,229,105
22485,Novillers,60469,60,19,107,9,103,75,187,126
22486,Noyers-Saint-Martin,60470,60,92,216,76,220,168,464,308
22487,Noyon,60471,60,1650,3763,1709,3683,2351,7743,5413
22488,Offoy,60472,60,12,48,0,36,32,68,60
22489,Ognes,60473,60,16,88,24,72,80,176,104
22490,Ognolles,60474,60,25,96,20,65,70,155,121
22491,Ognon,60475,60,4,34,21,64,16,101,38
22492,Omécourt,60476,60,0,68,24,64,48,136,68
22493,Ons-en-Bray,60477,60,60,341,163,519,236,918,401
22494,Ormoy-le-Davien,60478,60,4,109,33,94,69,196,113
22495,Ormoy-Villers,60479,60,59,160,55,213,145,413,219
22496,Oroër,60480,60,12,129,66,215,104,385,141
22497,Orrouy,60481,60,56,152,12,164,136,312,208
22498,Orry-la-Ville,60482,60,414,776,248,1271,653,2172,1190
22499,Orvillers-Sorel,60483,60,48,121,41,147,102,290,169
22500,Oudeuil,60484,60,21,53,24,72,44,140,74
22501,Oursel-Maison,60485,60,3,54,15,59,39,113,57
22502,Paillart,60486,60,100,135,35,195,115,345,235
22503,Parnes,60487,60,34,92,25,115,53,193,126
22504,Passel,60488,60,35,50,30,110,50,190,85
22505,Péroy-les-Gombries,60489,60,26,314,113,262,261,636,340
22506,Pierrefitte-en-Beauvaisis,60490,60,47,62,43,128,37,208,109
22507,Pierrefonds,60491,60,230,335,125,630,305,1060,565
22508,Pimprez,60492,60,35,275,75,265,200,540,310
22509,Pisseleu,60493,60,16,145,62,98,110,270,161
22510,Plailly,60494,60,182,381,159,633,259,1051,563
22511,Plainval,60495,60,27,121,37,76,103,216,148
22512,Plainville,60496,60,15,40,6,28,39,73,55
22513,Le Plessier-sur-Bulles,60497,60,10,55,35,25,85,145,65
22514,Le Plessier-sur-Saint-Just,60498,60,64,135,35,157,115,307,199
22515,Plessis-de-Roye,60499,60,24,76,12,80,48,140,100
22516,Le Plessis-Belleville,60500,60,230,940,329,1024,710,2063,1170
22517,Le Plessis-Brion,60501,60,166,319,97,475,270,842,485
22518,Le Plessis-Patte-d'Oie,60502,60,16,44,28,28,8,64,60
22519,Le Ployron,60503,60,15,30,5,30,25,60,45
22520,Ponchon,60504,60,112,300,152,340,200,692,412
22521,Pontarmé,60505,60,80,185,85,260,213,558,265
22522,Pont-l'Évêque,60506,60,65,205,55,230,110,395,270
22523,Pontoise-lès-Noyon,60507,60,38,108,16,134,102,252,146
22524,Pontpoint,60508,60,272,768,343,1016,648,2007,1040
22525,Pont-Sainte-Maxence,60509,60,1091,3477,1727,3569,2413,7709,4568
22526,Porcheux,60510,60,12,172,64,117,106,287,184
22527,Porquéricourt,60511,60,25,120,30,160,45,235,145
22528,Pouilly,60512,60,0,36,8,92,8,108,36
22529,Précy-sur-Oise,60513,60,257,755,257,1109,663,2029,1012
22530,Prévillers,60514,60,8,77,12,41,42,95,85
22531,Pronleroy,60515,60,20,120,20,125,90,235,140
22532,Puiseux-en-Bray,60516,60,35,148,4,124,89,217,183
22533,Puiseux-le-Hauberger,60517,60,24,260,76,312,168,556,284
22534,Puits-la-Vallée,60518,60,20,70,30,60,25,115,90
22535,Quesmy,60519,60,12,45,12,58,34,104,57
22536,Le Quesnel-Aubry,60520,60,8,57,16,48,73,137,65
22537,Quincampoix-Fleuzy,60521,60,85,75,30,170,40,240,160
22538,Quinquempoix,60522,60,12,57,30,66,38,134,69
22539,Rainvillers,60523,60,125,195,70,315,165,550,320
22540,Rantigny,60524,60,195,631,345,828,507,1680,826
22541,Raray,60525,60,20,45,20,53,35,108,65
22542,Ravenel,60526,60,75,299,132,327,225,684,374
22543,Réez-Fosse-Martin,60527,60,15,30,25,45,35,105,45
22544,Reilly,60528,60,8,12,8,59,8,75,20
22545,Rémécourt,60529,60,10,26,0,45,15,60,36
22546,Rémérangles,60530,60,30,45,20,65,50,135,75
22547,Remy,60531,60,140,448,184,644,336,1164,588
22548,Ressons-l'Abbaye,60532,60,10,35,30,50,10,90,45
22549,Ressons-sur-Matz,60533,60,200,425,181,474,290,945,625
22550,Rethondes,60534,60,50,194,36,286,128,450,244
22551,Reuil-sur-Brêche,60535,60,24,113,36,80,84,200,137
22552,Rhuis,60536,60,0,45,10,40,45,95,45
22553,Ribécourt-Dreslincourt,60537,60,402,1070,336,1098,815,2249,1472
22554,Ricquebourg,60538,60,12,78,26,77,33,136,90
22555,Rieux,60539,60,198,374,116,507,280,903,572
22556,Rivecourt,60540,60,20,120,35,175,85,295,140
22557,Roberval,60541,60,10,100,40,143,80,263,110
22558,Rochy-Condé,60542,60,84,269,143,146,266,555,353
22559,Rocquemont,60543,60,20,27,8,29,16,53,47
22560,Rocquencourt,60544,60,20,55,15,34,38,87,75
22561,Romescamps,60545,60,80,168,56,140,116,312,248
22562,Rosières,60546,60,0,50,5,35,45,85,50
22563,Rosoy,60547,60,35,156,56,195,141,392,191
22564,Rosoy-en-Multien,60548,60,8,148,40,176,105,321,156
22565,Rotangy,60549,60,20,56,31,29,46,106,76
22566,Rothois,60550,60,8,61,39,49,43,131,69
22567,Rousseloy,60551,60,17,90,18,121,43,182,107
22568,Rouville,60552,60,9,69,34,69,59,162,78
22569,Rouvillers,60553,60,20,90,40,65,65,170,110
22570,Rouvres-en-Multien,60554,60,12,127,42,152,75,269,139
22571,Rouvroy-les-Merles,60555,60,4,8,8,8,8,24,12
22572,Royaucourt,60556,60,3,52,9,56,47,112,55
22573,Roy-Boissy,60557,60,30,85,30,90,80,200,115
22574,Roye-sur-Matz,60558,60,35,130,35,180,80,295,165
22575,La Rue-Saint-Pierre,60559,60,45,225,89,279,159,527,270
22576,Rully,60560,60,95,180,40,310,130,480,275
22577,Russy-Bémont,60561,60,16,40,40,68,36,144,56
22578,Sacy-le-Grand,60562,60,137,307,161,496,293,950,444
22579,Sacy-le-Petit,60563,60,33,118,67,159,107,333,151
22580,Sains-Morainvillers,60564,60,20,88,39,60,78,177,108
22581,Saint-André-Farivillers,60565,60,45,140,35,135,150,320,185
22582,Saint-Arnoult,60566,60,24,37,21,92,16,129,61
22583,Saint-Aubin-en-Bray,60567,60,95,312,91,348,214,653,407
22584,Saint-Aubin-sous-Erquery,60568,60,26,93,8,84,83,175,119
22585,Saint-Crépin-aux-Bois,60569,60,50,65,25,65,40,130,115
22586,Saint-Crépin-Ibouvillers,60570,60,46,393,124,442,331,897,439
22587,Saint-Deniscourt,60571,60,20,25,0,25,20,45,45
22588,Saint-Étienne-Roilaye,60572,60,16,65,16,135,60,211,81
22589,Sainte-Eusoye,60573,60,12,92,40,96,64,200,104
22590,Saint-Félix,60574,60,35,195,25,200,175,400,230
22591,Sainte-Geneviève,60575,60,259,796,311,988,573,1872,1055
22592,Saint-Germain-la-Poterie,60576,60,27,92,50,125,53,228,119
22593,Saint-Germer-de-Fly,60577,60,250,440,100,570,355,1025,690
22594,Saintines,60578,60,84,292,120,264,240,624,376
22595,Saint-Jean-aux-Bois,60579,60,37,38,40,132,36,208,75
22596,Saint-Just-en-Chaussée,60581,60,713,1483,911,1683,1104,3698,2196
22597,Saint-Léger-aux-Bois,60582,60,76,164,66,289,131,486,240
22598,Saint-Léger-en-Bray,60583,60,30,70,45,160,35,240,100
22599,Saint-Leu-d'Esserent,60584,60,436,1217,458,1551,874,2883,1653
22600,Saint-Martin-aux-Bois,60585,60,27,77,30,79,47,156,104
22601,Saint-Martin-le-Noeud,60586,60,88,224,96,400,212,708,312
22602,Saint-Martin-Longueau,60587,60,135,429,84,539,295,918,564
22603,Saint-Maur,60588,60,19,96,44,108,63,215,115
22604,Saint-Maximin,60589,60,232,788,432,900,680,2012,1020
22605,Saint-Omer-en-Chaussée,60590,60,73,255,107,261,227,595,328
22606,Saint-Paul,60591,60,148,348,156,560,301,1017,496
22607,Saint-Pierre-es-Champs,60592,60,76,168,39,225,166,430,244
22608,Saint-Pierre-lès-Bitry,60593,60,8,48,16,40,40,96,56
22609,Saint-Quentin-des-Prés,60594,60,23,68,41,75,54,170,91
22610,Saint-Remy-en-l'Eau,60595,60,24,116,44,140,76,260,140
22611,Saint-Samson-la-Poterie,60596,60,40,88,20,68,56,144,128
22612,Saint-Sauveur,60597,60,252,365,183,510,265,958,617
22613,Saint-Sulpice,60598,60,52,300,88,300,228,616,352
22614,Saint-Thibault,60599,60,13,104,28,89,50,167,117
22615,Saint-Vaast-de-Longmont,60600,60,44,160,52,232,128,412,204
22616,Saint-Vaast-lès-Mello,60601,60,108,313,136,268,249,653,421
22617,Saint-Valery,60602,60,4,17,0,29,0,29,21
22618,Salency,60603,60,130,230,85,255,175,515,360
22619,Sarcus,60604,60,30,85,15,75,50,140,115
22620,Sarnois,60605,60,32,97,24,80,92,196,129
22621,Le Saulchoy,60608,60,5,20,10,40,35,85,25
22622,Savignies,60609,60,94,161,77,273,141,491,255
22623,Sempigny,60610,60,80,190,90,345,100,535,270
22624,Senantes,60611,60,65,175,45,245,130,420,240
22625,Senlis,60612,60,1584,3905,1519,4522,3156,9197,5489
22626,Senots,60613,60,30,100,35,85,95,215,130
22627,Serans,60614,60,15,60,10,75,60,145,75
22628,Sérévillers,60615,60,20,55,10,20,35,65,75
22629,Sérifontaine,60616,60,330,821,243,784,666,1693,1151
22630,Sermaize,60617,60,24,64,24,92,48,164,88
22631,Séry-Magneval,60618,60,25,85,5,95,70,170,110
22632,Silly-le-Long,60619,60,66,324,135,292,285,712,390
22633,Silly-Tillard,60620,60,60,100,15,150,120,285,160
22634,Solente,60621,60,5,40,20,50,10,80,45
22635,Sommereux,60622,60,34,96,38,115,109,262,130
22636,Songeons,60623,60,150,220,125,315,165,605,370
22637,Sully,60624,60,25,40,16,36,40,92,65
22638,Suzoy,60625,60,40,132,44,236,96,376,172
22639,Talmontiers,60626,60,75,166,65,281,125,471,241
22640,Tartigny,60627,60,73,85,10,60,40,110,158
22641,Therdonne,60628,60,115,222,153,291,205,649,337
22642,Thérines,60629,60,16,40,28,80,36,144,56
22643,Thibivillers,60630,60,15,41,15,60,45,120,56
22644,Thiers-sur-Thève,60631,60,77,252,79,334,245,658,329
22645,Thiescourt,60632,60,68,220,60,245,155,460,288
22646,Thieuloy-Saint-Antoine,60633,60,20,106,44,101,73,218,126
22647,Thieux,60634,60,25,99,25,152,69,246,124
22648,Thiverny,60635,60,90,217,132,297,192,621,307
22649,Thourotte,60636,60,535,1083,506,1461,831,2798,1618
22650,Thury-en-Valois,60637,60,33,122,16,180,96,292,155
22651,Thury-sous-Clermont,60638,60,24,164,84,264,136,484,188
22652,Tillé,60639,60,149,155,138,491,130,759,304
22653,Tourly,60640,60,0,40,25,90,30,145,40
22654,Tracy-le-Mont,60641,60,180,415,195,550,315,1060,595
22655,Tracy-le-Val,60642,60,50,310,65,406,270,741,360
22656,Tricot,60643,60,216,376,208,372,296,876,592
22657,Trie-Château,60644,60,184,354,143,525,224,892,538
22658,Trie-la-Ville,60645,60,55,60,30,110,50,190,115
22659,Troissereux,60646,60,129,209,134,486,128,748,338
22660,Trosly-Breuil,60647,60,287,464,190,712,337,1239,751
22661,Troussencourt,60648,60,32,96,28,116,80,224,128
22662,Troussures,60649,60,30,20,15,60,25,100,50
22663,Trumilly,60650,60,44,122,31,132,98,261,166
22664,Ully-Saint-Georges,60651,60,110,515,175,629,465,1269,625
22665,Valdampierre,60652,60,40,276,76,352,200,628,316
22666,Valescourt,60653,60,14,57,16,129,41,186,71
22667,Vandélicourt,60654,60,16,72,36,92,72,200,88
22668,Varesnes,60655,60,28,90,23,99,90,212,118
22669,Varinfroy,60656,60,28,75,20,49,67,136,103
22670,Vauchelles,60657,60,12,75,39,69,55,163,87
22671,Vauciennes,60658,60,80,170,45,230,145,420,250
22672,Vaudancourt,60659,60,8,48,20,64,36,120,56
22673,Le Vaumain,60660,60,10,100,15,135,105,255,110
22674,Vaumoise,60661,60,103,266,64,282,145,491,369
22675,Le Vauroux,60662,60,48,144,44,180,96,320,192
22676,Velennes,60663,60,9,59,18,82,24,124,68
22677,Vendeuil-Caply,60664,60,50,155,50,145,90,285,205
22678,Venette,60665,60,276,733,228,786,617,1631,1009
22679,Ver-sur-Launette,60666,60,55,300,105,428,269,802,355
22680,Verberie,60667,60,265,1120,614,1091,903,2608,1385
22681,Verderel-lès-Sauqueuse,60668,60,92,157,30,289,112,431,249
22682,Verderonne,60669,60,60,110,25,210,100,335,170
22683,Verneuil-en-Halatte,60670,60,522,1197,379,1544,870,2793,1719
22684,Versigny,60671,60,20,120,35,175,55,265,140
22685,Vez,60672,60,26,101,18,87,43,148,127
22686,Viefvillers,60673,60,20,34,6,51,33,90,54
22687,Vieux-Moulin,60674,60,35,158,29,262,89,380,193
22688,Vignemont,60675,60,33,65,51,199,46,296,98
22689,Ville,60676,60,59,221,62,202,167,431,280
22690,Villembray,60677,60,33,62,21,50,54,125,95
22691,Villeneuve-les-Sablons,60678,60,90,372,140,340,261,741,462
22692,La Villeneuve-sous-Thury,60679,60,15,60,5,45,45,95,75
22693,Villeneuve-sur-Verberie,60680,60,35,196,40,245,130,415,231
22694,Villers-Saint-Barthélemy,60681,60,28,136,64,184,84,332,164
22695,Villers-Saint-Frambourg,60682,60,49,126,23,229,81,333,175
22696,Villers-Saint-Genest,60683,60,16,95,59,85,84,228,111
22697,Villers-Saint-Paul,60684,60,518,1938,708,1797,1351,3856,2456
22698,Villers-Saint-Sépulcre,60685,60,59,253,89,244,220,553,312
22699,Villers-sous-Saint-Leu,60686,60,235,674,140,745,564,1449,909
22700,Villers-sur-Auchy,60687,60,36,104,36,116,76,228,140
22701,Villers-sur-Bonnières,60688,60,6,27,12,64,30,106,33
22702,Villers-sur-Coudun,60689,60,166,308,86,496,235,817,474
22703,Villers-sur-Trie,60690,60,12,94,12,88,81,181,106
22704,Villers-Vermont,60691,60,45,45,0,30,25,55,90
22705,Villers-Vicomte,60692,60,12,56,8,36,48,92,68
22706,Villeselve,60693,60,16,119,29,124,63,216,135
22707,Villotran,60694,60,10,75,20,80,70,170,85
22708,Vineuil-Saint-Firmin,60695,60,205,375,75,525,190,790,580
22709,Vrocourt,60697,60,3,3,0,18,0,18,6
22710,Wacquemoulin,60698,60,25,75,25,95,65,185,100
22711,Wambez,60699,60,5,30,25,70,15,110,35
22712,Warluis,60700,60,161,175,103,481,134,718,336
22713,Wavignies,60701,60,95,365,115,335,305,755,460
22714,Welles-Pérennes,60702,60,16,76,24,84,48,156,92
22715,Aux Marais,60703,60,132,188,56,212,148,416,320
22716,Alençon,61001,61,3653,5696,3463,7835,3841,15139,9349
22717,Almenêches,61002,61,138,150,68,158,114,340,288
22718,Antoigny,61004,61,20,32,8,56,28,92,52
22719,Appenai-sous-Bellême,61005,61,16,62,29,54,67,150,78
22720,Argentan,61006,61,2014,2833,1485,4487,2017,7989,4847
22721,Athis-Val de Rouvre,61007,61,572,1026,321,1466,792,2579,1598
22722,Aube,61008,61,179,304,81,448,185,714,483
22723,Aubry-en-Exmes,61009,61,36,75,14,79,57,150,111
22724,Aubry-le-Panthou,61010,61,12,20,12,60,4,76,32
22725,Aubusson,61011,61,26,124,32,132,66,230,150
22726,Auguaise,61012,61,24,50,12,62,25,99,74
22727,Aunay-les-Bois,61013,61,15,32,20,72,32,124,47
22728,Aunou-le-Faucon,61014,61,14,46,12,99,30,141,60
22729,Aunou-sur-Orne,61015,61,36,76,24,88,48,160,112
22730,Les Authieux-du-Puits,61017,61,24,16,0,24,20,44,40
22731,Avernes-Saint-Gourgon,61018,61,0,20,0,25,15,40,20
22732,Avernes-sous-Exmes,61019,61,8,12,0,40,12,52,20
22733,Avoine,61020,61,20,43,16,91,30,137,63
22734,Avrilly,61021,61,25,26,5,40,21,66,51
22735,Bailleul,61023,61,70,125,60,240,110,410,195
22736,Banvou,61024,61,40,170,40,265,106,411,210
22737,Barville,61026,61,20,48,52,36,32,120,68
22738,Bazoches-au-Houlme,61028,61,35,158,25,165,112,302,193
22739,Bazoches-sur-Hoëne,61029,61,193,200,79,280,145,504,393
22740,La Bazoque,61030,61,20,63,8,78,76,162,83
22741,Beaufai,61032,61,70,115,10,104,65,179,185
22742,Beaulieu,61034,61,44,44,8,80,36,124,88
22743,Beauvain,61035,61,23,53,19,84,31,134,76
22744,Belfonds,61036,61,24,64,12,56,56,124,88
22745,Bellavilliers,61037,61,16,52,8,32,48,88,68
22746,Bellême,61038,61,312,264,120,432,248,800,576
22747,La Bellière,61039,61,36,20,0,36,16,52,56
22748,Bellou-en-Houlme,61040,61,120,350,120,320,225,665,470
22749,Bellou-le-Trichard,61041,61,20,65,25,80,40,145,85
22750,Berd'huis,61043,61,123,247,91,351,183,625,370
22751,Berjou,61044,61,80,112,52,112,120,284,192
22752,Bizou,61046,61,12,12,4,47,20,71,24
22753,Boëcé,61048,61,6,31,3,27,20,50,37
22754,Boissei-la-Lande,61049,61,4,35,8,32,20,60,39
22755,Cour-Maugis sur Huisne,61050,61,104,105,38,252,100,390,209
22756,Boitron,61051,61,19,104,30,67,72,169,123
22757,Bonnefoi,61052,61,22,41,13,40,40,93,63
22758,Bonsmoulins,61053,61,48,80,16,84,40,140,128
22759,Le Bosc-Renoult,61054,61,24,72,4,92,48,144,96
22760,Boucé,61055,61,110,130,45,195,110,350,240
22761,Le Bouillon,61056,61,8,48,20,72,32,124,56
22762,Le Bourg-Saint-Léonard,61057,61,78,72,32,125,47,204,150
22763,Brethel,61060,61,8,38,8,54,21,83,46
22764,Bretoncelles,61061,61,260,301,80,435,239,754,561
22765,Brieux,61062,61,18,6,3,19,12,34,24
22766,Briouze,61063,61,332,255,135,467,229,831,587
22767,Brullemail,61064,61,15,25,15,50,5,70,40
22768,Buré,61066,61,15,30,5,40,15,60,45
22769,Bures,61067,61,15,45,20,55,30,105,60
22770,Bursard,61068,61,20,52,24,51,38,113,72
22771,Cahan,61069,61,12,44,0,58,39,97,56
22772,Caligny,61070,61,55,195,80,280,210,570,250
22773,Camembert,61071,61,25,35,25,90,15,130,60
22774,Canapville,61072,61,20,56,16,92,36,144,76
22775,Carrouges,61074,61,120,170,75,155,90,320,290
22776,Ceaucé,61075,61,316,252,120,356,188,664,568
22777,Le Cercueil,61076,61,5,35,5,55,40,100,40
22778,Cerisé,61077,61,151,229,50,220,120,390,380
22779,Cerisy-Belle-Étoile,61078,61,140,130,60,205,135,400,270
22780,Ceton,61079,61,298,325,149,537,290,976,623
22781,Chahains,61080,61,12,28,8,36,20,64,40
22782,Chailloué,61081,61,104,277,74,241,192,507,381
22783,Le Chalange,61082,61,5,35,10,20,30,60,40
22784,Chambois,61083,61,61,69,33,131,57,221,130
22785,Champcerie,61084,61,24,28,20,28,16,64,52
22786,Le Champ-de-la-Pierre,61085,61,5,0,0,15,5,20,5
22787,Les Champeaux,61086,61,0,25,15,60,15,90,25
22788,Champeaux-sur-Sarthe,61087,61,15,45,10,70,35,115,60
22789,Champ-Haut,61088,61,4,4,0,17,8,25,8
22790,Champosoult,61089,61,6,23,0,37,13,50,29
22791,Champsecret,61091,61,175,210,41,321,198,560,385
22792,Chandai,61092,61,56,150,55,201,115,371,206
22793,Chanu,61093,61,151,277,116,379,209,704,428
22794,La Chapelle-au-Moine,61094,61,52,140,32,236,116,384,192
22795,La Chapelle-Biche,61095,61,25,150,40,165,130,335,175
22796,Rives d'Andaine,61096,61,508,598,224,1140,369,1733,1106
22797,La Chapelle-Montligeon,61097,61,120,100,35,233,65,333,220
22798,La Chapelle-près-Sées,61098,61,35,100,30,180,65,275,135
22799,La Chapelle-Souëf,61099,61,28,56,24,120,44,188,84
22800,La Chapelle-Viel,61100,61,45,60,5,80,60,145,105
22801,Le Château-d'Almenêches,61101,61,15,70,30,65,40,135,85
22802,Le Châtellier,61102,61,30,95,70,145,85,300,125
22803,Chaumont,61103,61,16,68,12,36,56,104,84
22804,La Chaux,61104,61,4,4,0,32,0,32,8
22805,Chemilli,61105,61,15,30,15,90,35,140,45
22806,Ciral,61107,61,65,105,20,134,85,239,170
22807,Cisai-Saint-Aubin,61108,61,35,36,15,66,20,101,71
22808,La Cochère,61110,61,20,30,5,55,25,85,50
22809,Colombiers,61111,61,65,80,5,150,45,200,145
22810,Comblot,61113,61,15,10,0,16,9,25,25
22811,Commeaux,61114,61,8,39,12,63,16,91,47
22812,Sablons sur Huisne,61116,61,315,535,155,776,380,1311,850
22813,Condé-sur-Sarthe,61117,61,299,514,238,813,353,1404,813
22814,Corbon,61118,61,0,30,40,60,10,110,30
22815,Coudehard,61120,61,0,5,10,50,5,65,5
22816,Coulimer,61121,61,60,72,24,108,40,172,132
22817,Coulmer,61122,61,15,15,5,20,30,55,30
22818,Coulonces,61123,61,24,68,16,64,52,132,92
22819,La Coulonche,61124,61,55,95,60,190,85,335,150
22820,Coulonges-sur-Sarthe,61126,61,101,120,14,145,43,202,221
22821,Courgeon,61129,61,50,100,60,110,50,220,150
22822,Courgeoût,61130,61,55,119,38,119,76,233,174
22823,Courménil,61131,61,15,25,5,35,30,70,40
22824,Courtomer,61133,61,160,212,68,184,136,388,372
22825,Craménil,61137,61,20,20,10,55,40,105,40
22826,Croisilles,61138,61,9,56,16,37,47,100,65
22827,Crouttes,61139,61,32,81,16,100,65,181,113
22828,Crulai,61140,61,112,190,105,362,100,567,302
22829,Cuissai,61141,61,15,90,50,230,40,320,105
22830,Dame-Marie,61142,61,22,36,0,40,44,84,58
22831,Damigny,61143,61,498,500,242,951,345,1538,998
22832,Domfront en Poiraie,61145,61,724,646,447,1807,510,2764,1370
22833,Dompierre,61146,61,33,81,34,121,60,215,114
22834,Durcet,61148,61,12,78,20,96,62,178,90
22835,Échalou,61149,61,26,83,38,149,45,232,109
22836,Échauffour,61150,61,145,159,45,262,104,411,304
22837,Écorcei,61151,61,32,64,28,168,60,256,96
22838,Écorches,61152,61,40,5,10,20,0,30,45
22839,Écouché-les-Vallées,61153,61,316,389,174,599,312,1085,705
22840,Eperrais,61154,61,22,8,21,21,12,54,30
22841,Essay,61156,61,80,107,68,115,75,258,187
22842,Exmes,61157,61,30,80,25,95,45,165,110
22843,Faverolles,61158,61,25,45,0,48,16,64,70
22844,Fay,61159,61,8,12,4,21,12,37,20
22845,Feings,61160,61,22,36,16,78,35,129,58
22846,Fel,61161,61,47,33,26,72,36,134,80
22847,La Ferrière-au-Doyen,61162,61,21,45,3,61,31,95,66
22848,La Ferrière-aux-Étangs,61163,61,200,296,76,544,268,888,496
22849,La Ferrière-Béchet,61164,61,5,95,25,105,35,165,100
22850,La Ferrière-Bochard,61165,61,89,185,39,204,150,393,274
22851,Ferrières-la-Verrerie,61166,61,31,15,12,64,6,82,46
22852,La Ferté-en-Ouche,61167,61,411,824,273,979,597,1849,1235
22853,La Ferté-Macé,61168,61,858,1033,476,1946,780,3202,1891
22854,Flers,61169,61,2318,3223,1646,4437,2367,8450,5541
22855,Fleuré,61170,61,15,61,35,57,51,143,76
22856,Fontaine-les-Bassets,61171,61,15,15,10,35,5,50,30
22857,Fontenai-les-Louvets,61172,61,33,52,6,92,36,134,85
22858,Fontenai-sur-Orne,61173,61,40,45,5,115,40,160,85
22859,Francheville,61176,61,10,25,20,70,25,115,35
22860,La Fresnaie-Fayel,61178,61,10,25,5,20,10,35,35
22861,Fresnay-le-Samson,61180,61,15,16,0,62,10,72,31
22862,Gacé,61181,61,359,418,89,687,248,1024,777
22863,Gandelain,61182,61,27,82,47,161,49,257,109
22864,Gâprée,61183,61,25,25,10,55,10,75,50
22865,Les Genettes,61187,61,33,30,4,77,22,103,63
22866,La Genevraie,61188,61,16,16,16,48,4,68,32
22867,Giel-Courteilles,61189,61,35,80,20,135,85,240,115
22868,Ginai,61190,61,8,24,8,48,12,68,32
22869,Godisson,61192,61,15,30,0,35,20,55,45
22870,La Gonfrière,61193,61,50,75,5,100,65,170,125
22871,Goulet,61194,61,44,108,40,148,64,252,152
22872,Le Grais,61195,61,30,35,15,60,45,120,65
22873,Le Gué-de-la-Chaîne,61196,61,140,184,64,224,148,436,324
22874,Guêprei,61197,61,12,28,32,60,20,112,40
22875,Guerquesalles,61198,61,18,30,15,60,20,95,48
22876,Habloville,61199,61,35,40,61,104,25,190,75
22877,Hauterive,61202,61,26,154,26,127,113,266,180
22878,Héloup,61203,61,114,265,50,295,210,555,379
22879,L'Hôme-Chamondot,61206,61,36,60,16,96,52,164,96
22880,Igé,61207,61,72,115,66,249,80,395,187
22881,Irai,61208,61,80,164,76,144,124,344,244
22882,Joué-du-Bois,61209,61,49,82,25,139,64,228,131
22883,Joué-du-Plain,61210,61,12,76,24,92,52,168,88
22884,Juvigny Val d'Andaine,61211,61,336,519,216,717,336,1269,855
22885,Juvigny-sur-Orne,61212,61,3,26,12,36,9,57,29
22886,Lalacelle,61213,61,30,80,15,85,60,160,110
22887,L'Aigle,61214,61,1543,1738,743,2217,1276,4236,3281
22888,Laleu,61215,61,88,84,24,88,72,184,172
22889,La Lande-de-Goult,61216,61,20,40,20,68,28,116,60
22890,La Lande-de-Lougé,61217,61,0,5,5,35,5,45,5
22891,La Lande-Patry,61218,61,314,372,106,562,267,935,686
22892,La Lande-Saint-Siméon,61219,61,4,40,24,40,40,104,44
22893,Landigou,61221,61,27,90,20,145,92,257,117
22894,Landisacq,61222,61,91,197,35,230,129,394,288
22895,Larré,61224,61,10,115,65,120,105,290,125
22896,Lignères,61225,61,0,10,10,0,15,25,10
22897,Lignou,61227,61,36,12,12,56,12,80,48
22898,Livaie,61228,61,35,55,25,65,25,115,90
22899,Loisail,61229,61,10,30,15,40,40,95,40
22900,Longny les Villages,61230,61,542,591,139,1172,438,1749,1133
22901,Longuenoë,61231,61,8,28,4,40,24,68,36
22902,Lonlay-l'Abbaye,61232,61,268,280,92,340,172,604,548
22903,Lonlay-le-Tesson,61233,61,55,55,10,55,60,125,110
22904,Lonrai,61234,61,68,321,112,351,268,731,389
22905,Lougé-sur-Maire,61237,61,40,65,20,125,55,200,105
22906,Louvières-en-Auge,61238,61,15,15,5,40,5,50,30
22907,Macé,61240,61,121,88,16,160,64,240,209
22908,La Madeleine-Bouvet,61241,61,75,90,15,120,95,230,165
22909,Le Mage,61242,61,55,50,20,85,30,135,105
22910,Magny-le-Désert,61243,61,188,372,116,496,276,888,560
22911,Mahéru,61244,61,28,72,8,112,36,156,100
22912,Mantilly,61248,61,180,75,55,150,60,265,255
22913,Marchemaisons,61251,61,16,28,16,64,24,104,44
22914,Mardilly,61252,61,6,22,9,37,32,78,28
22915,Mauves-sur-Huisne,61255,61,90,100,45,225,95,365,190
22916,Médavy,61256,61,45,25,5,30,35,70,70
22917,Méhoudin,61257,61,20,24,4,36,20,60,44
22918,Le Mêle-sur-Sarthe,61258,61,138,173,63,206,112,381,311
22919,Le Ménil-Bérard,61259,61,8,12,4,24,16,44,20
22920,Le Ménil-de-Briouze,61260,61,70,165,55,144,130,329,235
22921,Le Ménil-Broût,61261,61,6,31,6,47,36,89,37
22922,Le Ménil-Ciboult,61262,61,28,32,16,28,24,68,60
22923,Ménil-Erreux,61263,61,40,50,5,70,45,120,90
22924,Ménil-Froger,61264,61,20,5,5,10,5,20,25
22925,Ménil-Gondouin,61265,61,22,29,4,67,22,93,51
22926,Le Ménil-Guyon,61266,61,15,10,5,37,15,57,25
22927,Ménil-Hermei,61267,61,20,55,25,89,34,148,75
22928,Ménil-Hubert-en-Exmes,61268,61,12,12,20,48,8,76,24
22929,Ménil-Hubert-sur-Orne,61269,61,60,125,35,160,100,295,185
22930,Le Ménil-Scelleur,61271,61,9,12,20,18,12,50,21
22931,Le Ménil-Vicomte,61272,61,0,0,6,12,0,18,0
22932,Ménil-Vin,61273,61,10,10,0,25,5,30,20
22933,Les Menus,61274,61,24,74,4,56,48,108,98
22934,Le Merlerault,61275,61,196,140,80,305,100,485,336
22935,Merri,61276,61,20,32,8,72,28,108,52
22936,La Mesnière,61277,61,20,84,35,76,98,209,104
22937,Messei,61278,61,250,465,155,708,365,1228,715
22938,Mieuxcé,61279,61,60,180,70,235,95,400,240
22939,Moncy,61281,61,25,64,44,100,25,169,89
22940,Montabard,61283,61,29,59,32,83,54,169,88
22941,Montchevrel,61284,61,25,70,30,85,25,140,95
22942,Montgaroult,61285,61,60,92,4,108,108,220,152
22943,Montgaudry,61286,61,13,26,9,25,9,43,39
22944,Montilly-sur-Noireau,61287,61,100,200,60,230,150,440,300
22945,Montmerrei,61288,61,45,140,35,160,136,331,185
22946,Mont-Ormel,61289,61,9,20,0,15,12,27,29
22947,Montreuil-au-Houlme,61290,61,12,40,4,44,40,88,52
22948,Montreuil-la-Cambe,61291,61,0,15,0,35,20,55,15
22949,Montsecret-Clairefougère,61292,61,95,205,53,154,180,387,300
22950,Mortagne-au-Perche,61293,61,681,691,331,1158,551,2040,1372
22951,Mortrée,61294,61,201,244,101,337,172,610,445
22952,La Motte-Fouquet,61295,61,6,37,22,39,24,85,43
22953,Moulins-la-Marche,61297,61,160,172,28,216,144,388,332
22954,Moulins-sur-Orne,61298,61,20,59,12,147,20,179,79
22955,Moussonvilliers,61299,61,30,60,20,75,35,130,90
22956,Moutiers-au-Perche,61300,61,100,96,16,124,88,228,196
22957,Neauphe-sous-Essai,61301,61,25,40,20,103,35,158,65
22958,Neauphe-sur-Dive,61302,61,5,30,10,70,30,110,35
22959,Nécy,61303,61,60,144,36,196,92,324,204
22960,Neuilly-le-Bisson,61304,61,20,115,5,90,80,175,135
22961,Neuville-sur-Touques,61307,61,40,55,15,100,40,155,95
22962,Neuvy-au-Houlme,61308,61,3,42,15,84,34,133,45
22963,Perche en Nocé,61309,61,203,607,167,761,417,1345,810
22964,Nonant-le-Pin,61310,61,100,95,55,195,50,300,195
22965,Normandel,61311,61,15,20,0,35,10,45,35
22966,Occagnes,61314,61,70,140,70,195,90,355,210
22967,Omméel,61315,61,15,25,5,55,30,90,40
22968,Ommoy,61316,61,20,25,15,40,15,70,45
22969,Orgères,61317,61,21,22,9,53,18,80,43
22970,Origny-le-Butin,61318,61,8,36,8,28,32,68,44
22971,Origny-le-Roux,61319,61,35,75,15,145,5,165,110
22972,Pacé,61321,61,48,80,19,94,58,171,128
22973,Parfondeval,61322,61,36,24,16,24,24,64,60
22974,Le Pas-Saint-l'Homer,61323,61,16,40,20,28,44,92,56
22975,Passais Villages,61324,61,252,190,63,413,158,634,442
22976,La Perrière,61325,61,45,50,10,120,20,150,95
22977,Perrou,61326,61,28,48,12,68,44,124,76
22978,Pervenchères,61327,61,41,84,46,91,46,183,125
22979,Le Pin-au-Haras,61328,61,31,40,32,95,47,174,71
22980,Le Pin-la-Garenne,61329,61,86,180,35,239,104,378,266
22981,Planches,61330,61,31,53,12,56,35,103,84
22982,Le Plantis,61331,61,12,48,4,44,40,88,60
22983,Pointel,61332,61,54,87,16,62,69,147,141
22984,Pontchardon,61333,61,8,92,16,64,48,128,100
22985,Pouvrai,61336,61,16,21,14,34,6,54,37
22986,Putanges-le-Lac,61339,61,327,453,187,706,390,1283,780
22987,Écouves,61341,61,111,430,141,649,314,1104,541
22988,Rai,61342,61,195,347,135,496,260,891,542
22989,Rânes,61344,61,192,224,92,380,160,632,416
22990,Rémalard en Perche,61345,61,401,406,150,700,351,1201,807
22991,Le Renouard,61346,61,20,44,4,84,40,128,64
22992,Résenlieu,61347,61,25,40,5,80,20,105,65
22993,Réveillon,61348,61,62,63,12,99,69,180,125
22994,Ri,61349,61,8,41,16,28,42,86,49
22995,La Roche-Mabile,61350,61,30,30,25,40,30,95,60
22996,Roiville,61351,61,20,55,0,55,30,85,75
22997,Rônai,61352,61,22,31,3,40,20,63,53
22998,Rouperroux,61357,61,16,33,16,48,32,96,49
22999,Sai,61358,61,40,50,15,70,45,130,90
23000,Saint-Agnan-sur-Sarthe,61360,61,15,25,20,45,5,70,40
23001,Saint-André-de-Briouze,61361,61,12,56,20,60,44,124,68
23002,Saint-André-de-Messei,61362,61,38,157,34,204,108,346,195
23003,Saint-Aquilin-de-Corbion,61363,61,0,20,15,30,15,60,20
23004,Saint-Aubin-d'Appenai,61365,61,60,64,29,141,39,209,124
23005,Saint-Aubin-de-Bonneval,61366,61,12,48,12,44,36,92,60
23006,Saint-Aubin-de-Courteraie,61367,61,45,25,10,40,15,65,70
23007,Saint-Bômer-les-Forges,61369,61,120,270,95,350,195,640,390
23008,Saint-Brice,61370,61,10,30,10,85,20,115,40
23009,Saint-Brice-sous-Rânes,61371,61,33,19,3,37,15,55,52
23010,Saint-Céneri-le-Gérei,61372,61,35,5,5,55,5,65,40
23011,Sainte-Céronne-lès-Mortagne,61373,61,22,40,20,104,26,150,62
23012,Saint-Christophe-de-Chaulieu,61374,61,24,9,6,18,6,30,33
23013,Boischampré,61375,61,108,343,94,404,241,739,451
23014,Saint-Clair-de-Halouze,61376,61,70,225,55,355,165,575,295
23015,Saint-Cyr-la-Rosière,61379,61,30,55,25,80,40,145,85
23016,Saint-Denis-sur-Huisne,61381,61,20,20,5,10,10,25,40
23017,Saint-Denis-sur-Sarthon,61382,61,174,246,85,314,193,592,420
23018,Saint-Didier-sous-Écouves,61383,61,4,34,16,60,17,93,38
23019,Saint-Ellier-les-Bois,61384,61,22,58,30,58,29,117,80
23020,Saint-Evroult-de-Montfort,61385,61,36,96,28,124,64,216,132
23021,Saint-Evroult-Notre-Dame-du-Bois,61386,61,65,95,35,184,65,284,160
23022,Saint-Fraimbault,61387,61,180,92,40,176,64,280,272
23023,Saint-Fulgent-des-Ormes,61388,61,15,40,5,65,45,115,55
23024,Sainte-Gauburge-Sainte-Colombe,61389,61,231,185,120,410,125,655,416
23025,Saint-Georges-d'Annebecq,61390,61,20,30,20,50,20,90,50
23026,Saint-Georges-des-Groseillers,61391,61,529,636,306,1246,477,2029,1165
23027,Saint-Germain-d'Aunay,61392,61,25,31,10,68,27,105,56
23028,Saint-Germain-de-Clairefeuille,61393,61,23,34,9,42,32,83,57
23029,Saint-Germain-de-la-Coudre,61394,61,110,180,55,300,120,475,290
23030,Saint-Germain-des-Grois,61395,61,21,53,25,81,38,144,74
23031,Saint-Germain-de-Martigny,61396,61,5,10,0,45,10,55,15
23032,Saint-Germain-du-Corbéis,61397,61,722,848,175,1424,575,2174,1570
23033,Saint-Germain-le-Vieux,61398,61,5,20,0,25,15,40,25
23034,Saint-Gervais-des-Sablons,61399,61,20,8,0,24,16,40,28
23035,Saint-Gervais-du-Perron,61400,61,30,131,15,110,70,195,161
23036,Saint-Gilles-des-Marais,61401,61,4,25,4,20,34,58,29
23037,Saint-Hilaire-de-Briouze,61402,61,36,84,20,100,56,176,120
23038,Saint-Hilaire-la-Gérard,61403,61,16,36,4,36,48,88,52
23039,Saint-Hilaire-le-Châtel,61404,61,45,175,65,235,115,415,220
23040,Saint-Hilaire-sur-Erre,61405,61,85,140,0,180,130,310,225
23041,Saint-Hilaire-sur-Risle,61406,61,70,55,40,115,40,195,125
23042,Sainte-Honorine-la-Chardonne,61407,61,95,216,70,239,144,453,311
23043,Sainte-Honorine-la-Guillaume,61408,61,65,70,5,100,85,190,135
23044,Saint-Jouin-de-Blavou,61411,61,50,61,10,126,45,181,111
23045,Saint-Julien-sur-Sarthe,61412,61,92,185,64,205,144,413,277
23046,Saint-Lambert-sur-Dive,61413,61,20,50,15,45,35,95,70
23047,Saint-Langis-lès-Mortagne,61414,61,215,185,70,325,95,490,400
23048,Saint-Léger-sur-Sarthe,61415,61,28,100,56,128,56,240,128
23049,Saint-Léonard-des-Parcs,61416,61,8,4,8,28,20,56,12
23050,Saint-Mard-de-Réno,61418,61,44,80,48,200,64,312,124
23051,Sainte-Marguerite-de-Carrouges,61419,61,20,40,12,108,44,164,60
23052,Sainte-Marie-la-Robert,61420,61,12,21,0,37,4,41,33
23053,Saint-Mars-d'Égrenne,61421,61,140,145,55,240,95,390,285
23054,Les Aspres,61422,61,132,156,76,204,128,408,288
23055,Saint-Martin-d'Écublei,61423,61,34,186,30,199,145,374,220
23056,Saint-Martin-des-Landes,61424,61,12,39,9,86,26,121,51
23057,Saint-Martin-des-Pézerits,61425,61,8,41,0,46,16,62,49
23058,Saint-Martin-du-Vieux-Bellême,61426,61,76,136,28,272,96,396,212
23059,Saint-Martin-l'Aiguillon,61427,61,35,45,10,45,60,115,80
23060,Saint-Maurice-lès-Charencey,61429,61,74,135,65,165,70,300,209
23061,Saint-Michel-Tuboeuf,61432,61,82,128,47,214,76,337,210
23062,Saint-Nicolas-des-Bois,61433,61,36,76,32,72,52,156,112
23063,Saint-Nicolas-de-Sommaire,61435,61,16,76,8,96,72,176,92
23064,Sainte-Opportune,61436,61,20,75,25,85,55,165,95
23065,Saint-Ouen-de-la-Cour,61437,61,4,8,4,36,4,44,12
23066,Saint-Ouen-de-Sécherouvre,61438,61,12,32,0,88,44,132,44
23067,Saint-Ouen-le-Brisoult,61439,61,21,41,6,32,15,53,62
23068,Saint-Ouen-sur-Iton,61440,61,100,186,45,320,206,571,286
23069,Saint-Patrice-du-Désert,61442,61,60,30,30,45,40,115,90
23070,Saint-Paul,61443,61,92,168,52,204,136,392,260
23071,Saint-Philbert-sur-Orne,61444,61,8,16,4,51,12,67,24
23072,Saint-Pierre-d'Entremont,61445,61,80,196,56,212,160,428,276
23073,Saint-Pierre-des-Loges,61446,61,25,35,0,70,35,105,60
23074,Saint-Pierre-du-Regard,61447,61,249,328,47,452,289,788,577
23075,Saint-Pierre-la-Bruyère,61448,61,32,108,28,208,84,320,140
23076,Saint-Pierre-la-Rivière,61449,61,20,45,15,60,30,105,65
23077,Saint-Quentin-de-Blavou,61450,61,4,16,8,44,8,60,20
23078,Saint-Quentin-les-Chardonnets,61451,61,30,75,35,100,99,234,105
23079,Saint-Roch-sur-Égrenne,61452,61,35,40,5,80,20,105,75
23080,Saint-Sauveur-de-Carrouges,61453,61,15,55,16,103,42,161,70
23081,Sainte-Scolasse-sur-Sarthe,61454,61,137,137,70,140,78,288,274
23082,Saint-Sulpice-sur-Risle,61456,61,240,400,195,650,205,1050,640
23083,Saint-Symphorien-des-Bruyères,61457,61,39,122,51,188,64,303,161
23084,Saires-la-Verrerie,61459,61,36,69,12,77,57,146,105
23085,Sap-en-Auge,61460,61,148,187,44,264,132,440,335
23086,Le Sap-André,61461,61,18,3,3,51,9,63,21
23087,Sarceaux,61462,61,105,265,75,358,205,638,370
23088,Les Monts d'Andaine,61463,61,201,470,162,614,340,1116,671
23089,Sées,61464,61,699,892,432,1193,515,2140,1591
23090,La Selle-la-Forge,61466,61,205,354,56,493,266,815,559
23091,Semallé,61467,61,24,88,33,111,79,223,112
23092,Sentilly,61468,61,22,20,3,25,25,53,42
23093,Sérigny,61471,61,80,55,45,180,30,255,135
23094,Sévigny,61472,61,35,60,0,180,35,215,95
23095,Sevrai,61473,61,24,72,8,96,56,160,96
23096,Silly-en-Gouffern,61474,61,56,81,29,142,41,212,137
23097,Soligny-la-Trappe,61475,61,160,130,56,145,92,293,290
23098,Suré,61476,61,25,40,25,114,39,178,65
23099,Survie,61477,61,24,32,8,68,12,88,56
23100,Tanques,61479,61,40,40,5,35,30,70,80
23101,Tanville,61480,61,27,38,3,69,38,110,65
23102,Tellières-le-Plessis,61481,61,12,36,0,28,20,48,48
23103,Tessé-Froulay,61482,61,65,75,15,160,65,240,140
23104,Bagnoles de l'Orne Normandie,61483,61,630,405,180,1025,260,1465,1035
23105,Val-au-Perche,61484,61,444,1016,378,1222,678,2278,1460
23106,Ticheville,61485,61,31,41,9,70,33,112,72
23107,Tinchebray-Bocage,61486,61,844,1070,439,1548,832,2819,1914
23108,Torchamp,61487,61,74,60,15,109,30,154,134
23109,Touquettes,61488,61,12,29,4,8,26,38,41
23110,Tournai-sur-Dive,61490,61,50,65,30,115,35,180,115
23111,Tourouvre au Perche,61491,61,588,706,205,1156,459,1820,1294
23112,Trémont,61492,61,20,44,16,28,20,64,64
23113,La Trinité-des-Laitiers,61493,61,12,20,4,32,16,52,32
23114,Trun,61494,61,240,300,84,380,196,660,540
23115,Urou-et-Crennes,61496,61,145,185,10,275,135,420,330
23116,Valframbert,61497,61,116,425,148,619,271,1038,541
23117,Vaunoise,61498,61,0,25,10,54,15,79,25
23118,Les Ventes-de-Bourse,61499,61,4,52,4,76,32,112,56
23119,La Ventrouze,61500,61,12,9,3,40,15,58,21
23120,Verrières,61501,61,24,130,25,155,90,270,154
23121,Vidai,61502,61,8,24,0,32,16,48,32
23122,Vieux-Pont,61503,61,42,37,15,64,6,85,79
23123,Villebadin,61504,61,20,36,8,20,40,68,56
23124,Villedieu-lès-Bailleul,61505,61,18,32,13,94,19,126,50
23125,Villiers-sous-Mortagne,61507,61,40,78,5,95,73,173,118
23126,Vimoutiers,61508,61,649,649,395,1163,329,1887,1298
23127,Vitrai-sous-Laigle,61510,61,34,54,8,85,18,111,88
23128,Les Yveteaux,61512,61,5,30,5,35,25,65,35
23129,Ablain-Saint-Nazaire,62001,62,237,406,85,625,279,989,643
23130,Ablainzevelle,62002,62,4,40,40,76,40,156,44
23131,Acheville,62003,62,50,165,50,240,130,420,215
23132,Achicourt,62004,62,897,1865,898,2657,1328,4883,2762
23133,Achiet-le-Grand,62005,62,87,277,73,308,201,582,364
23134,Achiet-le-Petit,62006,62,50,75,10,90,85,185,125
23135,Acq,62007,62,68,189,68,222,145,435,257
23136,Acquin-Westbécourt,62008,62,29,229,76,200,181,457,258
23137,Adinfer,62009,62,16,92,8,54,57,119,108
23138,Affringues,62010,62,27,41,9,62,40,111,68
23139,Agnez-lès-Duisans,62011,62,51,157,65,179,125,369,208
23140,Agnières,62012,62,25,85,25,60,65,150,110
23141,Agny,62013,62,165,475,130,720,435,1285,640
23142,Aire-sur-la-Lys,62014,62,1190,2369,985,3105,1827,5917,3559
23143,Airon-Notre-Dame,62015,62,21,48,25,61,40,126,69
23144,Airon-Saint-Vaast,62016,62,25,40,25,80,15,120,65
23145,Aix-en-Ergny,62017,62,20,45,25,55,40,120,65
23146,Aix-en-Issart,62018,62,36,68,52,44,56,152,104
23147,Aix-Noulette,62019,62,445,935,480,1210,755,2445,1380
23148,Alembon,62020,62,55,190,50,190,135,375,245
23149,Alette,62021,62,32,108,44,116,92,252,140
23150,Alincthun,62022,62,45,80,20,130,60,210,125
23151,Allouagne,62023,62,392,615,362,1025,520,1907,1007
23152,Alquines,62024,62,110,275,95,290,190,575,385
23153,Ambleteuse,62025,62,250,350,130,746,260,1136,600
23154,Ambricourt,62026,62,0,36,5,51,25,81,36
23155,Ambrines,62027,62,20,92,24,44,72,140,112
23156,Ames,62028,62,100,184,56,208,116,380,284
23157,Amettes,62029,62,56,128,32,128,116,276,184
23158,Amplier,62030,62,30,75,35,105,60,200,105
23159,Andres,62031,62,46,433,142,492,374,1008,479
23160,Angres,62032,62,657,1082,434,1319,668,2421,1739
23161,Annay,62033,62,445,1043,484,1444,716,2644,1488
23162,Annequin,62034,62,156,660,236,733,526,1495,816
23163,Annezin,62035,62,685,1416,576,1925,1187,3688,2101
23164,Anvin,62036,62,120,255,60,225,130,415,375
23165,Anzin-Saint-Aubin,62037,62,212,602,214,1133,464,1811,814
23166,Ardres,62038,62,433,1098,403,1336,797,2536,1531
23167,Arleux-en-Gohelle,62039,62,71,167,94,288,153,535,238
23168,Arques,62040,62,952,2683,1150,2971,1953,6074,3635
23169,Arras,62041,62,4352,9961,6759,10884,7709,25352,14313
23170,Athies,62042,62,70,215,100,311,188,599,285
23171,Les Attaques,62043,62,201,479,151,564,435,1150,680
23172,Attin,62044,62,47,181,73,263,93,429,228
23173,Aubigny-en-Artois,62045,62,151,363,92,414,275,781,514
23174,Aubin-Saint-Vaast,62046,62,76,165,67,271,121,459,241
23175,Aubrometz,62047,62,15,40,5,50,35,90,55
23176,Auchel,62048,62,1371,3020,1317,2942,1898,6157,4391
23177,Auchy-au-Bois,62049,62,70,125,30,145,90,265,195
23178,Auchy-lès-Hesdin,62050,62,206,360,146,544,267,957,566
23179,Auchy-les-Mines,62051,62,411,1301,563,1409,842,2814,1712
23180,Audembert,62052,62,44,112,24,124,92,240,156
23181,Audincthun,62053,62,92,148,72,188,124,384,240
23182,Audinghen,62054,62,65,110,80,195,115,390,175
23183,Audrehem,62055,62,25,171,25,155,114,294,196
23184,Audresselles,62056,62,55,164,55,228,112,395,219
23185,Audruicq,62057,62,612,1484,561,1552,1011,3124,2096
23186,Aumerval,62058,62,12,48,16,62,35,113,60
23187,Autingues,62059,62,35,80,15,100,45,160,115
23188,Auxi-le-Château,62060,62,355,680,320,858,444,1622,1035
23189,Averdoingt,62061,62,28,80,40,88,52,180,108
23190,Avesnes,62062,62,4,16,4,8,12,24,20
23191,Avesnes-le-Comte,62063,62,208,592,212,620,372,1204,800
23192,Avesnes-lès-Bapaume,62064,62,24,24,16,76,8,100,48
23193,Avion,62065,62,1748,5130,2242,5085,3546,10873,6878
23194,Avondance,62066,62,0,15,10,15,5,30,15
23195,Avroult,62067,62,73,153,49,143,134,326,226
23196,Ayette,62068,62,39,70,43,88,50,181,109
23197,Azincourt,62069,62,35,95,25,90,60,175,130
23198,Bailleul-aux-Cornailles,62070,62,30,70,5,95,45,145,100
23199,Bailleul-lès-Pernes,62071,62,50,110,54,123,100,277,160
23200,Bailleulmont,62072,62,35,45,25,70,70,165,80
23201,Bailleul-Sir-Berthoult,62073,62,128,357,128,409,257,794,485
23202,Bailleulval,62074,62,32,60,16,80,64,160,92
23203,Baincthun,62075,62,90,335,80,518,260,858,425
23204,Bainghen,62076,62,15,75,20,45,75,140,90
23205,Bajus,62077,62,12,112,28,125,88,241,124
23206,Balinghem,62078,62,59,312,86,391,230,707,371
23207,Bancourt,62079,62,4,12,8,16,21,45,16
23208,Bapaume,62080,62,420,807,454,903,464,1821,1227
23209,Baralle,62081,62,46,95,44,182,73,299,141
23210,Barastre,62082,62,20,92,32,64,76,172,112
23211,Barlin,62083,62,700,2135,970,2325,1490,4785,2835
23212,Barly,62084,62,20,45,15,120,25,160,65
23213,Basseux,62085,62,23,17,6,47,15,68,40
23214,Bavincourt,62086,62,55,115,45,110,70,225,170
23215,Bayenghem-lès-Éperlecques,62087,62,60,320,65,265,290,620,380
23216,Bayenghem-lès-Seninghem,62088,62,45,64,16,81,67,164,109
23217,Bazinghen,62089,62,30,130,20,155,65,240,160
23218,Béalencourt,62090,62,12,16,20,36,32,88,28
23219,Beaudricourt,62091,62,10,30,10,35,10,55,40
23220,Beaufort-Blavincourt,62092,62,45,90,25,180,75,280,135
23221,Beaulencourt,62093,62,15,46,15,85,33,133,61
23222,Beaumerie-Saint-Martin,62094,62,29,97,16,120,70,206,126
23223,Beaumetz-lès-Aire,62095,62,32,60,28,76,36,140,92
23224,Beaumetz-lès-Cambrai,62096,62,60,182,30,200,105,335,242
23225,Beaumetz-lès-Loges,62097,62,95,235,90,339,189,618,330
23226,Beaurains,62099,62,688,1328,654,1608,948,3210,2016
23227,Beaurainville,62100,62,310,495,138,649,375,1162,805
23228,Beauvois,62101,62,20,35,15,40,30,85,55
23229,Bécourt,62102,62,30,75,25,85,45,155,105
23230,Béhagnies,62103,62,6,15,3,44,23,70,21
23231,Bellebrune,62104,62,35,105,45,80,95,220,140
23232,Belle-et-Houllefort,62105,62,40,112,64,184,100,348,152
23233,Bellonne,62106,62,10,35,30,115,20,165,45
23234,Bénifontaine,62107,62,35,80,45,155,55,255,115
23235,Berck,62108,62,1915,2745,1743,5054,1901,8698,4660
23236,Bergueneuse,62109,62,21,42,8,74,50,132,63
23237,Berlencourt-le-Cauroy,62111,62,65,65,10,65,40,115,130
23238,Berles-au-Bois,62112,62,66,87,47,165,82,294,153
23239,Berles-Monchel,62113,62,48,144,44,156,120,320,192
23240,Bermicourt,62114,62,16,32,12,56,28,96,48
23241,Berneville,62115,62,36,152,52,200,76,328,188
23242,Bernieulles,62116,62,40,45,20,50,25,95,85
23243,Bertincourt,62117,62,124,252,80,304,152,536,376
23244,Béthonsart,62118,62,15,51,9,24,38,71,66
23245,Béthune,62119,62,3033,5881,3644,7312,4538,15494,8914
23246,Beugin,62120,62,15,125,45,200,70,315,140
23247,Beugnâtre,62121,62,0,51,20,20,48,88,51
23248,Beugny,62122,62,55,105,15,118,85,218,160
23249,Beussent,62123,62,65,145,90,115,125,330,210
23250,Beutin,62124,62,55,145,50,150,90,290,200
23251,Beuvrequen,62125,62,55,89,49,111,91,251,144
23252,Beuvry,62126,62,838,2406,1218,2967,1695,5880,3244
23253,Bezinghem,62127,62,40,110,15,100,80,195,150
23254,Biache-Saint-Vaast,62128,62,499,1005,433,1130,785,2348,1504
23255,Biefvillers-lès-Bapaume,62129,62,0,16,6,43,6,55,16
23256,Bienvillers-au-Bois,62130,62,96,140,52,236,104,392,236
23257,Bihucourt,62131,62,31,100,18,72,68,158,131
23258,Billy-Berclau,62132,62,386,1053,557,1439,924,2920,1439
23259,Billy-Montigny,62133,62,917,2277,1269,2100,1547,4916,3194
23260,Bimont,62134,62,25,55,15,15,25,55,80
23261,Blairville,62135,62,29,107,20,105,30,155,136
23262,Blangerval-Blangermont,62137,62,8,32,12,36,32,80,40
23263,Blangy-sur-Ternoise,62138,62,150,170,85,255,85,425,320
23264,Blendecques,62139,62,401,1328,476,1798,922,3196,1729
23265,Bléquin,62140,62,52,131,44,97,117,258,183
23266,Blessy,62141,62,104,212,68,264,208,540,316
23267,Blingel,62142,62,0,34,12,45,34,91,34
23268,Boffles,62143,62,4,17,9,8,17,34,21
23269,Boiry-Becquerelle,62144,62,31,87,39,132,57,228,118
23270,Boiry-Notre-Dame,62145,62,29,94,47,165,79,291,123
23271,Boiry-Saint-Martin,62146,62,50,50,45,100,35,180,100
23272,Boiry-Sainte-Rictrude,62147,62,85,95,20,115,90,225,180
23273,Bois-Bernard,62148,62,82,180,73,285,150,508,262
23274,Boisdinghem,62149,62,4,68,32,40,56,128,72
23275,Boisjean,62150,62,44,140,48,184,100,332,184
23276,Boisleux-au-Mont,62151,62,35,160,65,128,115,308,195
23277,Boisleux-Saint-Marc,62152,62,15,70,25,60,90,175,85
23278,Bomy,62153,62,84,145,56,176,133,365,229
23279,Bonnières,62154,62,68,156,72,244,112,428,224
23280,Bonningues-lès-Ardres,62155,62,65,215,65,170,160,395,280
23281,Bonningues-lès-Calais,62156,62,55,145,58,238,98,394,200
23282,Boubers-lès-Hesmond,62157,62,34,25,4,0,12,16,59
23283,Boubers-sur-Canche,62158,62,76,164,44,208,132,384,240
23284,Boulogne-sur-Mer,62160,62,4329,11290,6280,11668,7765,25713,15619
23285,Bouquehault,62161,62,80,230,65,160,195,420,310
23286,Bourecq,62162,62,66,170,35,151,129,315,236
23287,Bouret-sur-Canche,62163,62,30,50,35,125,0,160,80
23288,Bourlon,62164,62,108,302,121,407,205,733,410
23289,Bournonville,62165,62,44,56,20,92,44,156,100
23290,Bours,62166,62,58,145,43,228,97,368,203
23291,Boursin,62167,62,8,92,12,84,72,168,100
23292,Bourthes,62168,62,112,276,116,152,196,464,388
23293,Bouvelinghem,62169,62,20,55,25,50,60,135,75
23294,Bouvigny-Boyeffles,62170,62,213,611,225,894,407,1526,824
23295,Boyaval,62171,62,8,56,16,52,20,88,64
23296,Boyelles,62172,62,29,98,30,53,101,184,127
23297,Brebières,62173,62,441,1249,442,1711,904,3057,1690
23298,Brêmes,62174,62,113,279,154,467,195,816,392
23299,Brévillers,62175,62,21,35,9,37,39,85,56
23300,Bréxent-Énocq,62176,62,42,177,37,210,154,401,219
23301,Brimeux,62177,62,65,230,75,260,195,530,295
23302,Bruay-la-Buissière,62178,62,3097,5830,2567,6690,3845,13102,8927
23303,Brunembert,62179,62,20,129,28,96,112,236,149
23304,Brias,62180,62,20,104,36,60,93,189,124
23305,Bucquoy,62181,62,181,377,151,511,237,899,558
23306,Buire-au-Bois,62182,62,24,44,8,116,24,148,68
23307,Buire-le-Sec,62183,62,80,215,125,225,125,475,295
23308,Buissy,62184,62,16,69,16,51,56,123,85
23309,Bullecourt,62185,62,15,70,15,90,70,175,85
23310,Bully-les-Mines,62186,62,1514,3367,1456,3604,2345,7405,4881
23311,Buneville,62187,62,9,31,22,59,22,103,40
23312,Burbure,62188,62,393,768,302,963,582,1847,1161
23313,Bus,62189,62,15,50,10,10,40,60,65
23314,Busnes,62190,62,143,260,89,470,230,789,403
23315,Caffiers,62191,62,45,240,55,175,153,383,285
23316,Cagnicourt,62192,62,40,136,8,128,85,221,176
23317,Calais,62193,62,7134,19426,10448,20855,13054,44357,26560
23318,Calonne-Ricouart,62194,62,668,1447,597,1583,1028,3208,2115
23319,Calonne-sur-la-Lys,62195,62,105,413,159,477,355,991,518
23320,La Calotterie,62196,62,51,176,26,204,112,342,227
23321,Camblain-Châtelain,62197,62,212,489,264,526,294,1084,701
23322,Cambligneul,62198,62,44,88,40,124,48,212,132
23323,Camblain-l'Abbé,62199,62,43,157,21,234,107,362,200
23324,Cambrin,62200,62,60,238,154,342,188,684,298
23325,Camiers,62201,62,292,588,288,888,388,1564,880
23326,Campagne-lès-Boulonnais,62202,62,48,172,76,172,116,364,220
23327,Campagne-lès-Guines,62203,62,38,116,36,173,58,267,154
23328,Campagne-lès-Hesdin,62204,62,218,379,120,432,285,837,597
23329,Campagne-lès-Wardrecques,62205,62,69,281,96,477,229,802,350
23330,Campigneulles-les-Grandes,62206,62,30,71,30,125,40,195,101
23331,Campigneulles-les-Petites,62207,62,50,115,55,260,65,380,165
23332,Canettemont,62208,62,16,16,20,16,8,44,32
23333,Canlers,62209,62,18,31,19,43,32,94,49
23334,Canteleux,62210,62,0,16,0,8,0,8,16
23335,Capelle-Fermont,62211,62,8,69,12,56,60,128,77
23336,Capelle-lès-Hesdin,62212,62,36,124,60,144,72,276,160
23337,Carency,62213,62,65,179,54,283,149,486,244
23338,Carly,62214,62,45,130,70,230,85,385,175
23339,Carvin,62215,62,1699,4436,1943,5187,3287,10417,6135
23340,La Cauchie,62216,62,18,30,9,46,21,76,48
23341,Cauchy-à-la-Tour,62217,62,307,711,367,974,498,1839,1018
23342,Caucourt,62218,62,32,88,48,88,76,212,120
23343,Caumont,62219,62,28,44,16,52,40,108,72
23344,Cavron-Saint-Martin,62220,62,50,95,50,175,105,330,145
23345,Chelers,62221,62,18,71,21,61,48,130,89
23346,Chériennes,62222,62,29,16,6,66,6,78,45
23347,Chérisy,62223,62,25,75,55,70,75,200,100
23348,Chocques,62224,62,325,781,309,958,563,1830,1106
23349,Clairmarais,62225,62,100,105,100,255,75,430,205
23350,Clenleu,62227,62,33,45,16,33,43,92,78
23351,Clerques,62228,62,33,96,20,63,76,159,129
23352,Cléty,62229,62,48,209,100,156,204,460,257
23353,Colembert,62230,62,96,265,63,210,192,465,361
23354,Colline-Beaumont,62231,62,16,34,4,45,16,65,50
23355,La Comté,62232,62,56,218,57,306,180,543,274
23356,Conchil-le-Temple,62233,62,70,312,104,331,240,675,382
23357,Conchy-sur-Canche,62234,62,30,60,30,60,30,120,90
23358,Condette,62235,62,482,525,175,922,385,1482,1007
23359,Contes,62236,62,27,69,16,110,57,183,96
23360,Conteville-lès-Boulogne,62237,62,65,105,35,175,75,285,170
23361,Conteville-en-Ternois,62238,62,12,44,16,20,12,48,56
23362,Coquelles,62239,62,264,541,240,947,332,1519,805
23363,Corbehem,62240,62,254,620,185,577,488,1250,874
23364,Cormont,62241,62,32,112,36,92,68,196,144
23365,Couin,62242,62,4,25,8,25,25,58,29
23366,Coullemont,62243,62,15,24,3,18,27,48,39
23367,Coulogne,62244,62,762,1274,475,1986,875,3336,2036
23368,Coulomby,62245,62,65,245,70,144,166,380,310
23369,Coupelle-Neuve,62246,62,19,60,3,44,30,77,79
23370,Coupelle-Vieille,62247,62,48,188,72,172,117,361,236
23371,Courcelles-le-Comte,62248,62,40,130,45,175,75,295,170
23372,Courcelles-lès-Lens,62249,62,657,2052,915,1944,1273,4132,2709
23373,Courrières,62250,62,1235,2819,1147,3209,2074,6430,4054
23374,Courset,62251,62,36,136,68,128,96,292,172
23375,La Couture,62252,62,165,747,275,869,658,1802,912
23376,Couturelle,62253,62,5,5,11,47,0,58,10
23377,Coyecques,62254,62,65,129,51,165,107,323,194
23378,Crémarest,62255,62,70,235,85,240,170,495,305
23379,Crépy,62256,62,10,25,5,60,45,110,35
23380,Créquy,62257,62,70,124,12,136,71,219,194
23381,Croisette,62258,62,56,96,20,88,56,164,152
23382,Croisilles,62259,62,130,500,195,475,355,1025,630
23383,Croix-en-Ternois,62260,62,16,128,28,68,92,188,144
23384,Cucq,62261,62,845,945,465,2090,705,3260,1790
23385,Cuinchy,62262,62,119,379,226,591,337,1154,498
23386,Dainville,62263,62,912,1165,301,1951,843,3095,2077
23387,Dannes,62264,62,164,356,124,364,312,800,520
23388,Delettes,62265,62,112,336,128,308,280,716,448
23389,Denier,62266,62,8,16,12,12,8,32,24
23390,Dennebroeucq,62267,62,48,120,20,96,100,216,168
23391,Desvres,62268,62,640,1265,610,1440,950,3000,1905
23392,Diéval,62269,62,80,200,75,205,170,450,280
23393,Divion,62270,62,869,1848,819,1973,1178,3970,2717
23394,Dohem,62271,62,72,244,80,208,188,476,316
23395,Douchy-lès-Ayette,62272,62,28,52,39,105,33,177,80
23396,Doudeauville,62273,62,28,132,64,176,96,336,160
23397,Dourges,62274,62,534,1564,727,1708,1122,3557,2098
23398,Douriez,62275,62,15,110,30,99,85,214,125
23399,Douvrin,62276,62,572,1370,589,1498,1025,3112,1942
23400,Drocourt,62277,62,250,855,300,895,620,1815,1105
23401,Drouvin-le-Marais,62278,62,50,170,60,148,130,338,220
23402,Duisans,62279,62,136,298,127,423,246,796,434
23403,Dury,62280,62,10,95,25,130,80,235,105
23404,Echinghen,62281,62,29,68,13,147,53,213,97
23405,Éclimeux,62282,62,10,33,13,72,19,104,43
23406,Écoivres,62283,62,16,32,24,16,20,60,48
23407,Écourt-Saint-Quentin,62284,62,240,370,215,505,355,1075,610
23408,Écoust-Saint-Mein,62285,62,50,110,45,185,95,325,160
23409,Ecquedecques,62286,62,37,126,25,137,111,273,163
23410,Ecques,62288,62,172,540,159,633,429,1221,712
23411,Écuires,62289,62,120,144,68,308,128,504,264
23412,Écurie,62290,62,44,92,52,152,64,268,136
23413,Éleu-dit-Leauwette,62291,62,330,683,323,973,560,1856,1013
23414,Elnes,62292,62,68,268,120,276,228,624,336
23415,Embry,62293,62,35,52,16,63,28,107,87
23416,Enguinegatte,62294,62,45,140,40,90,140,270,185
23417,Enquin-les-Mines,62295,62,125,323,75,285,283,643,448
23418,Enquin-sur-Baillons,62296,62,13,67,29,76,41,146,80
23419,Éperlecques,62297,62,316,975,371,1065,674,2110,1291
23420,Épinoy,62298,62,40,152,60,148,128,336,192
23421,Eps,62299,62,25,85,10,85,50,145,110
23422,Équihen-Plage,62300,62,290,781,365,888,506,1759,1071
23423,Équirre,62301,62,12,8,0,28,8,36,20
23424,Ergny,62302,62,32,48,16,97,28,141,80
23425,Érin,62303,62,29,39,25,56,39,120,68
23426,Erny-Saint-Julien,62304,62,40,100,35,80,75,190,140
23427,Ervillers,62306,62,45,104,15,150,104,269,149
23428,Escalles,62307,62,35,45,45,95,30,170,80
23429,Escoeuilles,62308,62,40,176,48,84,136,268,216
23430,Esquerdes,62309,62,128,511,132,479,304,915,639
23431,Essars,62310,62,165,364,170,550,318,1038,529
23432,Estevelles,62311,62,116,580,280,616,476,1372,696
23433,Estrée,62312,62,9,72,27,96,55,178,81
23434,Estrée-Blanche,62313,62,90,250,145,259,195,599,340
23435,Estrée-Cauchy,62314,62,40,120,30,90,85,205,160
23436,Estréelles,62315,62,44,100,16,100,92,208,144
23437,Estrée-Wamin,62316,62,15,40,20,70,40,130,55
23438,Étaing,62317,62,24,140,28,120,136,284,164
23439,Étaples,62318,62,1204,2936,1288,3442,2062,6792,4140
23440,Éterpigny,62319,62,4,72,16,88,68,172,76
23441,Étrun,62320,62,60,70,40,115,40,195,130
23442,Évin-Malmaison,62321,62,369,1415,431,1273,993,2697,1784
23443,Famechon,62322,62,15,25,5,50,10,65,40
23444,Fampoux,62323,62,112,288,100,400,244,744,400
23445,Farbus,62324,62,58,116,39,204,77,320,174
23446,Fauquembergues,62325,62,97,264,97,267,163,527,361
23447,Favreuil,62326,62,17,39,36,62,22,120,56
23448,Febvin-Palfart,62327,62,60,164,92,136,132,360,224
23449,Ferfay,62328,62,55,290,80,280,230,590,345
23450,Ferques,62329,62,205,550,185,485,400,1070,755
23451,Festubert,62330,62,100,345,110,430,300,840,445
23452,Feuchy,62331,62,131,228,111,331,175,617,359
23453,Ficheux,62332,62,59,72,47,185,83,315,131
23454,Fiefs,62333,62,35,123,22,116,46,184,158
23455,Fiennes,62334,62,55,245,90,330,170,590,300
23456,Fillièvres,62335,62,78,88,21,154,86,261,166
23457,Fléchin,62336,62,80,135,35,160,80,275,215
23458,Flers,62337,62,15,85,50,60,25,135,100
23459,Fleurbaix,62338,62,346,579,190,1066,359,1615,925
23460,Fleury,62339,62,0,45,30,45,10,85,45
23461,Floringhem,62340,62,90,290,75,230,210,515,380
23462,Foncquevillers,62341,62,25,130,55,145,90,290,155
23463,Fontaine-lès-Boulans,62342,62,8,36,16,16,16,48,44
23464,Fontaine-lès-Croisilles,62343,62,30,90,10,89,65,164,120
23465,Fontaine-lès-Hermans,62344,62,20,36,12,12,28,52,56
23466,Fontaine-l'Étalon,62345,62,20,25,0,40,10,50,45
23467,Fortel-en-Artois,62346,62,20,60,20,90,35,145,80
23468,Fosseux,62347,62,25,35,10,30,35,75,60
23469,Foufflin-Ricametz,62348,62,16,28,12,32,24,68,44
23470,Fouquereuil,62349,62,111,397,139,415,312,866,508
23471,Fouquières-lès-Béthune,62350,62,130,207,63,406,158,627,337
23472,Fouquières-lès-Lens,62351,62,608,1703,749,2136,1052,3937,2311
23473,Framecourt,62352,62,4,17,8,24,20,52,21
23474,Frémicourt,62353,62,5,50,30,100,65,195,55
23475,Frencq,62354,62,84,236,56,272,148,476,320
23476,Fresnes-lès-Montauban,62355,62,40,150,80,200,115,395,190
23477,Fresnicourt-le-Dolmen,62356,62,90,150,110,250,145,505,240
23478,Fresnoy,62357,62,15,13,3,20,0,23,28
23479,Fresnoy-en-Gohelle,62358,62,5,50,15,110,30,155,55
23480,Fressin,62359,62,77,139,40,123,96,259,216
23481,Fréthun,62360,62,114,345,150,370,305,825,459
23482,Frévent,62361,62,461,919,415,1016,576,2007,1380
23483,Frévillers,62362,62,36,56,12,76,64,152,92
23484,Frévin-Capelle,62363,62,26,77,12,110,101,223,103
23485,Fruges,62364,62,277,572,196,688,449,1333,849
23486,Galametz,62365,62,19,45,34,46,18,98,64
23487,Gauchin-Légal,62366,62,35,75,15,115,75,205,110
23488,Gauchin-Verloingt,62367,62,70,185,40,245,150,435,255
23489,Gaudiempré,62368,62,44,44,8,60,28,96,88
23490,Gavrelle,62369,62,52,195,44,128,161,333,247
23491,Gennes-Ivergny,62370,62,15,20,30,65,10,105,35
23492,Givenchy-en-Gohelle,62371,62,222,490,168,698,374,1240,712
23493,Givenchy-le-Noble,62372,62,20,20,24,56,24,104,40
23494,Givenchy-lès-la-Bassée,62373,62,100,290,100,320,205,625,390
23495,Gomiécourt,62374,62,26,22,4,58,12,74,48
23496,Gommecourt,62375,62,15,30,10,35,20,65,45
23497,Gonnehem,62376,62,220,689,283,766,525,1574,909
23498,Gosnay,62377,62,116,211,71,291,166,528,327
23499,Gouves,62378,62,24,32,20,92,20,132,56
23500,Gouy-en-Artois,62379,62,56,54,36,92,45,173,110
23501,Gouy-Servins,62380,62,18,72,25,141,54,220,90
23502,Gouy-en-Ternois,62381,62,15,25,15,65,25,105,40
23503,Gouy-Saint-André,62382,62,60,195,15,183,180,378,255
23504,Gouy-sous-Bellonne,62383,62,116,340,104,484,292,880,456
23505,Graincourt-lès-Havrincourt,62384,62,51,121,84,170,116,370,172
23506,Grand-Rullecourt,62385,62,50,115,40,120,90,250,165
23507,Grenay,62386,62,639,2160,966,1550,1322,3838,2799
23508,Grévillers,62387,62,45,75,22,101,63,186,120
23509,Grigny,62388,62,25,40,45,145,30,220,65
23510,Grincourt-lès-Pas,62389,62,0,0,0,18,3,21,0
23511,Groffliers,62390,62,152,330,70,649,194,913,482
23512,Guarbecque,62391,62,204,380,124,496,232,852,584
23513,Guémappe,62392,62,20,75,20,165,50,235,95
23514,Guemps,62393,62,92,332,132,305,199,636,424
23515,Guigny,62395,62,20,48,12,40,44,96,68
23516,Guinecourt,62396,62,5,0,0,0,0,0,5
23517,Guînes,62397,62,460,1664,596,1779,1035,3410,2124
23518,Guisy,62398,62,35,45,30,115,50,195,80
23519,Habarcq,62399,62,70,165,85,200,140,425,235
23520,Haillicourt,62400,62,501,1408,585,1466,966,3017,1909
23521,Haisnes,62401,62,305,1280,420,1345,965,2730,1585
23522,Halinghen,62402,62,35,95,15,85,95,195,130
23523,Hallines,62403,62,165,350,90,410,220,720,515
23524,Halloy,62404,62,40,45,25,75,30,130,85
23525,Hamblain-les-Prés,62405,62,35,160,48,133,97,278,195
23526,Hamelincourt,62406,62,45,65,20,90,40,150,110
23527,Ham-en-Artois,62407,62,105,215,110,400,195,705,320
23528,Hames-Boucres,62408,62,90,472,105,514,283,902,562
23529,Hannescamps,62409,62,12,57,3,61,47,111,69
23530,Haplincourt,62410,62,26,42,28,52,16,96,68
23531,Haravesnes,62411,62,16,8,8,8,4,20,24
23532,Hardinghen,62412,62,144,292,88,316,244,648,436
23533,Harnes,62413,62,1496,3255,1526,3813,2215,7554,4751
23534,Haucourt,62414,62,30,60,25,85,45,155,90
23535,Haute-Avesnes,62415,62,50,152,38,115,100,253,202
23536,Hautecloque,62416,62,16,56,8,60,68,136,72
23537,Hauteville,62418,62,30,90,25,115,65,205,120
23538,Haut-Loquin,62419,62,16,55,34,42,34,110,71
23539,Havrincourt,62421,62,35,110,40,130,70,240,145
23540,Hébuterne,62422,62,64,123,66,126,76,268,187
23541,Helfaut,62423,62,192,332,120,564,280,964,524
23542,Hendecourt-lès-Cagnicourt,62424,62,48,88,8,72,96,176,136
23543,Hendecourt-lès-Ransart,62425,62,15,40,35,30,10,75,55
23544,Héninel,62426,62,15,55,5,60,55,120,70
23545,Hénin-Beaumont,62427,62,2660,7158,3482,7450,5202,16134,9818
23546,Hénin-sur-Cojeul,62428,62,48,141,40,172,92,304,189
23547,Henneveux,62429,62,25,90,45,70,65,180,115
23548,Hénu,62430,62,8,42,30,32,30,92,50
23549,Herbelles,62431,62,60,120,72,184,84,340,180
23550,Herbinghen,62432,62,20,90,80,110,65,255,110
23551,Héricourt,62433,62,15,30,5,45,10,60,45
23552,La Herlière,62434,62,40,45,5,10,45,60,85
23553,Herlincourt,62435,62,25,15,5,55,5,65,40
23554,Herlin-le-Sec,62436,62,16,56,4,52,48,104,72
23555,Herly,62437,62,60,62,16,95,62,173,122
23556,Hermaville,62438,62,32,150,32,201,120,353,182
23557,Hermelinghen,62439,62,12,132,52,74,77,203,144
23558,Hermies,62440,62,186,247,150,349,135,634,433
23559,Hermin,62441,62,18,41,15,59,31,105,59
23560,Hernicourt,62442,62,46,167,22,150,115,287,213
23561,Hersin-Coupigny,62443,62,637,1683,681,1866,1152,3699,2320
23562,Hervelinghen,62444,62,10,65,30,90,40,160,75
23563,Hesdigneul-lès-Béthune,62445,62,110,199,99,270,139,508,309
23564,Hesdigneul-lès-Boulogne,62446,62,84,170,28,152,131,311,254
23565,Hesdin,62447,62,344,429,171,578,381,1130,773
23566,Hesdin-l'Abbé,62448,62,195,455,165,700,345,1210,650
23567,Hesmond,62449,62,15,46,14,28,44,86,61
23568,Hestrus,62450,62,55,45,5,85,35,125,100
23569,Heuchin,62451,62,70,180,50,135,135,320,250
23570,Heuringhem,62452,62,105,290,110,600,214,924,395
23571,Hézecques,62453,62,12,26,4,28,26,58,38
23572,Hinges,62454,62,195,652,209,815,553,1577,847
23573,Hocquinghen,62455,62,7,17,27,34,13,74,24
23574,Houchin,62456,62,64,144,56,240,130,426,208
23575,Houdain,62457,62,1006,1980,868,2305,1215,4388,2986
23576,Houlle,62458,62,104,248,144,396,168,708,352
23577,Houvin-Houvigneul,62459,62,60,48,12,52,60,124,108
23578,Hubersent,62460,62,24,45,43,64,47,154,69
23579,Huby-Saint-Leu,62461,62,116,187,100,328,115,543,303
23580,Huclier,62462,62,5,35,30,20,30,80,40
23581,Hucqueliers,62463,62,75,103,35,164,97,296,178
23582,Hulluch,62464,62,381,871,363,960,646,1969,1252
23583,Humbercamps,62465,62,39,47,12,53,46,111,86
23584,Humbert,62466,62,33,54,16,62,25,103,87
23585,Humeroeuille,62467,62,24,37,16,28,37,81,61
23586,Humières,62468,62,45,35,20,75,35,130,80
23587,Inchy-en-Artois,62469,62,50,175,70,190,115,375,225
23588,Incourt,62470,62,8,12,4,32,8,44,20
23589,Inghem,62471,62,15,185,65,145,120,330,200
23590,Inxent,62472,62,20,40,15,70,30,115,60
23591,Isbergues,62473,62,1450,2027,949,2896,1496,5341,3477
23592,Isques,62474,62,130,275,75,458,190,723,405
23593,Ivergny,62475,62,35,80,35,60,50,145,115
23594,Izel-lès-Équerchin,62476,62,100,248,64,316,188,568,348
23595,Izel-lès-Hameau,62477,62,62,178,42,269,103,414,240
23596,Journy,62478,62,48,61,37,53,52,142,109
23597,Labeuvrière,62479,62,148,428,184,512,404,1100,576
23598,Labourse,62480,62,207,793,242,665,626,1533,1000
23599,Labroye,62481,62,15,45,15,45,35,95,60
23600,Lacres,62483,62,16,78,12,60,68,140,94
23601,Lagnicourt-Marcel,62484,62,30,85,55,85,85,225,115
23602,Laires,62485,62,30,90,25,130,75,230,120
23603,Lambres,62486,62,68,241,91,360,207,658,309
23604,Landrethun-le-Nord,62487,62,89,404,147,327,248,722,493
23605,Landrethun-lès-Ardres,62488,62,60,220,60,228,160,448,280
23606,Lapugnoy,62489,62,413,867,295,1131,719,2145,1280
23607,Lattre-Saint-Quentin,62490,62,32,64,28,80,48,156,96
23608,Laventie,62491,62,403,1356,433,1577,988,2998,1759
23609,Lebiez,62492,62,30,65,20,85,35,140,95
23610,Lebucquière,62493,62,35,55,35,85,40,160,90
23611,Léchelle,62494,62,10,5,5,26,5,36,15
23612,Ledinghem,62495,62,31,102,24,68,69,161,133
23613,Lefaux,62496,62,25,65,30,60,60,150,90
23614,Leforest,62497,62,878,1913,730,1988,1396,4114,2791
23615,Lens,62498,62,4063,8015,4160,9135,5452,18747,12078
23616,Lépine,62499,62,29,55,15,128,40,183,84
23617,Lespesses,62500,62,44,88,32,144,84,260,132
23618,Lespinoy,62501,62,40,50,25,65,45,135,90
23619,Lestrem,62502,62,317,1186,392,1425,952,2769,1503
23620,Leubringhen,62503,62,3,86,9,89,76,174,89
23621,Leulinghem,62504,62,8,59,20,73,39,132,67
23622,Leulinghen-Bernes,62505,62,35,115,40,135,105,280,150
23623,Licques,62506,62,152,469,116,480,394,990,621
23624,Liencourt,62507,62,25,75,35,80,60,175,100
23625,Lières,62508,62,20,90,55,115,95,265,110
23626,Liettres,62509,62,17,101,42,89,51,182,118
23627,Liévin,62510,62,3019,8719,3932,9457,5880,19269,11738
23628,Lignereuil,62511,62,25,45,10,30,35,75,70
23629,Ligny-lès-Aire,62512,62,40,188,52,216,124,392,228
23630,Ligny-sur-Canche,62513,62,24,38,18,51,21,90,62
23631,Ligny-Saint-Flochel,62514,62,16,88,44,80,44,168,104
23632,Ligny-Thilloy,62515,62,63,132,33,188,91,312,195
23633,Lillers,62516,62,1084,2753,1205,2934,1928,6067,3837
23634,Linghem,62517,62,16,52,40,68,32,140,68
23635,Linzeux,62518,62,10,40,5,75,15,95,50
23636,Lisbourg,62519,62,96,116,100,152,120,372,212
23637,Locon,62520,62,203,560,201,926,407,1534,763
23638,La Loge,62521,62,25,47,0,43,46,89,72
23639,Loison-sur-Créquoise,62522,62,12,46,22,97,25,144,58
23640,Loison-sous-Lens,62523,62,541,1382,704,1540,1006,3250,1923
23641,Longfossé,62524,62,193,355,79,431,288,798,548
23642,Longuenesse,62525,62,1126,2639,1071,3616,1720,6407,3765
23643,Longueville,62526,62,35,20,15,25,25,65,55
23644,Longvilliers,62527,62,30,55,40,90,30,160,85
23645,Loos-en-Gohelle,62528,62,736,1685,690,2043,1187,3920,2421
23646,Lorgies,62529,62,68,480,136,524,376,1036,548
23647,Lottinghen,62530,62,64,180,52,132,140,324,244
23648,Louches,62531,62,78,303,45,236,224,505,381
23649,Lozinghem,62532,62,120,392,130,314,320,764,512
23650,Lugy,62533,62,0,60,15,50,40,105,60
23651,Lumbres,62534,62,429,989,438,1165,705,2308,1418
23652,La Madelaine-sous-Montreuil,62535,62,0,20,20,85,25,130,20
23653,Magnicourt-en-Comte,62536,62,93,173,13,178,109,300,266
23654,Magnicourt-sur-Canche,62537,62,16,25,8,29,16,53,41
23655,Maintenay,62538,62,40,76,36,176,52,264,116
23656,Maisnil,62539,62,18,61,19,61,69,149,79
23657,Maisnil-lès-Ruitz,62540,62,184,455,184,389,356,929,639
23658,Maisoncelle,62541,62,10,35,5,40,35,80,45
23659,Maizières,62542,62,20,44,12,56,40,108,64
23660,Mametz,62543,62,216,460,196,680,416,1292,676
23661,Manin,62544,62,20,56,12,52,52,116,76
23662,Maninghem,62545,62,3,34,19,22,44,85,37
23663,Maninghen-Henne,62546,62,40,70,20,126,50,196,110
23664,Marant,62547,62,24,4,20,28,4,52,28
23665,Marck,62548,62,725,3182,1087,3195,2410,6692,3907
23666,Marconne,62549,62,166,245,110,361,155,626,411
23667,Marconnelle,62550,62,174,275,108,424,180,712,449
23668,Marenla,62551,62,44,72,44,48,52,144,116
23669,Maresquel-Ecquemicourt,62552,62,149,205,105,349,155,609,354
23670,Marest,62553,62,24,48,44,116,52,212,72
23671,Maresville,62554,62,8,26,0,37,8,45,34
23672,Marles-les-Mines,62555,62,757,1424,627,1662,1040,3329,2181
23673,Marles-sur-Canche,62556,62,25,38,55,100,26,181,63
23674,Maroeuil,62557,62,230,572,224,940,414,1578,802
23675,Marquay,62558,62,24,40,8,80,20,108,64
23676,Marquion,62559,62,136,224,96,316,164,576,360
23677,Marquise,62560,62,490,1480,561,1373,1043,2977,1970
23678,Martinpuich,62561,62,24,40,16,92,16,124,64
23679,Matringhem,62562,62,15,55,20,65,50,135,70
23680,Mazingarbe,62563,62,549,2277,1044,2182,1646,4872,2826
23681,Mazinghem,62564,62,50,160,30,120,135,285,210
23682,Mencas,62565,62,14,45,0,29,15,44,59
23683,Menneville,62566,62,39,205,45,288,130,463,244
23684,Mentque-Nortbécourt,62567,62,50,190,85,174,140,399,240
23685,Mercatel,62568,62,48,155,82,207,123,412,203
23686,Merck-Saint-Liévin,62569,62,92,172,40,168,176,384,264
23687,Méricourt,62570,62,1448,3162,1313,3466,2194,6973,4610
23688,Merlimont,62571,62,443,745,327,1268,539,2134,1188
23689,Metz-en-Couture,62572,62,60,190,65,190,155,410,250
23690,Meurchin,62573,62,382,1045,430,1074,855,2359,1427
23691,Mingoval,62574,62,31,53,9,54,42,105,84
23692,Moncheaux-lès-Frévent,62576,62,9,29,19,24,26,69,38
23693,Monchel-sur-Canche,62577,62,0,50,0,30,25,55,50
23694,Monchiet,62578,62,4,36,8,24,17,49,40
23695,Monchy-au-Bois,62579,62,43,159,8,133,138,279,202
23696,Monchy-Breton,62580,62,40,120,28,148,92,268,160
23697,Monchy-Cayeux,62581,62,36,76,52,84,48,184,112
23698,Monchy-le-Preux,62582,62,60,160,60,179,175,414,220
23699,Mondicourt,62583,62,52,180,60,172,160,392,232
23700,Mont-Bernanchon,62584,62,140,310,140,485,250,875,450
23701,Montcavrel,62585,62,65,105,15,120,90,225,170
23702,Montenescourt,62586,62,43,99,30,151,87,268,142
23703,Montigny-en-Gohelle,62587,62,904,2908,1478,2823,2033,6334,3812
23704,Montreuil,62588,62,289,407,207,656,313,1176,696
23705,Mont-Saint-Éloi,62589,62,125,230,90,380,190,660,355
23706,Monts-en-Ternois,62590,62,20,15,5,0,15,20,35
23707,Morchies,62591,62,33,52,8,49,25,82,85
23708,Moringhem,62592,62,43,126,70,146,81,297,169
23709,Morval,62593,62,0,30,0,45,15,60,30
23710,Mory,62594,62,36,91,27,98,60,185,127
23711,Moulle,62595,62,110,270,95,370,205,670,380
23712,Mouriez,62596,62,40,64,20,68,44,132,104
23713,Moyenneville,62597,62,30,75,15,100,50,165,105
23714,Muncq-Nieurlet,62598,62,34,224,86,169,142,397,258
23715,Nabringhen,62599,62,5,50,25,70,40,135,55
23716,Nédon,62600,62,25,40,0,50,25,75,65
23717,Nédonchel,62601,62,35,50,35,40,25,100,85
23718,Nempont-Saint-Firmin,62602,62,16,46,4,52,46,102,62
23719,Nesles,62603,62,71,224,87,354,149,590,295
23720,Neufchâtel-Hardelot,62604,62,431,839,298,1548,556,2402,1270
23721,Neulette,62605,62,0,8,0,16,0,16,8
23722,Neuve-Chapelle,62606,62,63,408,71,521,256,848,471
23723,Neuville-au-Cornet,62607,62,10,5,10,35,10,55,15
23724,Neuville-Bourjonval,62608,62,24,34,6,29,38,73,58
23725,Neuville-Saint-Vaast,62609,62,245,340,120,545,230,895,585
23726,Neuville-sous-Montreuil,62610,62,108,144,72,204,124,400,252
23727,Neuville-Vitasse,62611,62,55,100,50,215,90,355,155
23728,Neuvireuil,62612,62,32,88,67,161,87,315,120
23729,Nielles-lès-Bléquin,62613,62,153,229,60,236,185,481,382
23730,Nielles-lès-Ardres,62614,62,55,115,50,190,100,340,170
23731,Nielles-lès-Calais,62615,62,16,82,4,75,64,143,98
23732,Noeux-lès-Auxi,62616,62,8,32,20,86,4,110,40
23733,Noeux-les-Mines,62617,62,1492,3198,1608,3681,2343,7632,4690
23734,Nordausques,62618,62,89,392,94,242,305,641,481
23735,Noreuil,62619,62,4,36,13,75,12,100,40
23736,Norrent-Fontes,62620,62,172,308,180,492,256,928,480
23737,Nortkerque,62621,62,94,447,135,527,345,1007,541
23738,Nort-Leulinghem,62622,62,8,52,24,52,60,136,60
23739,Nouvelle-Église,62623,62,24,190,74,121,170,365,214
23740,Noyelles-Godault,62624,62,453,1445,721,1557,1135,3413,1898
23741,Noyelles-lès-Humières,62625,62,0,15,10,20,10,40,15
23742,Noyelles-lès-Vermelles,62626,62,212,715,251,599,506,1356,927
23743,Noyelles-sous-Bellonne,62627,62,70,235,85,225,205,515,305
23744,Noyelles-sous-Lens,62628,62,1216,1540,816,2036,1120,3972,2756
23745,Noyellette,62629,62,15,30,5,80,35,120,45
23746,Noyelle-Vion,62630,62,32,77,12,80,68,160,109
23747,Nuncq-Hautecôte,62631,62,45,136,24,115,79,218,181
23748,Oblinghem,62632,62,28,74,42,89,49,180,102
23749,Oeuf-en-Ternois,62633,62,44,52,16,96,44,156,96
23750,Offekerque,62634,62,72,342,152,312,194,658,414
23751,Offin,62635,62,15,55,25,40,65,130,70
23752,Offrethun,62636,62,5,70,5,130,55,190,75
23753,Oignies,62637,62,1372,2367,1134,2978,1633,5745,3739
23754,Oisy-le-Verger,62638,62,144,304,188,416,168,772,448
23755,Oppy,62639,62,39,82,51,129,47,227,121
23756,Orville,62640,62,25,125,40,135,75,250,150
23757,Ostreville,62641,62,32,68,28,92,40,160,100
23758,Ourton,62642,62,105,230,60,235,155,450,335
23759,Outreau,62643,62,1447,3915,1501,4356,2601,8458,5362
23760,Ouve-Wirquin,62644,62,78,122,44,104,103,251,200
23761,Oye-Plage,62645,62,375,1395,495,2217,884,3596,1770
23762,Palluel,62646,62,35,121,51,201,92,344,156
23763,Le Parcq,62647,62,105,245,65,233,140,438,350
23764,Parenty,62648,62,35,135,40,185,110,335,170
23765,Pas-en-Artois,62649,62,145,190,63,218,121,402,335
23766,Pelves,62650,62,68,164,68,288,140,496,232
23767,Penin,62651,62,32,130,48,100,138,286,162
23768,Pernes,62652,62,230,470,160,405,285,850,700
23769,Pernes-lès-Boulogne,62653,62,54,89,36,185,47,268,143
23770,Peuplingues,62654,62,45,225,70,270,155,495,270
23771,Pierremont,62655,62,16,62,30,72,66,168,78
23772,Pihem,62656,62,80,245,60,390,185,635,325
23773,Pihen-lès-Guînes,62657,62,40,128,56,132,120,308,168
23774,Pittefaux,62658,62,8,40,4,56,12,72,48
23775,Planques,62659,62,5,15,5,50,5,60,20
23776,Plouvain,62660,62,20,130,55,155,95,305,150
23777,Bouin-Plumoison,62661,62,28,121,20,138,107,265,149
23778,Polincove,62662,62,63,228,50,271,142,463,291
23779,Pommera,62663,62,32,92,20,96,88,204,124
23780,Pommier,62664,62,12,56,24,72,56,152,68
23781,Le Ponchel,62665,62,45,30,15,80,30,125,75
23782,Pont-à-Vendin,62666,62,207,931,340,860,748,1948,1138
23783,Le Portel,62667,62,1042,2609,1116,3056,1536,5708,3651
23784,Prédefin,62668,62,40,60,8,76,48,132,100
23785,Pressy,62669,62,44,71,29,98,34,161,115
23786,Preures,62670,62,65,125,70,185,135,390,190
23787,Pronville,62671,62,15,100,15,105,85,205,115
23788,Puisieux,62672,62,84,192,92,136,172,400,276
23789,Quéant,62673,62,51,191,35,135,170,340,242
23790,Quelmes,62674,62,33,151,34,184,97,315,184
23791,Quercamps,62675,62,24,45,26,70,48,144,69
23792,Quernes,62676,62,48,116,28,156,120,304,164
23793,Le Quesnoy-en-Artois,62677,62,35,90,40,100,75,215,125
23794,Quesques,62678,62,79,124,57,223,108,388,203
23795,Questrecques,62679,62,25,95,35,110,55,200,120
23796,Quiéry-la-Motte,62680,62,53,150,75,275,113,463,203
23797,Quiestède,62681,62,30,165,60,240,130,430,195
23798,Quilen,62682,62,5,5,5,25,5,35,10
23799,Quoeux-Haut-Maînil,62683,62,25,44,22,90,33,145,69
23800,Racquinghem,62684,62,105,675,230,793,500,1523,780
23801,Radinghem,62685,62,22,67,24,53,51,128,89
23802,Ramecourt,62686,62,52,97,25,108,52,185,149
23803,Rang-du-Fliers,62688,62,429,1035,284,1571,819,2674,1464
23804,Ransart,62689,62,48,96,48,124,80,252,144
23805,Raye-sur-Authie,62690,62,39,72,16,60,30,106,111
23806,Saint-Augustin,62691,62,67,201,82,229,148,459,268
23807,Rebergues,62692,62,20,110,25,75,110,210,130
23808,Rebreuve-Ranchicourt,62693,62,134,254,37,346,241,624,388
23809,Rebreuve-sur-Canche,62694,62,40,45,10,79,45,134,85
23810,Rebreuviette,62695,62,35,70,20,125,30,175,105
23811,Reclinghem,62696,62,44,60,8,32,76,116,104
23812,Récourt,62697,62,9,61,0,69,57,126,70
23813,Recques-sur-Course,62698,62,48,80,4,108,48,160,128
23814,Recques-sur-Hem,62699,62,42,173,67,156,113,336,215
23815,Regnauville,62700,62,50,45,20,70,20,110,95
23816,Rely,62701,62,65,130,35,150,100,285,195
23817,Remilly-Wirquin,62702,62,43,69,43,87,52,182,112
23818,Rémy,62703,62,16,78,30,134,61,225,94
23819,Renty,62704,62,84,200,48,144,156,348,284
23820,Rety,62705,62,151,611,240,573,396,1209,762
23821,Richebourg,62706,62,204,632,224,1087,396,1707,836
23822,Riencourt-lès-Bapaume,62708,62,12,8,0,8,4,12,20
23823,Riencourt-lès-Cagnicourt,62709,62,30,55,50,65,60,175,85
23824,Rimboval,62710,62,5,45,5,55,45,105,50
23825,Rinxent,62711,62,292,717,251,1029,569,1849,1009
23826,Rivière,62712,62,176,240,88,424,204,716,416
23827,Robecq,62713,62,169,360,105,405,305,815,529
23828,Roclincourt,62714,62,90,154,45,299,133,477,244
23829,Rocquigny,62715,62,49,52,21,47,56,124,101
23830,Rodelinghem,62716,62,16,180,72,164,128,364,196
23831,Roëllecourt,62717,62,29,118,83,194,70,347,147
23832,Roeux,62718,62,140,410,80,440,400,920,550
23833,Rollancourt,62719,62,45,70,0,85,65,150,115
23834,Rombly,62720,62,0,12,8,22,8,38,12
23835,Roquetoire,62721,62,175,495,165,670,405,1240,670
23836,Rougefay,62722,62,50,10,5,20,15,40,60
23837,Roussent,62723,62,8,49,48,52,48,148,57
23838,Rouvroy,62724,62,954,2251,1110,2745,1476,5331,3205
23839,Royon,62725,62,12,24,20,40,20,80,36
23840,Ruisseauville,62726,62,24,64,20,36,56,112,88
23841,Ruitz,62727,62,154,373,148,532,310,990,527
23842,Rumaucourt,62728,62,80,163,70,213,125,408,243
23843,Rumilly,62729,62,16,69,8,77,40,125,85
23844,Ruminghem,62730,62,92,564,144,420,444,1008,656
23845,Ruyaulcourt,62731,62,68,72,32,88,68,188,140
23846,Sachin,62732,62,12,101,28,81,71,180,113
23847,Sailly-au-Bois,62733,62,20,66,39,96,28,163,86
23848,Sailly-en-Ostrevent,62734,62,60,218,56,159,164,379,278
23849,Sailly-Labourse,62735,62,203,607,230,591,429,1250,810
23850,Sailly-sur-la-Lys,62736,62,278,1043,305,1577,738,2620,1321
23851,Sains-en-Gohelle,62737,62,571,1652,799,1881,1209,3889,2223
23852,Sains-lès-Fressin,62738,62,5,40,35,50,20,105,45
23853,Sains-lès-Marquion,62739,62,40,76,44,92,56,192,116
23854,Sains-lès-Pernes,62740,62,30,56,12,65,66,143,86
23855,Saint-Amand,62741,62,22,12,9,44,19,72,34
23856,Saint-Aubin,62742,62,15,80,20,125,35,180,95
23857,Sainte-Austreberthe,62743,62,30,65,40,215,45,300,95
23858,Sainte-Catherine,62744,62,431,786,292,1043,692,2027,1217
23859,Saint-Denoeux,62745,62,20,36,8,46,26,80,56
23860,Saint-Étienne-au-Mont,62746,62,578,1400,543,1519,989,3051,1978
23861,Saint-Floris,62747,62,65,180,40,125,160,325,245
23862,Saint-Folquin,62748,62,140,509,207,848,404,1459,649
23863,Saint-Georges,62749,62,36,56,16,164,40,220,92
23864,Saint-Hilaire-Cottes,62750,62,92,232,92,284,136,512,324
23865,Saint-Inglevert,62751,62,36,260,40,196,208,444,296
23866,Saint-Josse,62752,62,135,260,100,455,210,765,395
23867,Saint-Laurent-Blangy,62753,62,705,1616,843,1886,1325,4054,2321
23868,Saint-Léger,62754,62,40,115,40,105,130,275,155
23869,Saint-Léonard,62755,62,416,889,259,1270,645,2174,1305
23870,Sainte-Marie-Kerque,62756,62,94,453,176,444,351,971,547
23871,Saint-Martin-lez-Tatinghem,62757,62,1002,1441,516,1760,959,3235,2443
23872,Saint-Martin-Boulogne,62758,62,1578,2816,1158,3645,1965,6768,4394
23873,Saint-Martin-Choquel,62759,62,66,139,25,82,112,219,205
23874,Saint-Martin-d'Hardinghem,62760,62,55,75,30,90,30,150,130
23875,Saint-Martin-sur-Cojeul,62761,62,15,65,15,55,70,140,80
23876,Saint-Michel-sous-Bois,62762,62,9,27,3,32,29,64,36
23877,Saint-Michel-sur-Ternoise,62763,62,180,162,78,279,112,469,342
23878,Saint-Nicolas,62764,62,408,1181,578,1735,936,3249,1589
23879,Saint-Omer,62765,62,1402,3422,2322,4137,2544,9003,4824
23880,Saint-Omer-Capelle,62766,62,80,370,75,270,300,645,450
23881,Saint-Pol-sur-Ternoise,62767,62,749,1181,552,1437,905,2894,1930
23882,Saint-Rémy-au-Bois,62768,62,15,15,10,25,25,60,30
23883,Saint-Tricat,62769,62,34,197,86,228,159,473,231
23884,Saint-Venant,62770,62,330,685,210,900,575,1685,1015
23885,Sallaumines,62771,62,1066,2735,1350,2752,1642,5744,3801
23886,Salperwick,62772,62,40,130,30,200,100,330,170
23887,Samer,62773,62,420,1178,446,1017,861,2324,1598
23888,Sangatte,62774,62,493,1281,476,1551,913,2940,1774
23889,Sanghen,62775,62,24,77,48,64,72,184,101
23890,Sapignies,62776,62,10,50,25,40,55,120,60
23891,Le Sars,62777,62,16,48,4,34,34,72,64
23892,Sars-le-Bois,62778,62,0,15,25,25,5,55,15
23893,Sarton,62779,62,9,34,18,49,41,108,43
23894,Sauchy-Cauchy,62780,62,29,69,21,121,70,212,98
23895,Sauchy-Lestrée,62781,62,76,104,24,152,96,272,180
23896,Saudemont,62782,62,64,116,60,180,56,296,180
23897,Saulchoy,62783,62,20,59,35,71,66,172,79
23898,Saulty,62784,62,95,245,75,205,160,440,340
23899,Savy-Berlette,62785,62,100,268,72,248,212,532,368
23900,Selles,62786,62,44,80,16,109,30,155,124
23901,Sempy,62787,62,20,95,30,95,65,190,115
23902,Seninghem,62788,62,40,260,90,170,175,435,300
23903,Senlecques,62789,62,10,85,25,55,70,150,95
23904,Senlis,62790,62,40,15,5,60,25,90,55
23905,Séricourt,62791,62,5,20,10,15,10,35,25
23906,Serques,62792,62,104,296,52,412,264,728,400
23907,Servins,62793,62,80,285,110,330,235,675,365
23908,Setques,62794,62,55,160,30,210,125,365,215
23909,Sibiville,62795,62,8,36,24,28,24,76,44
23910,Simencourt,62796,62,60,105,60,228,100,388,165
23911,Siracourt,62797,62,36,68,40,76,40,156,104
23912,Sombrin,62798,62,50,50,20,75,35,130,100
23913,Sorrus,62799,62,57,253,48,184,183,415,310
23914,Souastre,62800,62,44,80,56,116,56,228,124
23915,Souchez,62801,62,370,570,260,735,570,1565,940
23916,Le Souich,62802,62,25,30,20,50,40,110,55
23917,Surques,62803,62,16,252,64,116,190,370,268
23918,Sus-Saint-Léger,62804,62,35,109,28,68,68,164,144
23919,Tangry,62805,62,40,49,16,63,38,117,89
23920,Tardinghen,62806,62,37,25,4,50,17,71,62
23921,Teneur,62808,62,55,35,66,75,40,181,90
23922,Ternas,62809,62,24,27,3,21,26,50,51
23923,Thélus,62810,62,150,295,80,415,260,755,445
23924,Thérouanne,62811,62,144,256,116,340,268,724,400
23925,Thiembronne,62812,62,64,240,112,256,164,532,304
23926,La Thieuloye,62813,62,53,102,77,164,56,297,155
23927,Thièvres,62814,62,40,35,15,30,20,65,75
23928,Tigny-Noyelle,62815,62,16,32,20,76,32,128,48
23929,Tilloy-lès-Hermaville,62816,62,18,61,12,39,54,105,79
23930,Tilloy-lès-Mofflaines,62817,62,155,355,175,400,285,860,510
23931,Tilly-Capelle,62818,62,30,40,10,65,25,100,70
23932,Tilques,62819,62,50,305,95,448,220,763,355
23933,Tincques,62820,62,85,195,85,300,155,540,280
23934,Tingry,62821,62,30,49,29,117,19,165,79
23935,Tollent,62822,62,18,10,6,33,3,42,28
23936,Torcy,62823,62,25,55,0,60,35,95,80
23937,Tortefontaine,62824,62,25,46,10,106,35,151,71
23938,Tortequesne,62825,62,72,204,44,227,192,463,276
23939,Le Touquet-Paris-Plage,62826,62,1274,555,210,1825,403,2438,1829
23940,Tournehem-sur-la-Hem,62827,62,165,450,135,365,320,820,615
23941,Tramecourt,62828,62,16,8,0,20,12,32,24
23942,Le Transloy,62829,62,36,101,20,110,79,209,137
23943,Trescault,62830,62,12,44,12,84,44,140,56
23944,Troisvaux,62831,62,54,75,13,60,61,134,129
23945,Tubersent,62832,62,70,145,15,170,95,280,215
23946,Vacquerie-le-Boucq,62833,62,20,28,4,20,20,44,48
23947,Vacqueriette-Erquières,62834,62,28,52,28,101,36,165,80
23948,Valhuon,62835,62,100,180,35,130,130,295,280
23949,Vaudricourt,62836,62,122,197,67,321,132,520,319
23950,Vaudringhem,62837,62,15,175,50,120,180,350,190
23951,Vaulx,62838,62,25,20,5,25,5,35,45
23952,Vaulx-Vraucourt,62839,62,100,226,100,300,200,600,326
23953,Vélu,62840,62,6,26,9,61,12,82,32
23954,Vendin-lès-Béthune,62841,62,333,525,241,810,459,1510,858
23955,Vendin-le-Vieil,62842,62,612,2461,941,2164,1607,4712,3073
23956,Verchin,62843,62,38,50,16,80,30,126,88
23957,Verchocq,62844,62,100,184,48,180,128,356,284
23958,Verlincthun,62845,62,28,93,54,107,85,246,121
23959,Vermelles,62846,62,480,1251,533,1353,832,2718,1731
23960,Verquigneul,62847,62,139,460,150,563,419,1132,599
23961,Verquin,62848,62,284,864,364,1267,625,2256,1148
23962,Verton,62849,62,188,626,173,863,418,1454,814
23963,Vieil-Hesdin,62850,62,63,78,21,103,71,195,141
23964,Vieille-Chapelle,62851,62,45,231,50,290,167,507,276
23965,Vieille-Église,62852,62,90,420,140,455,310,905,510
23966,Vieil-Moutier,62853,62,55,105,70,90,90,250,160
23967,Villers-au-Bois,62854,62,55,160,30,125,170,325,215
23968,Villers-au-Flos,62855,62,13,61,18,98,25,141,74
23969,Villers-Brûlin,62856,62,16,91,36,97,61,194,107
23970,Villers-Châtel,62857,62,4,44,0,44,40,84,48
23971,Villers-lès-Cagnicourt,62858,62,40,90,15,65,55,135,130
23972,Villers-l'Hôpital,62859,62,50,60,23,60,40,123,110
23973,Villers-Sir-Simon,62860,62,10,35,20,40,25,85,45
23974,Vimy,62861,62,561,986,288,1492,763,2543,1547
23975,Vincly,62862,62,16,34,19,41,22,82,50
23976,Violaines,62863,62,373,941,405,1219,709,2333,1314
23977,Vis-en-Artois,62864,62,55,175,99,178,170,447,230
23978,Vitry-en-Artois,62865,62,584,1104,477,1389,845,2711,1688
23979,Waben,62866,62,24,116,52,160,84,296,140
23980,Wacquinghen,62867,62,40,70,5,105,35,145,110
23981,Wail,62868,62,35,67,25,95,54,174,102
23982,Wailly,62869,62,104,240,125,435,175,735,344
23983,Wailly-Beaucamp,62870,62,58,301,86,277,236,599,359
23984,Wambercourt,62871,62,25,40,25,80,55,160,65
23985,Wamin,62872,62,28,76,36,72,40,148,104
23986,Wancourt,62873,62,32,230,64,164,197,425,262
23987,Wanquetin,62874,62,80,160,84,232,168,484,240
23988,Wardrecques,62875,62,67,337,119,400,259,778,404
23989,Warlencourt-Eaucourt,62876,62,0,35,15,60,30,105,35
23990,Warlincourt-lès-Pas,62877,62,12,68,28,44,52,124,80
23991,Warlus,62878,62,34,78,20,128,67,215,112
23992,Warluzel,62879,62,20,65,30,75,45,150,85
23993,Le Wast,62880,62,16,68,16,48,56,120,84
23994,Beauvoir-Wavans,62881,62,40,68,58,103,54,215,108
23995,Wavrans-sur-l'Aa,62882,62,165,320,115,478,235,828,485
23996,Wavrans-sur-Ternoise,62883,62,30,50,10,50,45,105,80
23997,Westrehem,62885,62,20,57,17,88,30,135,77
23998,Wicquinghem,62886,62,36,56,20,72,44,136,92
23999,Widehem,62887,62,10,40,40,118,25,183,50
24000,Wierre-au-Bois,62888,62,55,60,5,75,35,115,115
24001,Wierre-Effroy,62889,62,83,192,40,253,133,426,275
24002,Willeman,62890,62,34,37,4,60,28,92,71
24003,Willencourt,62891,62,20,20,10,70,10,90,40
24004,Willerval,62892,62,80,150,55,190,155,400,230
24005,Wimereux,62893,62,822,1673,547,2517,1223,4287,2495
24006,Wimille,62894,62,395,1069,306,1630,734,2670,1464
24007,Wingles,62895,62,890,2306,1167,2410,1555,5132,3196
24008,Wirwignes,62896,62,85,210,75,235,135,445,295
24009,Wismes,62897,62,74,82,36,163,77,276,156
24010,Wisques,62898,62,20,45,10,55,50,115,65
24011,Wissant,62899,62,205,205,75,390,130,595,410
24012,Witternesse,62900,62,45,140,85,160,125,370,185
24013,Wittes,62901,62,25,236,83,256,194,533,261
24014,Wizernes,62902,62,365,845,315,1145,640,2100,1210
24015,Zoteux,62903,62,42,158,67,157,103,327,200
24016,Zouafques,62904,62,28,216,100,128,156,384,244
24017,Zudausques,62905,62,28,272,72,272,196,540,300
24018,Zutkerque,62906,62,97,406,231,619,272,1122,503
24019,Libercourt,62907,62,1006,2245,938,2544,1650,5132,3251
24020,La Capelle-lès-Boulogne,62908,62,160,380,128,620,280,1028,540
24021,Ytres,62909,62,23,133,43,113,68,224,156
24022,Aigueperse,63001,63,261,578,220,694,504,1418,839
24023,Aix-la-Fayette,63002,63,4,0,0,44,12,56,4
24024,Ambert,63003,63,1155,1286,627,2283,1056,3966,2441
24025,Les Ancizes-Comps,63004,63,240,285,160,655,215,1030,525
24026,Antoingt,63005,63,44,84,28,156,80,264,128
24027,Anzat-le-Luguet,63006,63,50,20,5,65,30,100,70
24028,Apchat,63007,63,23,15,9,78,19,106,38
24029,Arconsat,63008,63,85,140,40,234,120,394,225
24030,Ardes,63009,63,86,70,51,147,57,255,156
24031,Arlanc,63010,63,260,405,164,697,298,1159,665
24032,Ars-les-Favets,63011,63,50,60,5,80,30,115,110
24033,Artonne,63012,63,80,200,76,332,164,572,280
24034,Aubiat,63013,63,120,241,75,278,183,536,361
24035,Aubière,63014,63,1171,1863,1649,2874,1478,6001,3034
24036,Aubusson-d'Auvergne,63015,63,39,35,12,82,38,132,74
24037,Augerolles,63016,63,140,180,55,325,112,492,320
24038,Augnat,63017,63,30,35,10,45,30,85,65
24039,Aulnat,63019,63,533,839,496,1256,715,2467,1372
24040,Aurières,63020,63,50,85,40,75,75,190,135
24041,Authezat,63021,63,53,180,25,190,168,383,233
24042,Auzat-la-Combelle,63022,63,435,370,160,769,375,1304,805
24043,Auzelles,63023,63,44,55,25,109,55,189,99
24044,Avèze,63024,63,20,10,20,125,0,145,30
24045,Ayat-sur-Sioule,63025,63,20,25,5,70,20,95,45
24046,Aydat,63026,63,214,542,185,805,469,1459,756
24047,Baffie,63027,63,30,25,0,35,20,55,55
24048,Bagnols,63028,63,85,75,30,200,45,275,160
24049,Bansat,63029,63,29,50,18,48,52,118,79
24050,Bas-et-Lezat,63030,63,25,87,16,111,46,173,112
24051,Beaulieu,63031,63,56,71,32,102,100,234,127
24052,Beaumont,63032,63,1334,2186,1522,3835,1896,7253,3520
24053,Beaumont-lès-Randan,63033,63,8,60,20,104,72,196,68
24054,Beauregard-l'Évêque,63034,63,112,364,80,458,259,797,476
24055,Beauregard-Vendon,63035,63,75,330,110,380,280,770,405
24056,Bergonne,63036,63,35,100,15,139,80,234,135
24057,Bertignat,63037,63,84,73,21,185,42,248,157
24058,Besse-et-Saint-Anastaise,63038,63,214,226,84,647,180,911,440
24059,Beurières,63039,63,40,68,28,100,68,196,108
24060,Billom,63040,63,480,1109,445,1420,841,2706,1589
24061,Biollet,63041,63,50,60,15,133,55,203,110
24062,Blanzat,63042,63,605,735,320,1360,555,2235,1340
24063,Blot-l'Église,63043,63,57,76,18,115,53,186,133
24064,Bongheat,63044,63,32,124,40,112,100,252,156
24065,Bort-l'Étang,63045,63,49,173,35,208,109,352,222
24066,Boudes,63046,63,38,68,21,80,53,154,106
24067,La Bourboule,63047,63,252,322,250,672,227,1149,574
24068,Bourg-Lastic,63048,63,170,90,75,340,115,530,260
24069,Bouzel,63049,63,37,186,55,203,154,412,223
24070,Brassac-les-Mines,63050,63,687,625,266,954,450,1670,1312
24071,Brenat,63051,63,76,116,40,228,128,396,192
24072,Le Breuil-sur-Couze,63052,63,156,252,72,300,240,612,408
24073,Briffons,63053,63,45,45,35,120,35,190,90
24074,Le Broc,63054,63,98,131,34,214,103,351,229
24075,Bromont-Lamothe,63055,63,112,252,60,356,200,616,364
24076,Brousse,63056,63,25,61,25,106,60,191,86
24077,Le Brugeron,63057,63,40,35,10,127,30,167,75
24078,Bulhon,63058,63,60,136,40,168,120,328,196
24079,Busséol,63059,63,28,44,24,56,52,132,72
24080,Bussières,63060,63,15,5,10,45,5,60,20
24081,Bussières-et-Pruns,63061,63,38,105,29,101,102,232,143
24082,Buxières-sous-Montaigut,63062,63,30,44,4,95,38,137,74
24083,Cébazat,63063,63,1366,1308,576,2664,1045,4285,2674
24084,La Celle,63064,63,10,10,0,60,0,60,20
24085,Ceilloux,63065,63,8,41,21,54,35,110,49
24086,Celles-sur-Durolle,63066,63,320,380,135,565,325,1025,700
24087,La Cellette,63067,63,32,32,12,64,20,96,64
24088,Le Cendre,63069,63,633,1126,432,1787,916,3135,1759
24089,Ceyrat,63070,63,643,1330,468,2428,1046,3942,1973
24090,Ceyssat,63071,63,56,194,36,212,170,418,250
24091,Chabreloche,63072,63,230,220,85,450,215,750,450
24092,Chadeleuf,63073,63,65,81,43,107,66,216,146
24093,Chalus,63074,63,10,45,5,80,40,125,55
24094,Chamalières,63075,63,3163,2899,2191,5743,2981,10915,6062
24095,Chambon-sur-Dolore,63076,63,70,15,20,60,5,85,85
24096,Chambon-sur-Lac,63077,63,57,54,37,131,60,228,111
24097,Chaméane,63078,63,12,25,9,46,18,73,37
24098,Champagnat-le-Jeune,63079,63,8,16,8,83,16,107,24
24099,Champeix,63080,63,180,293,148,384,295,827,473
24100,Champétières,63081,63,41,20,12,91,24,127,61
24101,Champs,63082,63,24,108,16,108,124,248,132
24102,Chanat-la-Mouteyre,63083,63,59,220,40,412,179,631,279
24103,Chanonat,63084,63,147,400,98,604,350,1052,547
24104,Chapdes-Beaufort,63085,63,97,246,98,313,182,593,343
24105,La Chapelle-Agnon,63086,63,63,45,13,151,52,216,108
24106,La Chapelle-Marcousse,63087,63,20,0,0,40,5,45,20
24107,La Chapelle-sur-Usson,63088,63,9,0,3,40,0,43,9
24108,Chappes,63089,63,120,500,105,529,375,1009,620
24109,Chaptuzat,63090,63,60,108,36,148,112,296,168
24110,Charbonnier-les-Mines,63091,63,125,195,45,320,200,565,320
24111,Charbonnières-les-Varennes,63092,63,158,459,140,535,408,1083,617
24112,Charbonnières-les-Vieilles,63093,63,111,237,95,345,210,650,348
24113,Charensat,63094,63,75,85,30,185,95,310,160
24114,Charnat,63095,63,20,50,45,65,40,150,70
24115,Chas,63096,63,30,90,35,155,70,260,120
24116,Chassagne,63097,63,15,5,10,40,5,55,20
24117,Chastreix,63098,63,45,35,5,100,30,135,80
24118,Châteaugay,63099,63,376,760,248,1201,600,2049,1136
24119,Châteauneuf-les-Bains,63100,63,72,52,16,124,36,176,124
24120,Château-sur-Cher,63101,63,15,15,0,35,20,55,30
24121,Châteldon,63102,63,120,152,80,328,96,504,272
24122,Châtel-Guyon,63103,63,870,1293,502,2161,1058,3721,2163
24123,La Chaulme,63104,63,28,13,6,35,9,50,41
24124,Chaumont-le-Bourg,63105,63,28,52,16,96,40,152,80
24125,Chauriat,63106,63,135,425,150,540,380,1070,560
24126,Chavaroux,63107,63,65,150,15,120,115,250,215
24127,Le Cheix,63108,63,80,139,53,210,113,376,219
24128,Chidrac,63109,63,60,116,84,132,84,300,176
24129,Cisternes-la-Forêt,63110,63,76,92,28,152,120,300,168
24130,Clémensat,63111,63,16,32,4,32,28,64,48
24131,Clerlande,63112,63,8,150,38,181,120,339,158
24132,Clermont-Ferrand,63113,63,15336,29830,30924,35825,24591,91340,45166
24133,Collanges,63114,63,8,38,8,54,30,92,46
24134,Combrailles,63115,63,35,50,20,75,40,135,85
24135,Combronde,63116,63,227,465,142,731,434,1307,692
24136,Compains,63117,63,19,9,3,46,16,65,28
24137,Condat-en-Combraille,63118,63,94,64,36,153,61,250,158
24138,Condat-lès-Montboissier,63119,63,44,34,8,32,59,99,78
24139,Corent,63120,63,40,180,76,208,200,484,220
24140,Coudes,63121,63,152,320,136,272,297,705,472
24141,Courgoul,63122,63,8,16,4,32,12,48,24
24142,Cournols,63123,63,12,43,8,49,41,98,55
24143,Cournon-d'Auvergne,63124,63,2808,4351,1808,6887,3423,12118,7159
24144,Courpière,63125,63,725,820,384,1529,667,2580,1545
24145,Le Crest,63126,63,130,334,80,457,299,836,464
24146,Creste,63127,63,16,4,4,8,12,24,20
24147,Crevant-Laveine,63128,63,104,288,104,328,176,608,392
24148,Cros,63129,63,30,20,15,70,33,118,50
24149,La Crouzille,63130,63,50,45,30,95,40,165,95
24150,Culhat,63131,63,131,272,83,269,272,624,403
24151,Cunlhat,63132,63,95,195,115,475,165,755,290
24152,Dallet,63133,63,130,390,199,400,320,919,520
24153,Dauzat-sur-Vodable,63134,63,35,25,0,10,25,35,60
24154,Davayat,63135,63,44,144,60,198,128,386,188
24155,Domaize,63136,63,65,85,10,140,65,215,150
24156,Doranges,63137,63,40,5,10,90,0,100,45
24157,Dorat,63138,63,76,140,48,284,140,472,216
24158,Dore-l'Église,63139,63,115,115,60,249,100,409,230
24159,Durmignat,63140,63,35,23,6,60,30,96,58
24160,Durtol,63141,63,209,364,154,859,242,1255,573
24161,Échandelys,63142,63,40,35,20,138,20,178,75
24162,Effiat,63143,63,88,268,116,272,276,664,356
24163,Égliseneuve-d'Entraigues,63144,63,124,30,15,181,31,227,154
24164,Égliseneuve-des-Liards,63145,63,15,35,5,55,30,90,50
24165,Égliseneuve-près-Billom,63146,63,85,165,33,296,131,460,250
24166,Églisolles,63147,63,90,40,0,90,35,125,130
24167,Ennezat,63148,63,180,606,237,829,518,1584,786
24168,Entraigues,63149,63,71,151,44,206,142,392,222
24169,Enval,63150,63,77,260,100,513,227,840,337
24170,Escoutoux,63151,63,144,304,104,508,264,876,448
24171,Espinasse,63152,63,65,55,10,120,40,170,120
24172,Espinchal,63153,63,24,21,0,34,25,59,45
24173,Espirat,63154,63,20,100,29,110,71,210,120
24174,Estandeuil,63155,63,56,115,42,104,67,213,171
24175,Esteil,63156,63,25,5,0,5,20,25,30
24176,Fayet-le-Château,63157,63,18,67,14,124,89,227,85
24177,Fayet-Ronaye,63158,63,20,25,15,50,0,65,45
24178,Fernoël,63159,63,30,20,10,65,5,80,50
24179,Aulhat-Flat,63160,63,76,248,49,330,197,576,324
24180,La Forie,63161,63,21,45,17,155,38,210,66
24181,Fournols,63162,63,80,40,25,130,40,195,120
24182,Gelles,63163,63,123,230,70,328,144,542,353
24183,Gerzat,63164,63,1164,2478,1193,3471,1911,6575,3642
24184,Giat,63165,63,160,139,60,323,120,503,299
24185,Gignat,63166,63,28,52,16,92,56,164,80
24186,Gimeaux,63167,63,27,91,32,121,77,230,118
24187,Glaine-Montaigut,63168,63,28,152,16,224,120,360,180
24188,La Godivelle,63169,63,0,0,0,5,5,10,0
24189,La Goutelle,63170,63,95,140,40,230,115,385,235
24190,Gouttières,63171,63,72,40,40,144,48,232,112
24191,Grandeyrolles,63172,63,20,5,0,20,5,25,25
24192,Grandrif,63173,63,20,55,0,55,60,115,75
24193,Grandval,63174,63,35,10,5,45,10,60,45
24194,Herment,63175,63,35,71,28,52,67,147,106
24195,Heume-l'Église,63176,63,20,20,10,40,30,80,40
24196,Isserteaux,63177,63,64,83,28,116,69,213,147
24197,Issoire,63178,63,2324,2845,1489,4527,2400,8416,5169
24198,Job,63179,63,135,215,60,395,165,620,350
24199,Joze,63180,63,124,292,80,328,256,664,416
24200,Jozerand,63181,63,70,140,55,155,95,305,210
24201,Jumeaux,63182,63,95,165,45,250,105,400,260
24202,Labessette,63183,63,32,8,0,12,16,28,40
24203,Lachaux,63184,63,70,50,0,95,60,155,120
24204,Lamontgie,63185,63,47,142,57,168,162,387,189
24205,Landogne,63186,63,37,41,12,68,42,122,78
24206,Lapeyrouse,63187,63,95,140,35,205,95,335,235
24207,Laps,63188,63,56,115,16,137,136,289,171
24208,Laqueuille,63189,63,62,62,30,105,46,181,124
24209,Larodde,63190,63,30,30,20,145,35,200,60
24210,Lastic,63191,63,37,0,4,50,4,58,37
24211,La Tour-d'Auvergne,63192,63,76,97,35,224,95,354,173
24212,Lempdes,63193,63,1140,1725,794,2878,1405,5077,2865
24213,Lempty,63194,63,30,110,55,105,60,220,140
24214,Lezoux,63195,63,679,1328,585,1576,1094,3255,2007
24215,Limons,63196,63,80,160,60,224,172,456,240
24216,Lisseuil,63197,63,8,20,8,44,12,64,28
24217,Loubeyrat,63198,63,96,272,84,384,300,768,368
24218,Ludesse,63199,63,40,150,60,140,85,285,190
24219,Lussat,63200,63,88,248,64,284,244,592,336
24220,Luzillat,63201,63,94,340,90,330,240,660,434
24221,Madriat,63202,63,10,21,20,40,10,70,31
24222,Malauzat,63203,63,52,288,88,400,268,756,340
24223,Malintrat,63204,63,135,265,50,308,309,667,400
24224,Manglieu,63205,63,70,135,10,150,95,255,205
24225,Manzat,63206,63,152,344,88,460,276,824,496
24226,Marat,63207,63,155,158,47,250,147,444,313
24227,Marcillat,63208,63,50,50,15,85,70,170,100
24228,Mareugheol,63209,63,20,35,10,85,25,120,55
24229,Maringues,63210,63,303,721,223,727,551,1501,1024
24230,Marsac-en-Livradois,63211,63,205,290,105,625,220,950,495
24231,Marsat,63212,63,144,271,80,482,242,804,415
24232,Les Martres-d'Artière,63213,63,96,656,140,664,535,1339,752
24233,Les Martres-de-Veyre,63214,63,492,942,391,1206,748,2345,1434
24234,Martres-sur-Morge,63215,63,70,165,70,195,145,410,235
24235,Mauzun,63216,63,20,28,8,20,24,52,48
24236,Mayres,63218,63,20,32,8,100,12,120,52
24237,Mazaye,63219,63,60,190,70,273,120,463,250
24238,Mazoires,63220,63,20,35,10,40,15,65,55
24239,Medeyrolles,63221,63,19,12,13,47,6,66,31
24240,Meilhaud,63222,63,52,144,60,104,108,272,196
24241,Menat,63223,63,82,92,36,194,89,319,174
24242,Ménétrol,63224,63,140,372,135,610,259,1004,512
24243,Messeix,63225,63,258,172,60,428,158,646,430
24244,Mezel,63226,63,194,471,125,607,381,1113,665
24245,Mirefleurs,63227,63,179,680,115,809,535,1459,859
24246,Miremont,63228,63,50,28,9,135,48,192,78
24247,Moissat,63229,63,120,353,104,300,302,706,473
24248,Le Monestier,63230,63,20,45,15,90,45,150,65
24249,La Monnerie-le-Montel,63231,63,301,375,135,687,270,1092,676
24250,Mons,63232,63,35,155,30,165,130,325,190
24251,Montaigut,63233,63,135,185,130,360,95,585,320
24252,Montaigut-le-Blanc,63234,63,69,233,77,230,183,490,302
24253,Montcel,63235,63,30,130,35,190,75,300,160
24254,Mont-Dore,63236,63,168,220,128,520,248,896,388
24255,Montel-de-Gelat,63237,63,74,80,40,175,80,295,154
24256,Montfermy,63238,63,16,57,8,76,56,140,73
24257,Montmorin,63239,63,52,223,32,213,184,429,275
24258,Montpensier,63240,63,50,117,8,127,99,234,167
24259,Montpeyroux,63241,63,56,68,28,116,64,208,124
24260,Moriat,63242,63,55,85,15,135,65,215,140
24261,Moureuille,63243,63,52,76,12,96,60,168,128
24262,Chambaron sur Morge,63244,63,125,422,81,439,419,939,547
24263,Mozac,63245,63,529,852,309,1374,583,2266,1381
24264,Murat-le-Quaire,63246,63,60,85,80,175,90,345,145
24265,Murol,63247,63,88,78,46,230,68,344,166
24266,Nébouzat,63248,63,48,194,61,278,163,502,242
24267,Néronde-sur-Dore,63249,63,51,97,49,200,56,305,148
24268,Neschers,63250,63,100,236,40,268,184,492,336
24269,Neuf-Église,63251,63,31,44,12,129,43,184,75
24270,Neuville,63252,63,24,77,8,143,80,231,101
24271,Noalhat,63253,63,5,65,25,70,80,175,70
24272,Nohanent,63254,63,259,518,185,728,452,1365,777
24273,Nonette-Orsonnette,63255,63,44,108,24,188,116,328,152
24274,Novacelles,63256,63,13,23,3,35,35,73,36
24275,Olby,63257,63,105,195,30,260,180,470,300
24276,Olliergues,63258,63,114,138,41,283,91,415,252
24277,Olloix,63259,63,28,76,12,124,68,204,104
24278,Olmet,63260,63,40,32,0,72,12,84,72
24279,Orbeil,63261,63,95,205,35,310,170,515,300
24280,Orcet,63262,63,245,554,223,1111,431,1765,799
24281,Orcines,63263,63,402,762,246,1147,677,2070,1164
24282,Orcival,63264,63,26,31,26,79,36,141,57
24283,Orléat,63265,63,271,530,100,624,555,1279,801
24284,Palladuc,63267,63,60,150,15,205,120,340,210
24285,Pardines,63268,63,29,44,24,94,51,169,73
24286,Parent,63269,63,100,224,36,248,192,476,324
24287,Parentignat,63270,63,35,142,20,196,78,294,177
24288,Paslières,63271,63,124,364,112,585,284,981,488
24289,Pérignat-lès-Sarliève,63272,63,310,600,165,1100,420,1685,910
24290,Pérignat-sur-Allier,63273,63,150,360,85,585,270,940,510
24291,Perpezat,63274,63,70,115,30,95,115,240,185
24292,Perrier,63275,63,137,200,45,346,145,536,337
24293,Peschadoires,63276,63,293,403,178,845,288,1311,696
24294,Peslières,63277,63,15,10,10,25,0,35,25
24295,Pessat-Villeneuve,63278,63,47,146,63,180,117,360,193
24296,Picherande,63279,63,59,65,40,150,35,225,124
24297,Pignols,63280,63,24,104,28,84,100,212,128
24298,Pionsat,63281,63,169,155,119,335,95,549,324
24299,Plauzat,63282,63,96,463,128,406,466,1000,559
24300,Pontaumur,63283,63,79,122,35,206,91,332,201
24301,Pont-du-Château,63284,63,1113,2499,961,3704,2023,6688,3612
24302,Pontgibaud,63285,63,84,163,82,211,101,394,247
24303,Pouzol,63286,63,35,50,40,105,35,180,85
24304,Les Pradeaux,63287,63,25,90,25,93,100,218,115
24305,Prompsat,63288,63,39,85,40,175,75,290,124
24306,Prondines,63289,63,35,55,25,115,30,170,90
24307,Pulvérières,63290,63,36,92,36,148,72,256,128
24308,Puy-Guillaume,63291,63,437,557,154,856,483,1493,994
24309,Puy-Saint-Gulmier,63292,63,28,25,16,33,16,65,53
24310,Le Quartier,63293,63,50,10,15,115,10,140,60
24311,Queuille,63294,63,29,65,15,105,55,175,94
24312,Randan,63295,63,170,300,160,480,240,880,470
24313,Ravel,63296,63,96,168,68,188,164,420,264
24314,Reignat,63297,63,21,107,36,95,87,218,128
24315,La Renaudie,63298,63,50,0,9,30,6,45,50
24316,Rentières,63299,63,20,20,10,50,25,85,40
24317,Riom,63300,63,2318,4232,2072,6006,3357,11435,6550
24318,Ris,63301,63,76,168,60,300,160,520,244
24319,La Roche-Blanche,63302,63,447,669,250,1158,498,1906,1116
24320,Roche-Charles-la-Mayrand,63303,63,5,5,15,10,0,25,10
24321,Roche-d'Agoux,63304,63,20,5,15,45,5,65,25
24322,Rochefort-Montagne,63305,63,176,152,84,240,104,428,328
24323,La Roche-Noire,63306,63,35,135,65,260,110,435,170
24324,Romagnat,63307,63,1354,1570,577,2908,1206,4691,2924
24325,Royat,63308,63,613,957,540,1712,835,3087,1570
24326,Saillant,63309,63,45,60,10,142,35,187,105
24327,Sainte-Agathe,63310,63,36,28,16,84,40,140,64
24328,Saint-Agoulin,63311,63,29,73,44,77,70,191,102
24329,Saint-Alyre-d'Arlanc,63312,63,31,17,8,73,8,89,48
24330,Saint-Alyre-ès-Montagne,63313,63,45,15,10,45,15,70,60
24331,Saint-Amant-Roche-Savine,63314,63,80,85,45,200,80,325,165
24332,Saint-Amant-Tallende,63315,63,216,448,112,484,420,1016,664
24333,Saint-André-le-Coq,63317,63,72,109,48,97,122,267,181
24334,Saint-Angel,63318,63,40,105,30,115,100,245,145
24335,Saint-Anthème,63319,63,180,90,39,265,105,409,270
24336,Saint-Avit,63320,63,39,45,15,100,45,160,84
24337,Saint-Babel,63321,63,120,230,75,275,210,560,350
24338,Saint-Beauzire,63322,63,208,550,112,764,486,1362,758
24339,Saint-Bonnet-le-Bourg,63323,63,16,23,3,43,22,68,39
24340,Saint-Bonnet-le-Chastel,63324,63,71,6,15,65,9,89,77
24341,Saint-Bonnet-lès-Allier,63325,63,24,95,35,139,130,304,119
24342,Saint-Bonnet-près-Orcival,63326,63,69,95,20,174,114,308,164
24343,Saint-Bonnet-près-Riom,63327,63,130,583,135,753,470,1358,713
24344,Sainte-Catherine,63328,63,22,3,3,9,3,15,25
24345,Sainte-Christine,63329,63,10,10,5,80,15,100,20
24346,Saint-Cirgues-sur-Couze,63330,63,32,100,20,124,76,220,132
24347,Saint-Clément-de-Valorgue,63331,63,27,39,3,89,35,127,66
24348,Saint-Clément-de-Régnat,63332,63,80,101,66,157,69,292,181
24349,Saint-Denis-Combarnazat,63333,63,30,56,4,64,55,123,86
24350,Saint-Dier-d'Auvergne,63334,63,50,115,35,220,109,364,165
24351,Saint-Diéry,63335,63,40,92,36,136,96,268,132
24352,Saint-Donat,63336,63,15,32,10,110,36,156,47
24353,Saint-Éloy-la-Glacière,63337,63,0,20,0,25,20,45,20
24354,Saint-Éloy-les-Mines,63338,63,755,675,206,1380,491,2077,1430
24355,Saint-Étienne-des-Champs,63339,63,20,40,5,70,15,90,60
24356,Saint-Étienne-sur-Usson,63340,63,40,50,35,120,45,200,90
24357,Saint-Ferréol-des-Côtes,63341,63,104,87,34,196,52,282,191
24358,Saint-Floret,63342,63,30,50,35,90,45,170,80
24359,Saint-Flour,63343,63,39,48,20,90,39,149,87
24360,Saint-Gal-sur-Sioule,63344,63,8,29,0,61,20,81,37
24361,Saint-Genès-Champanelle,63345,63,271,870,238,1211,701,2150,1141
24362,Saint-Genès-Champespe,63346,63,27,26,12,90,35,137,53
24363,Saint-Genès-du-Retz,63347,63,40,115,30,200,125,355,155
24364,Saint-Genès-la-Tourette,63348,63,24,14,19,59,29,107,38
24365,Saint-Georges-de-Mons,63349,63,371,394,161,710,317,1188,765
24366,Saint-Georges-sur-Allier,63350,63,64,319,80,428,325,833,383
24367,Saint-Germain-près-Herment,63351,63,8,4,8,32,4,44,12
24368,Saint-Germain-Lembron,63352,63,236,443,124,561,410,1095,679
24369,Saint-Germain-l'Herm,63353,63,110,87,12,128,62,202,197
24370,Saint-Gervais-d'Auvergne,63354,63,240,213,142,407,147,696,453
24371,Saint-Gervais-sous-Meymont,63355,63,55,40,10,105,35,150,95
24372,Saint-Gervazy,63356,63,36,72,16,84,60,160,108
24373,Saint-Hérent,63357,63,8,20,12,37,8,57,28
24374,Saint-Hilaire-la-Croix,63358,63,16,71,18,112,71,201,87
24375,Saint-Hilaire-les-Monges,63359,63,9,23,9,18,15,42,32
24376,Saint-Hilaire,63360,63,55,20,10,60,15,85,75
24377,Saint-Ignat,63362,63,115,200,36,281,146,463,315
24378,Saint-Jacques-d'Ambur,63363,63,63,34,13,82,42,137,97
24379,Saint-Jean-d'Heurs,63364,63,40,130,16,161,113,290,170
24380,Saint-Jean-des-Ollières,63365,63,43,94,24,147,62,233,137
24381,Saint-Jean-en-Val,63366,63,40,80,32,132,88,252,120
24382,Saint-Jean-Saint-Gervais,63367,63,20,20,25,40,5,70,40
24383,Saint-Julien-de-Coppel,63368,63,116,316,64,452,240,756,432
24384,Saint-Julien-la-Geneste,63369,63,20,20,15,50,25,90,40
24385,Saint-Julien-Puy-Lavèze,63370,63,60,90,30,140,50,220,150
24386,Saint-Just,63371,63,60,25,5,45,25,75,85
24387,Saint-Laure,63372,63,40,188,68,152,180,400,228
24388,Saint-Maigner,63373,63,44,36,12,92,24,128,80
24389,Saint-Martin-des-Olmes,63374,63,25,56,25,108,38,171,81
24390,Saint-Martin-des-Plains,63375,63,4,20,4,59,25,88,24
24391,Saint-Martin-d'Ollières,63376,63,10,45,15,68,10,93,55
24392,Saint-Maurice-près-Pionsat,63377,63,88,64,4,156,60,220,152
24393,Saint-Maurice,63378,63,100,194,95,269,165,529,294
24394,Saint-Myon,63379,63,70,125,40,150,100,290,195
24395,Saint-Nectaire,63380,63,70,120,51,237,114,402,190
24396,Saint-Ours,63381,63,160,384,112,560,336,1008,544
24397,Saint-Pardoux,63382,63,65,95,40,165,45,250,160
24398,Saint-Pierre-Colamine,63383,63,32,60,8,104,36,148,92
24399,Saint-Pierre-la-Bourlhonne,63384,63,30,15,5,50,15,70,45
24400,Saint-Pierre-le-Chastel,63385,63,30,130,45,115,115,275,160
24401,Saint-Pierre-Roche,63386,63,49,90,31,90,95,216,139
24402,Saint-Priest-Bramefant,63387,63,105,200,70,315,165,550,305
24403,Saint-Priest-des-Champs,63388,63,96,127,30,256,64,350,223
24404,Saint-Quentin-sur-Sauxillanges,63389,63,25,16,4,33,8,45,41
24405,Saint-Quintin-sur-Sioule,63390,63,58,64,13,149,43,205,122
24406,Saint-Rémy-de-Blot,63391,63,50,45,10,45,85,140,95
24407,Saint-Rémy-de-Chargnat,63392,63,55,121,42,206,75,323,176
24408,Saint-Rémy-sur-Durolle,63393,63,350,375,95,610,350,1055,725
24409,Saint-Romain,63394,63,49,55,5,65,40,110,104
24410,Saint-Sandoux,63395,63,55,280,60,260,240,560,335
24411,Saint-Saturnin,63396,63,102,273,61,373,249,683,375
24412,Saint-Sauves-d'Auvergne,63397,63,220,189,52,385,183,620,409
24413,Saint-Sauveur-la-Sagne,63398,63,40,5,10,35,10,55,45
24414,Saint-Sulpice,63399,63,12,0,3,46,6,55,12
24415,Saint-Sylvestre-Pragoulin,63400,63,135,255,60,420,210,690,390
24416,Saint-Victor-la-Rivière,63401,63,53,56,4,83,25,112,109
24417,Saint-Victor-Montvianeix,63402,63,12,37,36,69,46,151,49
24418,Saint-Vincent,63403,63,33,110,18,148,70,236,143
24419,Saint-Yvoine,63404,63,43,132,34,169,131,334,175
24420,Sallèdes,63405,63,60,140,65,160,160,385,200
24421,Sardon,63406,63,30,90,25,95,80,200,120
24422,Saulzet-le-Froid,63407,63,39,39,30,57,49,136,78
24423,Sauret-Besserve,63408,63,35,30,15,45,45,105,65
24424,Saurier,63409,63,21,56,25,76,32,133,77
24425,Sauvagnat,63410,63,35,25,10,40,35,85,60
24426,Sauvagnat-Sainte-Marthe,63411,63,35,121,75,140,107,322,156
24427,Sauvessanges,63412,63,85,95,28,174,77,279,180
24428,La Sauvetat,63413,63,129,134,62,182,134,378,263
24429,Sauviat,63414,63,63,126,21,183,100,304,189
24430,Sauxillanges,63415,63,129,244,133,435,214,782,373
24431,Savennes,63416,63,20,4,4,34,8,46,24
24432,Sayat,63417,63,345,465,165,911,275,1351,810
24433,Sermentizon,63418,63,72,120,44,196,144,384,192
24434,Servant,63419,63,113,99,24,158,83,265,212
24435,Seychalles,63420,63,44,216,58,193,163,414,260
24436,Singles,63421,63,40,15,5,95,5,105,55
24437,Solignat,63422,63,85,109,35,173,95,303,194
24438,Sugères,63423,63,104,132,28,180,144,352,236
24439,Surat,63424,63,43,143,48,185,104,337,186
24440,Tallende,63425,63,99,427,79,527,334,940,526
24441,Tauves,63426,63,148,172,24,308,116,448,320
24442,Teilhède,63427,63,48,100,36,160,76,272,148
24443,Teilhet,63428,63,56,72,24,104,48,176,128
24444,Ternant-les-Eaux,63429,63,0,16,0,12,20,32,16
24445,Thiers,63430,63,1767,2374,1259,3769,1944,6972,4141
24446,Thiolières,63431,63,25,29,3,39,36,78,54
24447,Thuret,63432,63,25,300,70,283,235,588,325
24448,Tortebesse,63433,63,4,24,0,24,12,36,28
24449,Tours-sur-Meymont,63434,63,85,90,35,225,85,345,175
24450,Tourzel-Ronzières,63435,63,45,60,20,95,50,165,105
24451,Tralaigues,63436,63,8,24,16,40,8,64,32
24452,Trémouille-Saint-Loup,63437,63,24,20,0,64,20,84,44
24453,Trézioux,63438,63,45,110,30,190,80,300,155
24454,Usson,63439,63,20,72,12,80,76,168,92
24455,Valbeleix,63440,63,20,35,30,30,25,85,55
24456,Valcivières,63441,63,45,40,25,80,25,130,85
24457,Valz-sous-Châteauneuf,63442,63,10,15,5,25,5,35,25
24458,Varennes-sur-Morge,63443,63,30,115,30,140,100,270,145
24459,Varennes-sur-Usson,63444,63,8,71,22,58,71,151,79
24460,Vassel,63445,63,20,89,8,49,71,128,109
24461,Vensat,63446,63,64,108,28,154,112,294,172
24462,Vergheas,63447,63,45,0,0,20,0,20,45
24463,Vernet-la-Varenne,63448,63,120,121,50,207,106,363,241
24464,Le Vernet-Sainte-Marguerite,63449,63,15,65,5,120,85,210,80
24465,Verneugheol,63450,63,45,55,0,85,45,130,100
24466,Vernines,63451,63,55,75,65,130,75,270,130
24467,Verrières,63452,63,10,15,5,35,10,50,25
24468,Vertaizon,63453,63,220,905,252,798,842,1892,1125
24469,Vertolaye,63454,63,69,93,25,205,82,312,162
24470,Veyre-Monton,63455,63,378,659,209,1477,587,2273,1037
24471,Vichel,63456,63,21,123,30,70,73,173,144
24472,Vic-le-Comte,63457,63,509,1264,407,1790,845,3042,1773
24473,Villeneuve,63458,63,20,55,15,50,35,100,75
24474,Villeneuve-les-Cerfs,63459,63,31,113,41,116,110,267,144
24475,Villosanges,63460,63,65,55,26,93,43,162,120
24476,Vinzelles,63461,63,38,58,8,139,58,205,96
24477,Virlet,63462,63,30,50,5,100,45,150,80
24478,Viscomtat,63463,63,78,71,25,255,61,341,149
24479,Vitrac,63464,63,49,78,4,98,77,179,127
24480,Viverols,63465,63,30,60,20,210,50,280,90
24481,Vodable,63466,63,30,35,0,85,40,125,65
24482,Voingt,63467,63,18,6,6,12,0,18,24
24483,Vollore-Montagne,63468,63,76,35,4,97,46,147,111
24484,Vollore-Ville,63469,63,124,184,28,304,120,452,308
24485,Volvic,63470,63,410,1060,425,1451,837,2713,1470
24486,Youx,63471,63,171,132,89,357,104,550,303
24487,Yronde-et-Buron,63472,63,85,135,80,240,140,460,220
24488,Yssac-la-Tourette,63473,63,36,100,32,120,84,236,136
24489,Aast,64001,64,16,35,0,53,40,93,51
24490,Abère,64002,64,8,35,12,41,33,86,43
24491,Abidos,64003,64,32,76,12,64,52,128,108
24492,Abitain,64004,64,10,13,0,30,15,45,23
24493,Abos,64005,64,76,114,48,152,90,290,190
24494,Accous,64006,64,72,88,12,140,84,236,160
24495,Agnos,64007,64,121,199,101,357,163,621,320
24496,Ahaxe-Alciette-Bascassan,64008,64,40,65,10,95,55,160,105
24497,Ahetze,64009,64,181,469,177,630,429,1236,650
24498,Aïcirits-Camou-Suhast,64010,64,150,106,17,244,99,360,256
24499,Aincille,64011,64,10,35,10,39,20,69,45
24500,Ainharp,64012,64,16,30,12,50,4,66,46
24501,Ainhice-Mongelos,64013,64,33,26,12,28,32,72,59
24502,Ainhoa,64014,64,75,170,55,194,170,419,245
24503,Alçay-Alçabéhéty-Sunharette,64015,64,80,50,5,50,45,100,130
24504,Aldudes,64016,64,67,27,44,106,30,180,94
24505,Alos-Sibas-Abense,64017,64,68,48,28,108,44,180,116
24506,Amendeuix-Oneix,64018,64,88,112,20,176,56,252,200
24507,Amorots-Succos,64019,64,56,56,8,52,60,120,112
24508,Ance,64020,64,56,44,8,84,28,120,100
24509,Andoins,64021,64,60,180,40,180,160,380,240
24510,Andrein,64022,64,15,20,10,60,20,90,35
24511,Angaïs,64023,64,84,196,80,352,136,568,280
24512,Anglet,64024,64,7143,7020,3720,13094,6888,23702,14163
24513,Angous,64025,64,30,25,0,30,20,50,55
24514,Anhaux,64026,64,44,96,24,116,104,244,140
24515,Anos,64027,64,9,46,10,51,34,95,55
24516,Anoye,64028,64,12,48,16,52,36,104,60
24517,Aramits,64029,64,139,98,40,181,96,317,237
24518,Arancou,64031,64,25,35,15,40,40,95,60
24519,Araujuzon,64032,64,36,52,12,60,40,112,88
24520,Araux,64033,64,0,45,20,30,40,90,45
24521,Arbérats-Sillègue,64034,64,40,60,20,95,50,165,100
24522,Arbonne,64035,64,195,489,145,747,394,1286,684
24523,Arbouet-Sussaute,64036,64,40,86,17,88,56,161,126
24524,Arbus,64037,64,96,310,80,405,220,705,406
24525,Arcangues,64038,64,481,668,165,1134,659,1958,1149
24526,Aren,64039,64,15,65,50,80,35,165,80
24527,Arette,64040,64,197,176,74,301,186,561,373
24528,Aressy,64041,64,105,153,35,193,158,386,258
24529,Argagnon,64042,64,120,135,65,285,90,440,255
24530,Argelos,64043,64,19,57,9,77,37,123,76
24531,Arget,64044,64,10,25,5,40,10,55,35
24532,Arhansus,64045,64,20,12,4,28,4,36,32
24533,Armendarits,64046,64,36,104,60,132,68,260,140
24534,Arnéguy,64047,64,29,47,33,72,30,135,76
24535,Arnos,64048,64,8,20,20,24,12,56,28
24536,Aroue-Ithorots-Olhaïby,64049,64,30,45,10,100,45,155,75
24537,Arrast-Larrebieu,64050,64,15,0,15,50,10,75,15
24538,Arraute-Charritte,64051,64,100,80,20,100,80,200,180
24539,Arricau-Bordes,64052,64,20,10,10,45,10,65,30
24540,Arrien,64053,64,17,31,8,50,43,101,48
24541,Arros-de-Nay,64054,64,90,161,80,355,100,535,251
24542,Arrosès,64056,64,40,20,5,70,5,80,60
24543,Arthez-de-Béarn,64057,64,253,490,110,573,359,1042,743
24544,Arthez-d'Asson,64058,64,64,99,64,211,63,338,163
24545,Artigueloutan,64059,64,66,301,24,303,247,574,367
24546,Artiguelouve,64060,64,168,438,72,577,296,945,606
24547,Artix,64061,64,611,765,251,1020,704,1975,1376
24548,Arudy,64062,64,489,398,142,807,304,1253,887
24549,Arzacq-Arraziguet,64063,64,137,255,155,299,195,649,392
24550,Asasp-Arros,64064,64,64,80,52,232,52,336,144
24551,Ascain,64065,64,533,901,436,1491,779,2706,1434
24552,Ascarat,64066,64,16,85,8,103,57,168,101
24553,Assat,64067,64,224,504,116,568,380,1064,728
24554,Asson,64068,64,240,540,185,705,365,1255,780
24555,Aste-Béon,64069,64,20,40,45,85,50,180,60
24556,Astis,64070,64,30,75,25,120,55,200,105
24557,Athos-Aspis,64071,64,33,20,12,94,20,126,53
24558,Aubertin,64072,64,90,120,40,304,75,419,210
24559,Aubin,64073,64,10,65,10,95,60,165,75
24560,Aubous,64074,64,32,0,0,12,8,20,32
24561,Audaux,64075,64,15,37,7,45,33,85,52
24562,Auga,64077,64,35,40,0,40,35,75,75
24563,Auriac,64078,64,24,56,12,84,60,156,80
24564,Aurions-Idernes,64079,64,7,6,14,48,12,74,13
24565,Aussevielle,64080,64,8,260,52,304,148,504,268
24566,Aussurucq,64081,64,40,40,15,95,50,160,80
24567,Auterrive,64082,64,12,12,8,63,17,88,24
24568,Autevielle-Saint-Martin-Bideren,64083,64,36,56,8,64,52,124,92
24569,Aydie,64084,64,28,12,12,48,20,80,40
24570,Aydius,64085,64,12,24,4,21,28,53,36
24571,Ayherre,64086,64,136,238,93,317,159,569,374
24572,Baigts-de-Béarn,64087,64,78,225,60,274,165,499,303
24573,Balansun,64088,64,31,63,0,79,86,165,94
24574,Baleix,64089,64,10,45,15,60,15,90,55
24575,Baliracq-Maumusson,64090,64,55,15,20,35,20,75,70
24576,Baliros,64091,64,61,86,8,134,108,250,147
24577,Banca,64092,64,62,42,19,88,48,155,104
24578,Barcus,64093,64,101,121,58,263,64,385,222
24579,Bardos,64094,64,250,390,150,605,280,1035,640
24580,Barinque,64095,64,40,184,56,176,156,388,224
24581,Barraute-Camu,64096,64,20,35,0,55,33,88,55
24582,Barzun,64097,64,45,135,55,260,105,420,180
24583,Bassillon-Vauzé,64098,64,12,10,3,18,6,27,22
24584,Bastanès,64099,64,20,20,10,50,20,80,40
24585,Bassussarry,64100,64,234,550,264,1070,464,1798,784
24586,Baudreix,64101,64,32,133,82,117,106,305,165
24587,Bayonne,64102,64,6356,9859,6512,13871,9859,30242,16215
24588,Bédeille,64103,64,10,45,15,85,58,158,55
24589,Bedous,64104,64,76,86,21,222,89,332,162
24590,Béguios,64105,64,28,44,8,112,56,176,72
24591,Béhasque-Lapiste,64106,64,75,123,29,184,42,255,198
24592,Béhorléguy,64107,64,12,16,4,16,8,28,28
24593,Bellocq,64108,64,100,225,90,285,175,550,325
24594,Bénéjacq,64109,64,284,464,136,628,416,1180,748
24595,Béost,64110,64,60,28,28,80,4,112,88
24596,Bentayou-Sérée,64111,64,22,34,8,20,26,54,56
24597,Bérenx,64112,64,88,60,36,164,84,284,148
24598,Bergouey-Viellenave,64113,64,35,25,0,35,20,55,60
24599,Bernadets,64114,64,80,145,20,200,120,340,225
24600,Berrogain-Laruns,64115,64,16,20,0,60,20,80,36
24601,Bescat,64116,64,34,55,20,125,45,190,89
24602,Bésingrand,64117,64,12,30,10,37,20,67,42
24603,Bétracq,64118,64,25,0,5,10,0,15,25
24604,Beuste,64119,64,86,118,56,187,90,333,204
24605,Beyrie-sur-Joyeuse,64120,64,65,112,51,139,102,292,177
24606,Beyrie-en-Béarn,64121,64,12,52,20,52,60,132,64
24607,Biarritz,64122,64,6675,3450,2004,8286,3734,14024,10125
24608,Bidache,64123,64,157,323,63,414,287,764,480
24609,Bidarray,64124,64,108,160,60,236,128,424,268
24610,Bidart,64125,64,672,1269,721,2261,1344,4326,1941
24611,Bidos,64126,64,315,181,70,415,165,650,496
24612,Bielle,64127,64,105,55,0,171,55,226,160
24613,Bilhères,64128,64,10,30,0,90,30,120,40
24614,Billère,64129,64,1922,2683,1885,4025,2518,8428,4605
24615,Biriatou,64130,64,88,318,76,416,289,781,406
24616,Biron,64131,64,65,150,45,180,110,335,215
24617,Bizanos,64132,64,876,944,389,1548,799,2736,1820
24618,Boeil-Bezing,64133,64,128,358,67,405,239,711,486
24619,Bonloc,64134,64,32,116,20,128,72,220,148
24620,Bonnut,64135,64,80,160,68,276,156,500,240
24621,Borce,64136,64,20,20,0,45,25,70,40
24622,Bordères,64137,64,75,120,70,278,85,433,195
24623,Bordes,64138,64,179,811,205,837,568,1610,990
24624,Bosdarros,64139,64,125,240,50,390,210,650,365
24625,Boucau,64140,64,1019,1802,591,2771,1498,4860,2821
24626,Boueilh-Boueilho-Lasque,64141,64,65,60,20,120,70,210,125
24627,Bougarber,64142,64,64,235,36,295,190,521,299
24628,Bouillon,64143,64,15,35,10,60,25,95,50
24629,Boumourt,64144,64,8,44,4,64,24,92,52
24630,Bourdettes,64145,64,52,139,40,145,114,299,191
24631,Bournos,64146,64,30,95,10,140,60,210,125
24632,Briscous,64147,64,208,648,232,904,584,1720,856
24633,Bruges-Capbis-Mifaget,64148,64,165,200,65,330,145,540,365
24634,Bugnein,64149,64,43,43,9,49,23,81,86
24635,Bunus,64150,64,15,25,10,70,10,90,40
24636,Burgaronne,64151,64,0,50,10,35,25,70,50
24637,Buros,64152,64,153,431,143,717,296,1156,584
24638,Burosse-Mendousse,64153,64,0,8,4,24,16,44,8
24639,Bussunarits-Sarrasquette,64154,64,12,33,4,72,44,120,45
24640,Bustince-Iriberry,64155,64,9,9,9,25,12,46,18
24641,Buziet,64156,64,40,118,40,169,101,310,158
24642,Buzy,64157,64,193,234,35,341,175,551,427
24643,Cabidos,64158,64,52,52,8,36,32,76,104
24644,Cadillon,64159,64,16,12,8,44,12,64,28
24645,Cambo-les-Bains,64160,64,858,1224,582,1815,1148,3545,2082
24646,Came,64161,64,112,226,44,286,220,550,338
24647,Camou-Cihigue,64162,64,25,6,10,32,9,51,31
24648,Cardesse,64165,64,24,78,20,102,34,156,102
24649,Caro,64166,64,33,39,12,50,25,87,72
24650,Carrère,64167,64,30,55,40,75,20,135,85
24651,Carresse-Cassaber,64168,64,85,165,30,250,120,400,250
24652,Castagnède,64170,64,25,40,10,110,25,145,65
24653,Casteide-Cami,64171,64,12,48,48,52,48,148,60
24654,Casteide-Candau,64172,64,24,45,24,80,58,162,69
24655,Casteide-Doat,64173,64,20,36,16,56,28,100,56
24656,Castéra-Loubix,64174,64,15,5,0,30,5,35,20
24657,Castet,64175,64,32,28,20,52,20,92,60
24658,Castetbon,64176,64,30,35,10,65,30,105,65
24659,Castétis,64177,64,88,148,32,228,132,392,236
24660,Castetnau-Camblong,64178,64,120,120,30,120,65,215,240
24661,Castetner,64179,64,3,23,6,41,42,89,26
24662,Castetpugon,64180,64,20,52,4,66,39,109,72
24663,Castillon (Canton d'Arthez-de-Béarn),64181,64,32,76,16,124,40,180,108
24664,Castillon (Canton de Lembeye),64182,64,20,15,15,20,10,45,35
24665,Caubios-Loos,64183,64,70,115,25,195,85,305,185
24666,Cescau,64184,64,52,178,29,158,115,302,230
24667,Cette-Eygun,64185,64,10,15,0,50,5,55,25
24668,Charre,64186,64,18,12,12,95,33,140,30
24669,Charritte-de-Bas,64187,64,60,60,10,100,25,135,120
24670,Chéraute,64188,64,228,160,132,301,139,572,388
24671,Ciboure,64189,64,1469,1040,495,2432,1024,3951,2509
24672,Claracq,64190,64,30,65,5,35,85,125,95
24673,Coarraze,64191,64,309,470,209,721,286,1216,779
24674,Conchez-de-Béarn,64192,64,20,20,5,65,15,85,40
24675,Corbère-Abères,64193,64,15,15,20,50,15,85,30
24676,Coslédaà-Lube-Boast,64194,64,70,80,40,115,65,220,150
24677,Coublucq,64195,64,20,25,15,35,25,75,45
24678,Crouseilles,64196,64,30,5,5,60,10,75,35
24679,Cuqueron,64197,64,12,48,20,72,44,136,60
24680,Denguin,64198,64,180,460,120,640,335,1095,640
24681,Diusse,64199,64,48,16,0,32,8,40,64
24682,Doazon,64200,64,20,64,12,60,36,108,84
24683,Dognen,64201,64,35,25,20,74,40,134,60
24684,Domezain-Berraute,64202,64,70,150,30,175,95,300,220
24685,Doumy,64203,64,40,75,15,95,75,185,115
24686,Eaux-Bonnes,64204,64,44,46,36,167,40,243,90
24687,Escos,64205,64,50,55,0,80,50,130,105
24688,Escot,64206,64,20,29,6,25,22,53,49
24689,Escou,64207,64,29,91,34,130,84,248,120
24690,Escoubès,64208,64,24,118,16,93,117,226,142
24691,Escout,64209,64,54,77,39,166,55,260,131
24692,Escurès,64210,64,8,48,8,56,40,104,56
24693,Eslourenties-Daban,64211,64,20,88,24,72,92,188,108
24694,Espéchède,64212,64,20,36,12,52,36,100,56
24695,Espelette,64213,64,256,529,180,716,406,1302,785
24696,Espès-Undurein,64214,64,120,96,36,193,76,305,216
24697,Espiute,64215,64,12,12,0,24,8,32,24
24698,Espoey,64216,64,173,274,100,340,179,619,447
24699,Esquiule,64217,64,55,110,15,235,110,360,165
24700,Estérençuby,64218,64,40,95,20,105,90,215,135
24701,Estialescq,64219,64,25,70,15,110,55,180,95
24702,Estos,64220,64,58,100,21,224,91,336,158
24703,Etcharry,64221,64,12,20,6,35,28,69,32
24704,Etchebar,64222,64,15,5,5,15,20,40,20
24705,Etsaut,64223,64,12,16,0,40,16,56,28
24706,Eysus,64224,64,110,123,50,265,103,418,233
24707,Féas,64225,64,40,50,35,170,55,260,90
24708,Fichous-Riumayou,64226,64,50,35,5,40,35,80,85
24709,Gabaston,64227,64,85,160,49,235,119,403,245
24710,Gabat,64228,64,15,53,13,74,43,130,68
24711,Gamarthe,64229,64,18,32,3,28,12,43,50
24712,Gan,64230,64,814,1294,390,1725,1082,3197,2108
24713,Garindein,64231,64,105,85,40,205,65,310,190
24714,Garlède-Mondebat,64232,64,45,70,5,60,45,110,115
24715,Garlin,64233,64,190,304,125,398,274,797,494
24716,Garos,64234,64,36,68,8,72,52,132,104
24717,Garris,64235,64,86,86,20,65,55,140,172
24718,Gayon,64236,64,15,0,3,21,0,24,15
24719,Gelos,64237,64,565,728,343,1156,577,2076,1293
24720,Ger,64238,64,275,415,150,690,345,1185,690
24721,Gerderest,64239,64,8,28,8,28,44,80,36
24722,Gère-Bélesten,64240,64,49,36,16,80,20,116,85
24723,Géronce,64241,64,60,105,50,155,75,280,165
24724,Gestas,64242,64,6,10,0,26,9,35,16
24725,Géus-d'Arzacq,64243,64,4,68,44,40,44,128,72
24726,Geüs-d'Oloron,64244,64,24,48,24,104,44,172,72
24727,Goès,64245,64,77,146,21,207,112,340,223
24728,Gomer,64246,64,25,105,10,90,85,185,130
24729,Gotein-Libarrenx,64247,64,61,95,20,171,88,279,156
24730,Guéthary,64249,64,163,225,118,395,203,716,388
24731,Guiche,64250,64,100,252,92,344,144,580,352
24732,Guinarthe-Parenties,64251,64,24,47,12,57,55,124,71
24733,Gurmençon,64252,64,165,200,50,250,150,450,365
24734,Gurs,64253,64,80,100,36,140,68,244,180
24735,Hagetaubin,64254,64,44,196,8,212,128,348,240
24736,Halsou,64255,64,32,98,48,252,121,421,130
24737,Hasparren,64256,64,699,1417,729,2045,1241,4015,2116
24738,Haut-de-Bosdarros,64257,64,34,81,4,109,75,188,115
24739,Haux,64258,64,10,10,5,44,14,63,20
24740,Hélette,64259,64,55,175,75,280,130,485,230
24741,Hendaye,64260,64,2020,3624,1340,5478,3704,10522,5644
24742,Herrère,64261,64,72,83,44,109,68,221,155
24743,Higuères-Souye,64262,64,25,65,25,135,30,190,90
24744,L'Hôpital-d'Orion,64263,64,15,25,10,80,25,115,40
24745,L'Hôpital-Saint-Blaise,64264,64,20,20,0,20,5,25,40
24746,Hosta,64265,64,5,15,5,25,25,55,20
24747,Hours,64266,64,34,66,25,20,68,113,100
24748,Ibarrolle,64267,64,16,20,0,18,16,34,36
24749,Idaux-Mendy,64268,64,37,45,23,84,31,138,82
24750,Idron,64269,64,474,1220,307,1695,843,2845,1694
24751,Igon,64270,64,92,244,28,280,212,520,336
24752,Iholdy,64271,64,70,135,35,160,100,295,205
24753,Ilharre,64272,64,25,45,5,55,30,90,70
24754,Irissarry,64273,64,88,240,72,236,208,516,328
24755,Irouléguy,64274,64,48,108,24,116,84,224,156
24756,Ispoure,64275,64,126,112,41,189,84,314,238
24757,Issor,64276,64,42,23,23,71,31,125,65
24758,Isturits,64277,64,25,135,25,130,105,260,160
24759,Itxassou,64279,64,292,478,144,657,378,1179,770
24760,Izeste,64280,64,145,75,44,100,70,214,220
24761,Jasses,64281,64,15,25,5,75,30,110,40
24762,Jatxou,64282,64,65,323,85,420,225,730,388
24763,Jaxu,64283,64,25,35,15,85,25,125,60
24764,Jurançon,64284,64,1176,1375,696,2500,1168,4364,2551
24765,Juxue,64285,64,25,44,20,49,25,94,69
24766,Laà-Mondrans,64286,64,88,76,8,176,56,240,164
24767,Laàs,64287,64,25,15,10,50,20,80,40
24768,Labastide-Cézéracq,64288,64,25,135,65,183,103,351,160
24769,La Bastide-Clairence,64289,64,110,227,85,351,188,624,337
24770,Labastide-Monréjeau,64290,64,68,190,52,145,135,332,258
24771,Labastide-Villefranche,64291,64,64,84,16,128,52,196,148
24772,Labatmale,64292,64,24,42,21,76,43,140,66
24773,Labatut,64293,64,20,35,5,85,25,115,55
24774,Labets-Biscay,64294,64,28,26,12,45,20,77,54
24775,Labeyrie,64295,64,8,27,0,41,22,63,35
24776,Lacadée,64296,64,28,40,12,44,40,96,68
24777,Lacarre,64297,64,20,45,0,45,55,100,65
24778,Lacarry-Arhan-Charritte-de-Haut,64298,64,21,27,9,28,23,60,48
24779,Lacommande,64299,64,5,60,20,105,40,165,65
24780,Lacq,64300,64,83,158,37,255,118,410,241
24781,Lagor,64301,64,215,225,120,425,190,735,440
24782,Lagos,64302,64,62,89,24,162,56,242,151
24783,Laguinge-Restoue,64303,64,33,48,3,47,29,79,81
24784,Lahonce,64304,64,268,507,186,828,399,1413,775
24785,Lahontan,64305,64,80,104,24,172,84,280,184
24786,Lahourcade,64306,64,120,135,55,285,110,450,255
24787,Lalongue,64307,64,20,55,10,80,40,130,75
24788,Lalonquette,64308,64,20,70,20,105,50,175,90
24789,Lamayou,64309,64,22,30,12,57,39,108,52
24790,Lanne-en-Barétous,64310,64,100,85,30,190,60,280,185
24791,Lannecaube,64311,64,45,15,10,45,30,85,60
24792,Lanneplaà,64312,64,30,95,0,95,70,165,125
24793,Lantabat,64313,64,18,78,26,96,29,151,96
24794,Larceveau-Arros-Cibits,64314,64,60,80,10,140,90,240,140
24795,Laroin,64315,64,129,204,108,316,213,637,333
24796,Larrau,64316,64,32,28,20,64,24,108,60
24797,Larressore,64317,64,138,482,168,616,392,1176,620
24798,Larreule,64318,64,27,30,25,25,41,91,57
24799,Larribar-Sorhapuru,64319,64,36,40,12,72,24,108,76
24800,Laruns,64320,64,234,138,97,423,152,672,372
24801,Lasclaveries,64321,64,55,50,20,80,30,130,105
24802,Lasse,64322,64,48,72,24,108,60,192,120
24803,Lasserre,64323,64,10,20,20,45,10,75,30
24804,Lasseube,64324,64,255,465,105,585,330,1020,720
24805,Lasseubetat,64325,64,32,48,4,60,52,116,80
24806,Lay-Lamidou,64326,64,28,32,8,32,24,64,60
24807,Lecumberry,64327,64,28,30,9,59,27,95,58
24808,Ledeuix,64328,64,144,220,60,428,188,676,364
24809,Lée,64329,64,72,384,68,484,267,819,456
24810,Lées-Athas,64330,64,30,56,25,80,55,160,86
24811,Lembeye,64331,64,192,168,56,256,136,448,360
24812,Lème,64332,64,35,40,25,35,25,85,75
24813,Léren,64334,64,18,44,12,77,19,108,62
24814,Lescar,64335,64,1158,2303,1021,3522,1549,6092,3461
24815,Lescun,64336,64,64,24,8,72,16,96,88
24816,Lespielle,64337,64,35,15,5,69,10,84,50
24817,Lespourcy,64338,64,32,60,0,48,52,100,92
24818,Lestelle-Bétharram,64339,64,136,220,64,240,132,436,356
24819,Lichans-Sunhar,64340,64,16,12,4,24,8,36,28
24820,Lichos,64341,64,16,23,9,39,17,65,39
24821,Licq-Athérey,64342,64,45,41,20,50,50,120,86
24822,Limendous,64343,64,70,194,8,152,150,310,264
24823,Livron,64344,64,40,113,30,115,123,268,153
24824,Lohitzun-Oyhercq,64345,64,20,35,16,77,4,97,55
24825,Lombia,64346,64,25,50,10,75,50,135,75
24826,Lonçon,64347,64,10,75,5,55,60,120,85
24827,Lons,64348,64,1547,2728,1369,4382,2005,7756,4275
24828,Loubieng,64349,64,77,124,28,126,92,246,201
24829,Louhossoa,64350,64,60,263,100,244,218,562,323
24830,Lourdios-Ichère,64351,64,16,36,12,68,20,100,52
24831,Lourenties,64352,64,25,90,45,105,70,220,115
24832,Louvie-Juzon,64353,64,175,240,25,445,195,665,415
24833,Louvie-Soubiron,64354,64,12,16,4,60,20,84,28
24834,Louvigny,64355,64,15,25,25,35,25,85,40
24835,Luc-Armau,64356,64,24,28,8,40,16,64,52
24836,Lucarré,64357,64,0,10,0,15,20,35,10
24837,Lucgarier,64358,64,35,27,40,96,30,166,62
24838,Lucq-de-Béarn,64359,64,150,190,60,355,175,590,340
24839,Lurbe-Saint-Christau,64360,64,40,25,20,80,10,110,65
24840,Lussagnet-Lusson,64361,64,40,45,0,45,30,75,85
24841,Luxe-Sumberraute,64362,64,40,92,16,112,52,180,132
24842,Lys,64363,64,92,72,28,88,64,180,164
24843,Macaye,64364,64,79,125,38,156,93,287,204
24844,Malaussanne,64365,64,46,76,25,137,67,229,122
24845,Mascaraàs-Haron,64366,64,45,20,15,40,20,75,65
24846,Maslacq,64367,64,152,240,68,252,204,524,392
24847,Masparraute,64368,64,30,80,0,53,80,133,110
24848,Maspie-Lalonquère-Juillacq,64369,64,30,60,5,125,25,155,90
24849,Maucor,64370,64,36,99,30,155,84,269,135
24850,Mauléon-Licharre,64371,64,656,493,233,1054,355,1642,1149
24851,Maure,64372,64,5,20,0,34,40,74,25
24852,Mazères-Lezons,64373,64,277,364,107,751,275,1133,641
24853,Mazerolles,64374,64,95,261,77,354,225,656,356
24854,Méharin,64375,64,24,72,20,68,72,160,96
24855,Meillon,64376,64,36,247,81,295,178,554,283
24856,Mendionde,64377,64,71,232,71,229,157,457,303
24857,Menditte,64378,64,26,35,15,53,32,100,61
24858,Mendive,64379,64,27,29,3,40,27,70,56
24859,Méracq,64380,64,48,56,4,48,72,124,104
24860,Méritein,64381,64,70,45,15,110,49,174,115
24861,Mesplède,64382,64,25,82,21,113,70,204,107
24862,Mialos,64383,64,26,22,4,12,26,42,48
24863,Miossens-Lanusse,64385,64,25,75,0,85,65,150,100
24864,Mirepeix,64386,64,176,310,94,363,253,710,486
24865,Momas,64387,64,44,148,48,156,140,344,192
24866,Momy,64388,64,15,35,5,70,15,90,50
24867,Monassut-Audiracq,64389,64,30,130,20,100,90,210,160
24868,Moncaup,64390,64,25,25,0,85,15,100,50
24869,Moncayolle-Larrory-Mendibieu,64391,64,45,65,0,150,45,195,110
24870,Moncla,64392,64,20,16,16,44,8,68,36
24871,Monein,64393,64,692,939,268,1656,787,2711,1631
24872,Monpezat,64394,64,19,13,6,25,6,37,32
24873,Monségur,64395,64,25,30,5,30,25,60,55
24874,Mont,64396,64,132,244,152,364,164,680,376
24875,Montagut,64397,64,5,40,0,55,25,80,45
24876,Montaner,64398,64,83,86,27,151,61,239,169
24877,Montardon,64399,64,225,585,145,760,458,1363,810
24878,Montaut,64400,64,185,320,55,350,205,610,505
24879,Mont-Disse,64401,64,5,15,5,35,10,50,20
24880,Montfort,64403,64,36,16,24,84,20,128,52
24881,Montory,64404,64,55,36,30,133,6,169,91
24882,Morlaàs,64405,64,506,928,420,1501,597,2518,1434
24883,Morlanne,64406,64,35,159,49,168,164,381,194
24884,Mouguerre,64407,64,435,1170,438,1889,960,3287,1605
24885,Mouhous,64408,64,4,12,16,20,8,44,16
24886,Moumour,64409,64,92,212,76,312,164,552,304
24887,Mourenx,64410,64,1343,1463,693,1914,1040,3647,2806
24888,Musculdy,64411,64,56,48,8,64,60,132,104
24889,Nabas,64412,64,5,25,5,70,10,85,30
24890,Narcastet,64413,64,82,164,64,175,177,416,246
24891,Narp,64414,64,40,25,5,35,20,60,65
24892,Navailles-Angos,64415,64,149,387,90,457,314,861,536
24893,Navarrenx,64416,64,145,235,105,332,165,602,380
24894,Nay,64417,64,570,585,343,973,496,1812,1155
24895,Noguères,64418,64,26,12,12,35,15,62,38
24896,Nousty,64419,64,105,510,119,449,430,998,615
24897,Ogenne-Camptort,64420,64,34,38,6,69,40,115,72
24898,Ogeu-les-Bains,64421,64,124,270,105,480,260,845,394
24899,Oloron-Sainte-Marie,64422,64,1906,1887,1052,3762,1544,6358,3793
24900,Oraàs,64423,64,15,45,15,70,30,115,60
24901,Ordiarp,64424,64,105,105,40,195,95,330,210
24902,Orègue,64425,64,84,72,88,152,80,320,156
24903,Orin,64426,64,56,64,4,68,44,116,120
24904,Orion,64427,64,40,15,10,55,20,85,55
24905,Orriule,64428,64,35,25,5,60,25,90,60
24906,Orsanco,64429,64,0,17,4,36,21,61,17
24907,Orthez,64430,64,2057,2023,992,3511,1610,6113,4080
24908,Os-Marsillon,64431,64,40,125,75,169,125,369,165
24909,Ossas-Suhare,64432,64,16,28,4,36,16,56,44
24910,Osse-en-Aspe,64433,64,62,39,4,72,23,99,101
24911,Ossenx,64434,64,0,12,0,12,16,28,12
24912,Osserain-Rivareyte,64435,64,13,42,10,89,37,136,55
24913,Ossès,64436,64,125,201,50,355,126,531,326
24914,Ostabat-Asme,64437,64,55,25,0,85,15,100,80
24915,Ouillon,64438,64,35,160,45,165,130,340,195
24916,Ousse,64439,64,124,453,92,584,354,1030,577
24917,Ozenx-Montestrucq,64440,64,48,103,15,123,58,196,151
24918,Pagolle,64441,64,48,52,24,104,48,176,100
24919,Parbayse,64442,64,16,88,12,76,76,164,104
24920,Pardies,64443,64,181,160,85,314,120,519,341
24921,Pardies-Piétat,64444,64,68,108,24,124,92,240,176
24922,Pau,64445,64,12386,14326,12991,21614,13002,47607,26712
24923,Peyrelongue-Abos,64446,64,12,24,4,56,40,100,36
24924,Piets-Plasence-Moustrou,64447,64,35,30,10,35,28,73,65
24925,Poey-de-Lescar,64448,64,179,405,130,599,285,1014,584
24926,Poey-d'Oloron,64449,64,13,35,8,62,29,99,48
24927,Pomps,64450,64,28,85,24,72,76,172,113
24928,Ponson-Debat-Pouts,64451,64,10,35,10,20,15,45,45
24929,Ponson-Dessus,64452,64,34,73,25,106,50,181,107
24930,Pontacq,64453,64,273,672,235,916,515,1666,945
24931,Pontiacq-Viellepinte,64454,64,36,24,20,60,24,104,60
24932,Portet,64455,64,36,40,0,56,36,92,76
24933,Pouliacq,64456,64,0,12,8,4,20,32,12
24934,Poursiugues-Boucoue,64457,64,60,25,20,55,30,105,85
24935,Préchacq-Josbaig,64458,64,52,68,12,84,56,152,120
24936,Préchacq-Navarrenx,64459,64,32,36,4,60,28,92,68
24937,Précilhon,64460,64,51,87,8,124,104,236,138
24938,Puyoô,64461,64,231,265,70,392,190,652,496
24939,Ramous,64462,64,65,128,65,120,123,308,193
24940,Rébénacq,64463,64,85,155,45,235,145,425,240
24941,Ribarrouy,64464,64,25,10,5,25,10,40,35
24942,Riupeyrous,64465,64,20,44,8,60,32,100,64
24943,Rivehaute,64466,64,48,44,32,84,40,156,92
24944,Rontignon,64467,64,76,164,68,328,96,492,240
24945,Roquiague,64468,64,18,9,12,37,9,58,27
24946,Saint-Abit,64469,64,12,104,20,92,84,196,116
24947,Saint-Armou,64470,64,111,171,8,177,128,313,282
24948,Saint-Boès,64471,64,45,50,27,146,28,201,95
24949,Saint-Castin,64472,64,66,230,38,262,204,504,296
24950,Sainte-Colome,64473,64,76,80,9,73,90,172,156
24951,Saint-Dos,64474,64,36,24,12,52,24,88,60
24952,Sainte-Engrâce,64475,64,50,36,15,76,25,116,86
24953,Saint-Esteben,64476,64,60,102,20,157,75,252,162
24954,Saint-Étienne-de-Baïgorry,64477,64,277,311,100,538,260,898,588
24955,Saint-Faust,64478,64,63,180,66,276,109,451,243
24956,Saint-Girons-en-Béarn,64479,64,24,32,4,68,32,104,56
24957,Saint-Gladie-Arrive-Munein,64480,64,45,30,20,60,40,120,75
24958,Saint-Goin,64481,64,45,42,9,51,34,94,87
24959,Saint-Jammes,64482,64,36,168,20,220,164,404,204
24960,Saint-Jean-de-Luz,64483,64,2980,2422,1054,4563,2033,7650,5402
24961,Saint-Jean-le-Vieux,64484,64,128,160,63,250,126,439,288
24962,Saint-Jean-Pied-de-Port,64485,64,314,186,140,538,168,846,500
24963,Saint-Jean-Poudge,64486,64,8,8,4,48,4,56,16
24964,Saint-Just-Ibarre,64487,64,50,35,25,95,25,145,85
24965,Saint-Laurent-Bretagne,64488,64,30,115,15,205,70,290,145
24966,Saint-Martin-d'Arberoue,64489,64,30,70,35,120,50,205,100
24967,Saint-Martin-d'Arrossa,64490,64,44,144,32,196,104,332,188
24968,Saint-Médard,64491,64,20,55,20,55,60,135,75
24969,Saint-Michel,64492,64,33,76,4,85,72,161,109
24970,Saint-Palais,64493,64,360,287,201,451,256,908,647
24971,Saint-Pé-de-Léren,64494,64,24,84,16,96,48,160,108
24972,Saint-Pée-sur-Nivelle,64495,64,613,1592,623,2063,1225,3911,2205
24973,Saint-Pierre-d'Irube,64496,64,791,1048,374,1434,857,2665,1839
24974,Saint-Vincent,64498,64,60,72,40,124,68,232,132
24975,Salies-de-Béarn,64499,64,941,737,345,1705,620,2670,1678
24976,Salles-Mongiscard,64500,64,64,89,5,59,78,142,153
24977,Sallespisse,64501,64,116,140,40,172,124,336,256
24978,Sames,64502,64,67,164,52,178,188,418,231
24979,Samsons-Lion,64503,64,12,4,8,45,4,57,16
24980,Sare,64504,64,275,524,239,873,484,1596,799
24981,Sarpourenx,64505,64,17,71,30,66,64,160,88
24982,Sarrance,64506,64,25,15,5,85,25,115,40
24983,Saubole,64507,64,16,40,28,32,36,96,56
24984,Saucède,64508,64,15,25,10,55,20,85,40
24985,Sauguis-Saint-Étienne,64509,64,55,15,0,60,10,70,70
24986,Sault-de-Navailles,64510,64,100,195,70,335,140,545,295
24987,Sauvagnon,64511,64,290,850,242,955,637,1834,1140
24988,Sauvelade,64512,64,40,60,15,70,60,145,100
24989,Sauveterre-de-Béarn,64513,64,185,229,134,403,184,721,414
24990,Séby,64514,64,40,45,10,65,30,105,85
24991,Sedze-Maubecq,64515,64,12,64,26,64,69,159,76
24992,Sedzère,64516,64,36,104,28,168,68,264,140
24993,Séméacq-Blachon,64517,64,45,20,10,64,25,99,65
24994,Sendets,64518,64,88,252,36,348,184,568,340
24995,Serres-Castet,64519,64,378,1153,252,1408,830,2490,1531
24996,Serres-Morlaàs,64520,64,123,172,57,305,101,463,295
24997,Serres-Sainte-Marie,64521,64,50,135,35,240,95,370,185
24998,Sévignacq-Meyracq,64522,64,25,125,35,210,110,355,150
24999,Sévignacq,64523,64,106,209,80,212,142,434,315
25000,Simacourbe,64524,64,24,68,40,168,64,272,92
25001,Siros,64525,64,64,162,49,251,147,447,226
25002,Soumoulou,64526,64,127,372,95,480,344,919,499
25003,Souraïde,64527,64,134,322,93,439,322,854,456
25004,Suhescun,64528,64,32,52,20,56,28,104,84
25005,Sus,64529,64,60,75,10,115,50,175,135
25006,Susmiou,64530,64,48,84,28,120,72,220,132
25007,Tabaille-Usquain,64531,64,0,0,4,20,0,24,0
25008,Tadousse-Ussau,64532,64,15,10,0,35,10,45,25
25009,Tardets-Sorholus,64533,64,130,75,25,185,65,275,205
25010,Taron-Sadirac-Viellenave,64534,64,35,35,15,90,15,120,70
25011,Tarsacq,64535,64,31,121,30,122,110,262,152
25012,Thèze,64536,64,69,203,62,243,178,483,272
25013,Trois-Villes,64537,64,52,16,12,48,12,72,68
25014,Uhart-Cize,64538,64,80,165,80,274,180,534,245
25015,Uhart-Mixe,64539,64,30,45,10,90,25,125,75
25016,Urcuit,64540,64,251,598,185,722,462,1369,849
25017,Urdès,64541,64,56,88,16,88,48,152,144
25018,Urdos,64542,64,10,5,5,55,0,60,15
25019,Urepel,64543,64,64,44,36,116,40,192,108
25020,Urost,64544,64,8,16,8,24,28,60,24
25021,Urrugne,64545,64,1104,2070,825,3312,1904,6041,3174
25022,Urt,64546,64,211,464,174,731,344,1249,675
25023,Ustaritz,64547,64,699,1450,734,2185,1297,4216,2149
25024,Uzan,64548,64,4,52,16,45,31,92,56
25025,Uzein,64549,64,112,280,109,267,215,591,392
25026,Uzos,64550,64,95,144,32,229,86,347,239
25027,Verdets,64551,64,40,70,20,80,55,155,110
25028,Vialer,64552,64,43,22,22,61,16,99,65
25029,Viellenave-d'Arthez,64554,64,16,44,4,60,44,108,60
25030,Viellenave-de-Navarrenx,64555,64,25,30,15,65,20,100,55
25031,Vielleségure,64556,64,63,56,15,105,54,174,119
25032,Vignes,64557,64,68,108,36,132,72,240,176
25033,Villefranque,64558,64,208,576,316,974,546,1836,784
25034,Viodos-Abense-de-Bas,64559,64,110,145,75,295,100,470,255
25035,Viven,64560,64,30,50,5,63,35,103,80
25036,Adast,65001,65,34,58,22,109,51,182,92
25037,Adé,65002,65,100,185,45,320,145,510,285
25038,Adervielle-Pouchergues,65003,65,0,20,16,48,40,104,20
25039,Agos-Vidalos,65004,65,64,112,16,156,68,240,176
25040,Allier,65005,65,19,125,0,125,120,245,144
25041,Ancizan,65006,65,59,37,22,70,35,127,96
25042,Andrest,65007,65,190,360,120,475,255,850,550
25043,Anères,65009,65,52,24,24,48,24,96,76
25044,Angos,65010,65,40,36,12,80,52,144,76
25045,Les Angles,65011,65,13,13,16,44,9,69,26
25046,Anla,65012,65,16,56,0,20,24,44,72
25047,Ansost,65013,65,4,12,8,20,8,36,16
25048,Antichan,65014,65,0,5,0,15,10,25,5
25049,Antin,65015,65,5,26,5,56,16,77,31
25050,Antist,65016,65,20,37,16,36,32,84,57
25051,Aragnouet,65017,65,12,47,15,73,50,138,59
25052,Arbéost,65018,65,15,29,0,57,14,71,44
25053,Arcizac-Adour,65019,65,51,90,44,208,62,314,141
25054,Arcizac-ez-Angles,65020,65,36,72,4,72,60,136,108
25055,Arcizans-Avant,65021,65,57,76,12,143,56,211,133
25056,Arcizans-Dessus,65022,65,4,26,0,55,20,75,30
25057,Ardengost,65023,65,3,0,6,6,0,12,3
25058,Argelès-Bagnères,65024,65,24,12,12,64,12,88,36
25059,Argelès-Gazost,65025,65,638,491,234,995,458,1687,1129
25060,Aries-Espénan,65026,65,8,20,4,28,8,40,28
25061,Arné,65028,65,53,35,16,71,20,107,88
25062,Arras-en-Lavedan,65029,65,85,94,15,219,79,313,179
25063,Arreau,65031,65,142,168,55,284,132,471,310
25064,Arrens-Marsous,65032,65,109,70,40,295,59,394,179
25065,Arrodets-ez-Angles,65033,65,8,16,4,16,28,48,24
25066,Arrodets,65034,65,5,0,0,10,0,10,5
25067,Artagnan,65035,65,89,104,24,159,80,263,193
25068,Artalens-Souin,65036,65,24,32,16,48,24,88,56
25069,Artiguemy,65037,65,10,10,5,55,5,65,20
25070,Artigues,65038,65,5,5,0,10,0,10,10
25071,Aspin-Aure,65039,65,12,6,0,12,6,18,18
25072,Aspin-en-Lavedan,65040,65,28,60,16,96,60,172,88
25073,Asque,65041,65,12,12,4,60,16,80,24
25074,Asté,65042,65,76,108,32,232,92,356,184
25075,Astugue,65043,65,5,50,15,100,35,150,55
25076,Aubarède,65044,65,24,62,24,109,44,177,86
25077,Aucun,65045,65,52,56,8,112,36,156,108
25078,Aulon,65046,65,16,4,8,34,8,50,20
25079,Aureilhan,65047,65,1324,1610,646,2941,1192,4779,2934
25080,Aurensan,65048,65,125,175,80,280,125,485,300
25081,Auriébat,65049,65,50,50,25,105,30,160,100
25082,Avajan,65050,65,10,6,10,30,3,43,16
25083,Aventignan,65051,65,56,28,12,80,20,112,84
25084,Averan,65052,65,0,5,5,25,20,50,5
25085,Aveux,65053,65,15,5,5,20,0,25,20
25086,Avezac-Prat-Lahitte,65054,65,86,138,16,182,104,302,224
25087,Ayros-Arbouix,65055,65,42,77,25,72,50,147,119
25088,Ayzac-Ost,65056,65,56,108,40,160,80,280,164
25089,Azereix,65057,65,155,195,85,390,125,600,350
25090,Azet,65058,65,24,28,12,44,32,88,52
25091,Bagnères-de-Bigorre,65059,65,1498,1173,568,2687,1175,4430,2671
25092,Banios,65060,65,5,10,5,15,10,30,15
25093,Barbachen,65061,65,0,10,0,25,15,40,10
25094,Barbazan-Debat,65062,65,474,775,299,1316,541,2156,1249
25095,Barbazan-Dessus,65063,65,12,36,12,68,28,108,48
25096,Bareilles,65064,65,10,10,0,10,15,25,20
25097,Barlest,65065,65,32,80,20,88,68,176,112
25098,Barrancoueu,65066,65,8,0,0,12,4,16,8
25099,Barry,65067,65,10,35,10,55,25,90,45
25100,Barthe,65068,65,5,5,0,10,0,10,10
25101,La Barthe-de-Neste,65069,65,270,285,60,375,215,650,555
25102,Bartrès,65070,65,60,92,16,184,84,284,152
25103,Batsère,65071,65,4,8,0,16,8,24,12
25104,Bazet,65072,65,205,350,130,610,300,1040,555
25105,Bazillac,65073,65,33,74,13,91,68,172,107
25106,Bazordan,65074,65,20,25,0,55,25,80,45
25107,Bazus-Aure,65075,65,40,20,0,65,10,75,60
25108,Bazus-Neste,65076,65,0,28,0,28,16,44,28
25109,Beaucens,65077,65,80,100,45,115,75,235,180
25110,Beaudéan,65078,65,60,48,20,200,52,272,108
25111,Bégole,65079,65,36,56,16,56,40,112,92
25112,Bénac,65080,65,41,149,32,121,140,293,190
25113,Benqué,65081,65,10,30,5,15,30,50,40
25114,Berbérust-Lias,65082,65,10,11,0,20,0,20,21
25115,Bernac-Debat,65083,65,50,175,25,305,115,445,225
25116,Bernac-Dessus,65084,65,23,80,6,91,52,149,103
25117,Bernadets-Debat,65085,65,8,13,4,60,0,64,21
25118,Bernadets-Dessus,65086,65,12,21,0,61,24,85,33
25119,Bertren,65087,65,60,25,5,70,20,95,85
25120,Betbèze,65088,65,20,12,0,8,8,16,32
25121,Betpouey,65089,65,10,15,0,58,10,68,25
25122,Betpouy,65090,65,0,25,0,35,15,50,25
25123,Bettes,65091,65,10,0,0,20,10,30,10
25124,Beyrède-Jumet,65092,65,30,40,25,65,35,125,70
25125,Bize,65093,65,55,30,0,95,30,125,85
25126,Bizous,65094,65,12,16,0,28,20,48,28
25127,Bonnefont,65095,65,56,64,16,92,56,164,120
25128,Bonnemazon,65096,65,15,5,0,20,15,35,20
25129,Bonrepos,65097,65,20,45,10,85,15,110,65
25130,Boô-Silhen,65098,65,68,40,32,84,48,164,108
25131,Bordères-Louron,65099,65,28,36,4,44,52,100,64
25132,Bordères-sur-l'Échez,65100,65,598,1343,482,1545,819,2846,1941
25133,Bordes,65101,65,50,205,55,280,155,490,255
25134,Bouilh-Devant,65102,65,4,4,0,4,8,12,8
25135,Bouilh-Péreuilh,65103,65,15,10,5,50,10,65,25
25136,Boulin,65104,65,12,63,22,128,44,194,75
25137,Bourg-de-Bigorre,65105,65,32,12,12,56,20,88,44
25138,Bourisp,65106,65,21,30,9,35,38,82,51
25139,Bourréac,65107,65,21,30,4,24,16,44,51
25140,Bours,65108,65,95,175,60,373,85,518,270
25141,Bramevaque,65109,65,4,4,0,20,4,24,8
25142,Bugard,65110,65,15,25,0,35,10,45,40
25143,Bulan,65111,65,15,0,10,25,5,40,15
25144,Bun,65112,65,15,20,15,80,20,115,35
25145,Burg,65113,65,56,60,4,84,60,148,116
25146,Buzon,65114,65,5,25,10,30,20,60,30
25147,Cabanac,65115,65,30,60,25,110,55,190,90
25148,Cadéac,65116,65,20,72,24,100,60,184,92
25149,Cadeilhan-Trachère,65117,65,0,5,5,35,5,45,5
25150,Caharet,65118,65,4,12,0,8,8,16,16
25151,Caixon,65119,65,24,114,28,113,82,223,138
25152,Calavanté,65120,65,26,84,31,81,62,174,110
25153,Camalès,65121,65,75,111,15,135,55,205,186
25154,Camous,65122,65,4,0,0,12,0,12,4
25155,Campan,65123,65,228,241,71,525,174,770,469
25156,Camparan,65124,65,0,10,16,25,10,51,10
25157,Campistrous,65125,65,55,55,25,145,35,205,110
25158,Campuzan,65126,65,56,24,8,60,20,88,80
25159,Capvern,65127,65,192,232,103,510,196,809,424
25160,Castelbajac,65128,65,20,28,8,44,20,72,48
25161,Castelnau-Magnoac,65129,65,200,124,44,184,132,360,324
25162,Castelnau-Rivière-Basse,65130,65,105,100,30,230,40,300,205
25163,Castelvieilh,65131,65,24,48,24,88,48,160,72
25164,Castéra-Lanusse,65132,65,0,8,4,24,12,40,8
25165,Castéra-Lou,65133,65,32,60,4,64,56,124,92
25166,Casterets,65134,65,0,0,0,0,0,0,0
25167,Castillon,65135,65,15,6,6,28,16,50,21
25168,Caubous,65136,65,20,0,0,10,5,15,20
25169,Caussade-Rivière,65137,65,16,20,8,32,16,56,36
25170,Cauterets,65138,65,150,188,65,362,182,609,338
25171,Cazarilh,65139,65,12,4,0,24,8,32,16
25172,Cazaux-Debat,65140,65,0,8,0,12,4,16,8
25173,Cazaux-Fréchet-Anéran-Camors,65141,65,5,10,0,20,15,35,15
25174,Chelle-Debat,65142,65,22,36,9,65,30,104,58
25175,Chelle-Spou,65143,65,16,33,0,32,25,57,49
25176,Cheust,65144,65,12,12,4,20,16,40,24
25177,Chèze,65145,65,0,4,12,28,12,52,4
25178,Chis,65146,65,8,89,24,133,44,201,97
25179,Cieutat,65147,65,45,135,16,244,96,356,180
25180,Cizos,65148,65,5,15,10,65,25,100,20
25181,Clarac,65149,65,22,66,4,52,23,79,88
25182,Clarens,65150,65,28,124,24,260,52,336,152
25183,Collongues,65151,65,5,35,5,60,35,100,40
25184,Coussan,65153,65,6,16,0,63,9,72,22
25185,Créchets,65154,65,12,0,4,16,0,20,12
25186,Devèze,65155,65,16,20,0,32,8,40,36
25187,Dours,65156,65,24,48,28,72,48,148,72
25188,Ens,65157,65,8,4,0,12,0,12,12
25189,Esbareich,65158,65,30,10,0,35,0,35,40
25190,Escala,65159,65,90,85,10,135,65,210,175
25191,Escaunets,65160,65,15,40,0,55,20,75,55
25192,Escondeaux,65161,65,16,84,28,76,56,160,100
25193,Esconnets,65162,65,4,20,0,12,8,20,24
25194,Escots,65163,65,10,10,0,5,10,15,20
25195,Escoubès-Pouts,65164,65,12,36,0,34,18,52,48
25196,Esparros,65165,65,21,8,20,84,12,116,29
25197,Espèche,65166,65,10,16,0,25,10,35,26
25198,Espieilh,65167,65,8,4,0,8,4,12,12
25199,Esquièze-Sère,65168,65,65,60,15,181,75,271,125
25200,Estaing,65169,65,3,9,9,18,10,37,12
25201,Estampures,65170,65,6,9,9,31,6,46,15
25202,Estarvielle,65171,65,6,0,0,12,0,12,6
25203,Estensan,65172,65,12,8,0,12,4,16,20
25204,Esterre,65173,65,25,36,15,59,27,101,61
25205,Estirac,65174,65,16,24,4,44,8,56,40
25206,Ferrère,65175,65,0,5,0,15,15,30,5
25207,Ferrières,65176,65,24,4,4,44,16,64,28
25208,Fontrailles,65177,65,15,19,0,58,12,70,34
25209,Fréchède,65178,65,0,12,16,12,8,36,12
25210,Fréchendets,65179,65,0,3,3,19,3,25,3
25211,Fréchet-Aure,65180,65,5,5,5,0,5,10,10
25212,Fréchou-Fréchet,65181,65,15,45,20,40,35,95,60
25213,Gaillagos,65182,65,36,28,4,20,24,48,64
25214,Galan,65183,65,116,116,28,232,88,348,232
25215,Galez,65184,65,24,44,0,77,28,105,68
25216,Gardères,65185,65,51,85,8,155,84,247,136
25217,Gaudent,65186,65,10,3,6,13,6,25,13
25218,Gaussan,65187,65,15,15,20,55,25,100,30
25219,Gayan,65189,65,12,63,20,97,38,155,75
25220,Gazave,65190,65,10,10,0,40,15,55,20
25221,Gazost,65191,65,24,24,8,52,24,84,48
25222,Gavarnie-Gèdre,65192,65,49,58,8,137,80,225,107
25223,Gembrie,65193,65,12,20,16,24,0,40,32
25224,Générest,65194,65,20,13,0,25,16,41,33
25225,Génos,65195,65,19,38,3,32,41,76,57
25226,Gensac,65196,65,24,20,20,32,8,60,44
25227,Ger,65197,65,16,45,12,88,36,136,61
25228,Gerde,65198,65,298,200,25,476,130,631,498
25229,Germ,65199,65,5,0,5,25,0,30,5
25230,Germs-sur-l'Oussouet,65200,65,8,8,12,48,8,68,16
25231,Geu,65201,65,25,35,5,80,30,115,60
25232,Gez,65202,65,40,60,49,115,69,233,100
25233,Gez-ez-Angles,65203,65,0,4,4,8,4,16,4
25234,Gonez,65204,65,5,0,5,15,0,20,5
25235,Gouaux,65205,65,12,6,6,42,0,48,18
25236,Goudon,65206,65,29,45,30,99,35,164,74
25237,Gourgue,65207,65,16,8,0,28,8,36,24
25238,Grailhen,65208,65,12,0,0,0,0,0,12
25239,Grézian,65209,65,20,20,12,32,12,56,40
25240,Grust,65210,65,10,9,0,9,6,15,19
25241,Guchan,65211,65,25,25,25,68,10,103,50
25242,Guchen,65212,65,52,56,28,84,76,188,108
25243,Guizerix,65213,65,32,28,12,48,12,72,60
25244,Hachan,65214,65,16,0,8,8,0,16,16
25245,Hagedet,65215,65,0,10,5,20,10,35,10
25246,Hauban,65216,65,4,8,0,33,24,57,12
25247,Hautaget,65217,65,15,10,0,25,10,35,25
25248,Hèches,65218,65,80,140,36,256,104,396,220
25249,Hères,65219,65,30,61,15,35,15,65,91
25250,Hibarette,65220,65,20,65,12,63,38,113,85
25251,Hiis,65221,65,24,56,12,92,48,152,80
25252,Hitte,65222,65,12,35,4,44,38,86,47
25253,Horgues,65223,65,135,250,55,462,225,742,385
25254,Houeydets,65224,65,40,48,4,84,56,144,88
25255,Hourc,65225,65,25,5,5,60,5,70,30
25256,Ibos,65226,65,393,549,190,883,454,1527,942
25257,Ilhet,65228,65,45,15,10,45,10,65,60
25258,Ilheu,65229,65,9,8,0,8,12,20,17
25259,Izaourt,65230,65,56,36,0,93,29,122,92
25260,Izaux,65231,65,20,37,20,79,16,115,57
25261,Jacque,65232,65,15,5,10,25,0,35,20
25262,Jarret,65233,65,27,86,10,84,60,154,113
25263,Jézeau,65234,65,20,15,0,45,15,60,35
25264,Juillan,65235,65,735,913,324,1373,703,2400,1648
25265,Julos,65236,65,20,60,32,160,64,256,80
25266,Juncalas,65237,65,32,27,13,55,23,91,59
25267,Labassère,65238,65,26,26,6,101,37,144,52
25268,Labastide,65239,65,36,24,12,56,24,92,60
25269,Labatut-Rivière,65240,65,76,72,32,136,80,248,148
25270,Laborde,65241,65,35,10,0,55,0,55,45
25271,Lacassagne,65242,65,48,44,12,76,60,148,92
25272,Lafitole,65243,65,45,120,5,180,110,295,165
25273,Lagarde,65244,65,72,89,68,164,92,324,161
25274,Lagrange,65245,65,20,40,10,140,25,175,60
25275,Arrayou-Lahitte,65247,65,5,30,5,45,35,85,35
25276,Lahitte-Toupière,65248,65,30,53,0,90,44,134,83
25277,Lalanne,65249,65,8,28,4,20,28,52,36
25278,Lalanne-Trie,65250,65,19,16,6,37,18,61,35
25279,Laloubère,65251,65,300,485,195,595,330,1120,785
25280,Lamarque-Pontacq,65252,65,124,212,44,284,160,488,336
25281,Lamarque-Rustaing,65253,65,15,10,0,5,20,25,25
25282,Laméac,65254,65,16,16,12,72,16,100,32
25283,Lançon,65255,65,10,10,0,0,10,10,20
25284,Lanespède,65256,65,26,23,10,40,22,72,49
25285,Lanne,65257,65,45,145,55,190,130,375,190
25286,Lannemezan,65258,65,1052,900,516,1780,830,3126,1952
25287,Lansac,65259,65,12,52,4,60,30,94,64
25288,Lapeyre,65260,65,25,12,0,34,16,50,37
25289,Laran,65261,65,0,5,5,25,5,35,5
25290,Larreule,65262,65,75,95,25,145,60,230,170
25291,Larroque,65263,65,8,16,8,52,8,68,24
25292,Lascazères,65264,65,44,56,24,128,36,188,100
25293,Laslades,65265,65,48,88,8,144,72,224,136
25294,Lassales,65266,65,8,0,0,20,0,20,8
25295,Lau-Balagnas,65267,65,108,96,56,180,76,312,204
25296,Layrisse,65268,65,0,35,15,75,40,130,35
25297,Lescurry,65269,65,30,35,10,60,30,100,65
25298,Lespouey,65270,65,36,56,8,68,48,124,92
25299,Lézignan,65271,65,75,80,15,135,55,205,155
25300,Lhez,65272,65,16,13,0,24,16,40,29
25301,Liac,65273,65,15,55,30,75,30,135,70
25302,Libaros,65274,65,24,12,20,64,8,92,36
25303,Lies,65275,65,4,8,4,36,12,52,12
25304,Lizos,65276,65,9,20,6,36,12,54,29
25305,Lombrès,65277,65,15,25,10,15,20,45,40
25306,Lomné,65278,65,6,10,6,12,3,21,16
25307,Lortet,65279,65,45,35,10,75,35,120,80
25308,Loubajac,65280,65,65,90,15,115,95,225,155
25309,Loucrup,65281,65,40,36,24,80,28,132,76
25310,Loudenvielle,65282,65,29,47,25,91,49,165,76
25311,Loudervielle,65283,65,10,0,15,15,5,35,10
25312,Louey,65284,65,85,195,68,403,144,615,280
25313,Louit,65285,65,25,30,15,80,40,135,55
25314,Lourdes,65286,65,2566,2617,1217,4866,2126,8209,5183
25315,Loures-Barousse,65287,65,148,100,36,176,68,280,248
25316,Lubret-Saint-Luc,65288,65,20,0,5,25,0,30,20
25317,Luby-Betmont,65289,65,0,17,8,38,28,74,17
25318,Luc,65290,65,32,44,24,54,33,111,76
25319,Lugagnan,65291,65,21,20,10,85,5,100,41
25320,Luquet,65292,65,64,104,28,152,48,228,168
25321,Lustar,65293,65,30,13,8,39,8,55,43
25322,Lutilhous,65294,65,28,60,12,80,48,140,88
25323,Luz-Saint-Sauveur,65295,65,174,130,85,350,145,580,304
25324,Madiran,65296,65,80,35,20,190,40,250,115
25325,Mansan,65297,65,6,3,0,12,0,12,9
25326,Marquerie,65298,65,25,10,10,20,25,55,35
25327,Marsac,65299,65,45,54,3,49,57,109,99
25328,Marsas,65300,65,10,20,5,20,20,45,30
25329,Marseillan,65301,65,24,52,28,92,36,156,76
25330,Mascaras,65303,65,38,72,23,100,61,184,110
25331,Maubourguet,65304,65,500,469,185,826,378,1389,969
25332,Mauléon-Barousse,65305,65,15,16,5,64,10,79,31
25333,Mauvezin,65306,65,32,56,4,72,64,140,88
25334,Mazères-de-Neste,65307,65,65,65,29,95,69,193,130
25335,Mazerolles,65308,65,12,16,9,33,12,54,28
25336,Mazouau,65309,65,10,0,0,5,0,5,10
25337,Mérilheu,65310,65,42,49,8,67,51,126,91
25338,Mingot,65311,65,0,32,20,32,24,76,32
25339,Molère,65312,65,0,10,0,9,6,15,10
25340,Momères,65313,65,75,168,43,230,169,442,243
25341,Monfaucon,65314,65,35,50,10,70,40,120,85
25342,Monléon-Magnoac,65315,65,49,89,24,180,42,246,138
25343,Monlong,65316,65,10,25,5,50,20,75,35
25344,Mont,65317,65,4,0,0,20,20,40,4
25345,Montastruc,65318,65,45,10,20,85,10,115,55
25346,Montégut,65319,65,25,15,10,50,20,80,40
25347,Montgaillard,65320,65,151,177,25,314,121,460,328
25348,Montignac,65321,65,16,25,12,36,16,64,41
25349,Montoussé,65322,65,65,35,30,75,45,150,100
25350,Montsérié,65323,65,4,8,4,20,20,44,12
25351,Moulédous,65324,65,48,52,20,52,40,112,100
25352,Moumoulous,65325,65,12,3,0,15,3,18,15
25353,Mun,65326,65,20,20,15,55,5,75,40
25354,Nestier,65327,65,25,35,5,55,50,110,60
25355,Neuilh,65328,65,12,19,11,28,12,51,31
25356,Nistos,65329,65,60,50,30,75,10,115,110
25357,Nouilhan,65330,65,45,25,5,100,5,110,70
25358,Odos,65331,65,544,674,204,1243,484,1931,1218
25359,Oléac-Debat,65332,65,12,35,12,53,35,100,47
25360,Oléac-Dessus,65333,65,8,32,12,48,28,88,40
25361,Omex,65334,65,36,36,20,96,40,156,72
25362,Ordizan,65335,65,80,140,10,140,125,275,220
25363,Organ,65336,65,8,0,8,12,0,20,8
25364,Orieux,65337,65,19,25,15,39,15,69,44
25365,Orignac,65338,65,64,68,32,68,40,140,132
25366,Orincles,65339,65,25,80,10,135,80,225,105
25367,Orleix,65340,65,321,455,137,692,308,1137,776
25368,Oroix,65341,65,16,30,22,52,4,78,46
25369,Osmets,65342,65,4,16,8,20,16,44,20
25370,Ossen,65343,65,12,45,8,68,61,137,57
25371,Ossun,65344,65,264,526,172,828,424,1424,790
25372,Ossun-ez-Angles,65345,65,0,4,8,24,4,36,4
25373,Oueilloux,65346,65,15,50,5,70,30,105,65
25374,Ourde,65347,65,0,10,5,20,10,35,10
25375,Ourdis-Cotdoussan,65348,65,12,8,0,28,8,36,20
25376,Ourdon,65349,65,0,0,0,5,0,5,0
25377,Oursbelille,65350,65,244,236,84,420,232,736,480
25378,Ousté,65351,65,0,10,0,10,15,25,10
25379,Ouzous,65352,65,28,40,8,96,16,120,68
25380,Ozon,65353,65,55,65,15,95,50,160,120
25381,Pailhac,65354,65,0,13,0,30,21,51,13
25382,Paréac,65355,65,5,10,0,20,30,50,15
25383,Péré,65356,65,0,10,0,30,20,50,10
25384,Peyraube,65357,65,16,36,20,56,20,96,52
25385,Peyret-Saint-André,65358,65,24,8,4,12,8,24,32
25386,Peyriguère,65359,65,0,8,0,8,0,8,8
25387,Peyrouse,65360,65,36,64,20,76,84,180,100
25388,Peyrun,65361,65,25,13,4,13,17,34,38
25389,Pierrefitte-Nestalas,65362,65,270,220,81,353,187,621,490
25390,Pinas,65363,65,93,81,26,144,65,235,174
25391,Pintac,65364,65,5,15,5,15,0,20,20
25392,Poueyferré,65366,65,145,216,35,330,125,490,361
25393,Poumarous,65367,65,12,24,28,48,28,104,36
25394,Pouy,65368,65,8,0,4,12,0,16,8
25395,Pouyastruc,65369,65,88,216,24,224,168,416,304
25396,Pouzac,65370,65,235,235,44,415,210,669,470
25397,Préchac,65371,65,15,35,5,115,40,160,50
25398,Pujo,65372,65,110,128,24,175,100,299,238
25399,Puntous,65373,65,60,15,20,90,0,110,75
25400,Puydarrieux,65374,65,30,40,10,130,10,150,70
25401,Rabastens-de-Bigorre,65375,65,152,328,112,428,276,816,480
25402,Recurt,65376,65,33,8,21,89,8,118,41
25403,Réjaumont,65377,65,15,45,10,85,30,125,60
25404,Ricaud,65378,65,20,15,0,15,15,30,35
25405,Ris,65379,65,0,4,0,4,8,12,4
25406,Sabalos,65380,65,0,48,8,56,36,100,48
25407,Sabarros,65381,65,16,16,0,0,8,8,32
25408,Sacoué,65382,65,5,10,5,25,5,35,15
25409,Sadournin,65383,65,45,25,10,65,25,100,70
25410,Sailhan,65384,65,28,16,12,40,24,76,44
25411,Saint-Arroman,65385,65,25,0,5,55,0,60,25
25412,Saint-Créac,65386,65,3,18,9,29,9,47,21
25413,Saint-Lanne,65387,65,20,8,9,85,53,147,28
25414,Saint-Lary-Soulan,65388,65,135,80,155,270,200,625,215
25415,Saint-Laurent-de-Neste,65389,65,185,155,30,370,115,515,340
25416,Saint-Lézer,65390,65,82,63,29,131,62,222,145
25417,Sainte-Marie,65391,65,5,10,5,20,5,30,15
25418,Saint-Martin,65392,65,47,125,13,125,81,219,172
25419,Saint-Pastous,65393,65,15,35,0,60,25,85,50
25420,Saint-Paul,65394,65,60,72,32,80,64,176,132
25421,Saint-Pé-de-Bigorre,65395,65,210,250,50,400,190,640,460
25422,Saint-Savin,65396,65,45,90,25,144,70,239,135
25423,Saint-Sever-de-Rustan,65397,65,20,34,4,55,37,96,54
25424,Saléchan,65398,65,40,42,40,46,45,131,82
25425,Saligos,65399,65,20,5,10,25,10,45,25
25426,Salles,65400,65,48,28,12,80,24,116,76
25427,Salles-Adour,65401,65,65,143,34,163,98,295,208
25428,Samuran,65402,65,0,4,0,8,4,12,4
25429,Sanous,65403,65,16,28,4,32,20,56,44
25430,Sariac-Magnoac,65404,65,37,18,9,43,18,70,55
25431,Sarlabous,65405,65,10,10,0,35,5,40,20
25432,Sarniguet,65406,65,24,68,12,68,52,132,92
25433,Sarp,65407,65,9,13,9,54,6,69,22
25434,Sarrancolin,65408,65,120,115,50,190,110,350,235
25435,Sarriac-Bigorre,65409,65,84,57,30,57,30,117,141
25436,Sarrouilles,65410,65,60,105,30,231,90,351,165
25437,Sassis,65411,65,8,28,4,32,12,48,36
25438,Sauveterre,65412,65,0,29,13,84,16,113,29
25439,Sazos,65413,65,16,24,4,40,28,72,40
25440,Ségalas,65414,65,10,15,0,30,34,64,25
25441,Ségus,65415,65,20,64,28,92,48,168,84
25442,Seich,65416,65,15,5,5,40,5,50,20
25443,Séméac,65417,65,876,890,381,1822,682,2885,1766
25444,Sénac,65418,65,40,44,8,132,52,192,84
25445,Sentous,65419,65,18,6,3,21,0,24,24
25446,Sère-en-Lavedan,65420,65,12,12,0,20,24,44,24
25447,Sère-Lanso,65421,65,6,0,3,21,3,27,6
25448,Séron,65422,65,40,92,0,92,96,188,132
25449,Sère-Rustaing,65423,65,0,25,10,65,30,105,25
25450,Sers,65424,65,6,15,3,33,22,58,21
25451,Siarrouy,65425,65,45,110,25,144,95,264,155
25452,Sinzos,65426,65,16,32,8,56,24,88,48
25453,Siradan,65427,65,15,18,6,79,21,106,33
25454,Sireix,65428,65,12,12,0,32,8,40,24
25455,Sombrun,65429,65,20,39,15,88,18,121,59
25456,Soréac,65430,65,4,16,8,20,12,40,20
25457,Sost,65431,65,5,15,5,60,15,80,20
25458,Soublecause,65432,65,20,40,0,70,24,94,60
25459,Soues,65433,65,560,640,275,1015,520,1810,1200
25460,Soulom,65435,65,30,38,36,78,29,143,68
25461,Souyeaux,65436,65,55,50,30,125,40,195,105
25462,Tajan,65437,65,30,25,20,50,10,80,55
25463,Talazac,65438,65,8,12,9,20,12,41,20
25464,Tarasteix,65439,65,56,48,16,84,56,156,104
25465,Tarbes,65440,65,7656,8515,5784,11195,6087,23066,16171
25466,Thèbe,65441,65,20,16,8,20,16,44,36
25467,Thermes-Magnoac,65442,65,44,44,20,64,36,120,88
25468,Thuy,65443,65,0,12,0,4,8,12,12
25469,Tibiran-Jaunac,65444,65,50,34,12,96,31,139,84
25470,Tilhouse,65445,65,59,25,13,76,20,109,84
25471,Tostat,65446,65,46,122,31,185,86,302,168
25472,Tournay,65447,65,176,335,80,442,269,791,511
25473,Tournous-Darré,65448,65,4,21,0,31,16,47,25
25474,Tournous-Devant,65449,65,20,30,0,45,15,60,50
25475,Tramezaïgues,65450,65,0,20,0,8,12,20,20
25476,Trébons,65451,65,147,152,26,246,98,370,299
25477,Trie-sur-Baïse,65452,65,282,195,95,294,110,499,477
25478,Troubat,65453,65,8,12,8,20,8,36,20
25479,Trouley-Labarthe,65454,65,5,20,0,30,35,65,25
25480,Tuzaguet,65455,65,120,85,45,134,80,259,205
25481,Uglas,65456,65,35,55,15,135,30,180,90
25482,Ugnouas,65457,65,8,24,4,8,32,44,32
25483,Uz,65458,65,0,15,0,5,15,20,15
25484,Uzer,65459,65,30,21,4,16,12,32,51
25485,Vic-en-Bigorre,65460,65,785,924,391,1575,783,2749,1709
25486,Vidou,65461,65,13,25,4,28,4,36,38
25487,Vidouze,65462,65,65,45,5,95,50,150,110
25488,Viella,65463,65,0,8,0,40,16,56,8
25489,Vielle-Adour,65464,65,70,135,15,180,110,305,205
25490,Vielle-Aure,65465,65,35,74,15,171,50,236,109
25491,Vielle-Louron,65466,65,4,22,4,24,21,49,26
25492,Vier-Bordes,65467,65,5,40,0,60,10,70,45
25493,Vieuzos,65468,65,20,10,0,5,5,10,30
25494,Viey,65469,65,0,0,8,12,4,24,0
25495,Viger,65470,65,20,25,15,40,25,80,45
25496,Vignec,65471,65,28,40,32,80,40,152,68
25497,Villefranque,65472,65,15,10,0,35,20,55,25
25498,Villelongue,65473,65,40,75,35,185,70,290,115
25499,Villembits,65474,65,20,24,4,36,28,68,44
25500,Villemur,65475,65,13,0,3,23,3,29,13
25501,Villenave-près-Béarn,65476,65,16,13,3,9,6,18,29
25502,Villenave-près-Marsac,65477,65,12,32,0,16,24,40,44
25503,Viscos,65478,65,10,5,5,27,0,32,15
25504,Visker,65479,65,25,45,20,173,45,238,70
25505,Vizos,65480,65,0,10,0,20,10,30,10
25506,Barèges,65481,65,20,40,20,80,24,124,60
25507,Cantaous,65482,65,70,60,25,200,40,265,130
25508,L'Albère,66001,66,23,20,5,27,25,57,43
25509,Alénya,66002,66,398,864,332,1282,489,2103,1262
25510,Amélie-les-Bains-Palalda,66003,66,1102,440,250,1258,405,1913,1542
25511,Les Angles,66004,66,32,96,32,240,108,380,128
25512,Angoustrine-Villeneuve-des-Escaldes,66005,66,37,143,25,219,97,341,180
25513,Ansignan,66006,66,58,20,10,56,25,91,78
25514,Arboussols,66007,66,8,21,4,44,18,66,29
25515,Argelès-sur-Mer,66008,66,2306,1691,759,3979,1348,6086,3997
25516,Arles-sur-Tech,66009,66,497,511,163,904,452,1519,1008
25517,Ayguatébia-Talau,66010,66,16,12,8,4,4,16,28
25518,Bages,66011,66,630,817,403,1350,787,2540,1447
25519,Baho,66012,66,411,793,269,1061,546,1876,1204
25520,Baillestavy,66013,66,16,36,4,40,20,64,52
25521,Baixas,66014,66,380,575,320,795,480,1595,955
25522,Banyuls-dels-Aspres,66015,66,152,292,65,428,217,710,444
25523,Banyuls-sur-Mer,66016,66,987,730,354,1764,616,2734,1717
25524,Le Barcarès,66017,66,1103,521,346,1836,536,2718,1624
25525,La Bastide,66018,66,30,15,0,25,5,30,45
25526,Bélesta,66019,66,52,60,12,44,60,116,112
25527,Bolquère,66020,66,50,220,50,305,195,550,270
25528,Bompas,66021,66,1018,1560,511,2639,1073,4223,2578
25529,Boule-d'Amont,66022,66,5,5,10,30,0,40,10
25530,Bouleternère,66023,66,162,194,88,262,187,537,356
25531,Le Boulou,66024,66,1170,1061,575,1874,875,3324,2231
25532,Bourg-Madame,66025,66,135,350,100,407,230,737,485
25533,Brouilla,66026,66,164,300,81,394,259,734,464
25534,La Cabanasse,66027,66,39,194,69,237,142,448,233
25535,Cabestany,66028,66,1737,2322,655,2957,1691,5303,4059
25536,Caixas,66029,66,30,20,5,55,20,80,50
25537,Calce,66030,66,30,25,40,80,40,160,55
25538,Calmeilles,66032,66,0,5,15,40,10,65,5
25539,Camélas,66033,66,69,87,8,138,84,230,156
25540,Campôme,66034,66,32,28,0,24,28,52,60
25541,Campoussy,66035,66,5,0,0,25,0,25,5
25542,Canaveilles,66036,66,6,3,0,21,0,21,9
25543,Canet-en-Roussillon,66037,66,2631,2031,809,4716,1790,7315,4662
25544,Canohès,66038,66,683,1165,383,1994,947,3324,1848
25545,Caramany,66039,66,12,8,0,81,17,98,20
25546,Casefabre,66040,66,3,10,0,15,3,18,13
25547,Cases-de-Pène,66041,66,50,264,45,260,263,568,314
25548,Cassagnes,66042,66,35,53,20,82,43,145,88
25549,Casteil,66043,66,17,17,15,52,9,76,34
25550,Castelnou,66044,66,40,65,30,190,40,260,105
25551,Catllar,66045,66,176,138,22,267,77,366,314
25552,Caudiès-de-Fenouillèdes,66046,66,165,130,10,215,130,355,295
25553,Caudiès-de-Conflent,66047,66,0,0,0,12,0,12,0
25554,Cerbère,66048,66,265,190,95,505,190,790,455
25555,Céret,66049,66,1642,1509,522,2788,964,4274,3151
25556,Claira,66050,66,405,1006,348,1342,804,2494,1411
25557,Clara,66051,66,16,53,20,81,47,148,69
25558,Codalet,66052,66,94,59,13,154,31,198,153
25559,Collioure,66053,66,684,359,125,1214,423,1762,1043
25560,Conat,66054,66,3,3,10,3,15,28,6
25561,Corbère,66055,66,29,175,77,268,92,437,204
25562,Corbère-les-Cabanes,66056,66,136,300,84,352,260,696,436
25563,Corneilla-de-Conflent,66057,66,80,120,55,170,55,280,200
25564,Corneilla-la-Rivière,66058,66,188,572,168,600,440,1208,760
25565,Corneilla-del-Vercol,66059,66,290,506,237,661,406,1304,796
25566,Corsavy,66060,66,25,20,5,126,20,151,45
25567,Coustouges,66061,66,20,28,4,32,32,68,48
25568,Dorres,66062,66,19,22,9,61,15,85,41
25569,Les Cluses,66063,66,68,56,4,108,36,148,124
25570,Égat,66064,66,25,105,40,165,105,310,130
25571,Elne,66065,66,1191,2092,793,2642,1596,5031,3283
25572,Enveitg,66066,66,76,144,80,216,128,424,220
25573,Err,66067,66,80,97,56,113,126,295,177
25574,Escaro,66068,66,0,35,10,41,25,76,35
25575,Espira-de-l'Agly,66069,66,326,950,300,953,708,1961,1276
25576,Espira-de-Conflent,66070,66,35,25,5,55,40,100,60
25577,Estagel,66071,66,333,441,184,665,366,1215,774
25578,Estavar,66072,66,55,103,38,94,114,246,158
25579,Estoher,66073,66,32,24,4,68,32,104,56
25580,Eus,66074,66,115,50,35,130,60,225,165
25581,Eyne,66075,66,10,15,10,50,30,90,25
25582,Felluns,66076,66,0,17,0,30,12,42,17
25583,Fenouillet,66077,66,0,9,3,30,12,45,9
25584,Fillols,66078,66,24,13,0,64,42,106,37
25585,Finestret,66079,66,20,25,0,90,35,125,45
25586,Fontpédrouse,66080,66,30,20,10,40,25,75,50
25587,Fontrabiouse,66081,66,4,36,0,64,28,92,40
25588,Formiguères,66082,66,33,99,24,127,94,245,132
25589,Fosse,66083,66,6,0,3,15,3,21,6
25590,Fourques,66084,66,195,315,85,358,225,668,510
25591,Fuilla,66085,66,51,107,13,150,73,236,158
25592,Glorianes,66086,66,8,8,0,8,4,12,16
25593,Ille-sur-Têt,66088,66,1122,1167,459,1608,822,2889,2289
25594,Joch,66089,66,20,54,12,75,75,162,74
25595,Jujols,66090,66,0,0,10,25,10,45,0
25596,Lamanère,66091,66,5,15,0,10,5,15,20
25597,Lansac,66092,66,15,26,0,41,5,46,41
25598,Laroque-des-Albères,66093,66,604,405,75,702,325,1102,1009
25599,Latour-Bas-Elne,66094,66,324,529,230,803,412,1445,853
25600,Latour-de-Carol,66095,66,80,120,15,150,75,240,200
25601,Latour-de-France,66096,66,155,230,80,310,185,575,385
25602,Lesquerde,66097,66,20,20,5,60,30,95,40
25603,La Llagonne,66098,66,30,65,10,70,75,155,95
25604,Llauro,66099,66,36,54,18,98,55,171,90
25605,Llo,66100,66,16,38,9,47,33,89,54
25606,Llupia,66101,66,360,410,105,765,310,1180,770
25607,Mantet,66102,66,0,10,5,10,15,30,10
25608,Marquixanes,66103,66,35,135,25,190,95,310,170
25609,Los Masos,66104,66,104,184,34,325,158,517,288
25610,Matemale,66105,66,25,50,20,100,65,185,75
25611,Maureillas-las-Illas,66106,66,526,517,225,1043,276,1544,1043
25612,Maury,66107,66,166,172,45,258,140,443,338
25613,Millas,66108,66,540,987,451,1295,695,2441,1527
25614,Molitg-les-Bains,66109,66,33,16,21,99,28,148,49
25615,Montalba-le-Château,66111,66,44,28,8,48,12,68,72
25616,Montauriol,66112,66,46,34,12,89,29,130,80
25617,Montbolo,66113,66,50,25,0,39,20,59,75
25618,Montescot,66114,66,234,445,105,643,343,1091,679
25619,Montesquieu-des-Albères,66115,66,275,220,65,487,155,707,495
25620,Montferrer,66116,66,34,29,0,86,12,98,63
25621,Mont-Louis,66117,66,15,40,3,36,48,87,55
25622,Montner,66118,66,42,68,31,109,43,183,110
25623,Mosset,66119,66,29,45,5,120,78,203,74
25624,Nahuja,66120,66,4,8,8,24,12,44,12
25625,Néfiach,66121,66,153,288,123,427,189,739,441
25626,Nohèdes,66122,66,12,8,8,28,8,44,20
25627,Nyer,66123,66,20,8,17,40,4,61,28
25628,Font-Romeu-Odeillo-Via,66124,66,225,434,177,663,281,1121,659
25629,Olette,66125,66,75,50,35,184,55,274,125
25630,Oms,66126,66,53,53,13,117,36,166,106
25631,Opoul-Périllos,66127,66,120,284,81,314,231,626,404
25632,Oreilla,66128,66,4,4,0,4,4,8,8
25633,Ortaffa,66129,66,201,305,100,451,199,750,506
25634,Osséja,66130,66,142,241,39,349,151,539,383
25635,Palau-de-Cerdagne,66132,66,55,115,30,105,105,240,170
25636,Palau-del-Vidre,66133,66,368,841,257,990,737,1984,1209
25637,Passa,66134,66,96,164,56,216,148,420,260
25638,Perpignan,66136,66,17979,29292,15336,33672,20920,69928,47271
25639,Le Perthus,66137,66,158,105,72,222,49,343,263
25640,Peyrestortes,66138,66,131,277,143,488,196,827,408
25641,Pézilla-de-Conflent,66139,66,15,5,0,20,5,25,20
25642,Pézilla-la-Rivière,66140,66,484,850,305,1028,659,1992,1334
25643,Pia,66141,66,801,2366,865,2577,1678,5120,3167
25644,Planès,66142,66,4,12,12,16,12,40,16
25645,Planèzes,66143,66,12,12,12,64,4,80,24
25646,Pollestres,66144,66,653,1158,319,1613,818,2750,1811
25647,Ponteilla,66145,66,192,796,252,892,679,1823,988
25648,Porta,66146,66,24,27,3,27,13,43,51
25649,Porté-Puymorens,66147,66,30,25,0,20,40,60,55
25650,Port-Vendres,66148,66,930,723,421,1388,600,2409,1653
25651,Prades,66149,66,1226,1212,445,2026,736,3207,2438
25652,Prats-de-Mollo-la-Preste,66150,66,243,123,64,408,135,607,366
25653,Prats-de-Sournia,66151,66,25,4,4,22,4,30,29
25654,Prugnanes,66152,66,24,16,0,40,12,52,40
25655,Prunet-et-Belpuig,66153,66,6,6,0,25,0,25,12
25656,Puyvalador,66154,66,5,15,0,15,25,40,20
25657,Py,66155,66,30,14,5,38,20,63,44
25658,Rabouillet,66156,66,8,12,20,56,8,84,20
25659,Railleu,66157,66,4,0,0,8,0,8,4
25660,Rasiguères,66158,66,30,31,15,60,25,100,61
25661,Réal,66159,66,8,16,8,24,16,48,24
25662,Reynès,66160,66,242,248,80,613,170,863,490
25663,Ria-Sirach,66161,66,169,268,48,547,233,828,437
25664,Rigarda,66162,66,32,184,48,176,192,416,216
25665,Rivesaltes,66164,66,1426,2014,772,2662,1491,4925,3440
25666,Rodès,66165,66,112,140,68,200,92,360,252
25667,Sahorre,66166,66,44,72,48,132,92,272,116
25668,Saillagouse,66167,66,76,266,65,307,270,642,342
25669,Saint-André,66168,66,729,664,222,1109,489,1820,1393
25670,Saint-Arnac,66169,66,20,16,8,44,28,80,36
25671,Sainte-Colombe-de-la-Commanderie,66170,66,20,24,28,52,24,104,44
25672,Saint-Cyprien,66171,66,2357,1624,632,3869,1237,5738,3981
25673,Saint-Estève,66172,66,1900,2543,1097,3923,1980,7000,4443
25674,Saint-Féliu-d'Amont,66173,66,92,293,64,268,278,610,385
25675,Saint-Féliu-d'Avall,66174,66,324,615,249,880,519,1648,939
25676,Saint-Génis-des-Fontaines,66175,66,713,450,142,1057,295,1494,1163
25677,Saint-Hippolyte,66176,66,276,773,264,985,553,1802,1049
25678,Saint-Jean-Lasseille,66177,66,70,445,120,385,440,945,515
25679,Saint-Jean-Pla-de-Corts,66178,66,352,464,164,744,340,1248,816
25680,Saint-Laurent-de-Cerdans,66179,66,245,160,55,435,145,635,405
25681,Saint-Laurent-de-la-Salanque,66180,66,1760,2113,882,3680,1703,6265,3873
25682,Sainte-Léocadie,66181,66,3,27,9,43,28,80,30
25683,Sainte-Marie,66182,66,848,961,373,1800,773,2946,1809
25684,Saint-Marsal,66183,66,24,8,0,36,8,44,32
25685,Saint-Martin-de-Fenouillet,66184,66,12,8,4,28,8,40,20
25686,Saint-Michel-de-Llotes,66185,66,40,52,28,164,56,248,92
25687,Saint-Nazaire,66186,66,386,561,150,954,421,1525,947
25688,Saint-Paul-de-Fenouillet,66187,66,372,357,135,687,200,1022,729
25689,Saint-Pierre-dels-Forcats,66188,66,12,68,24,96,43,163,80
25690,Saleilles,66189,66,910,1080,496,1626,819,2941,1990
25691,Salses-le-Château,66190,66,398,819,308,951,637,1896,1217
25692,Sansa,66191,66,10,0,0,10,0,10,10
25693,Sauto,66192,66,0,10,20,35,10,65,10
25694,Serdinya,66193,66,29,38,20,93,21,134,67
25695,Serralongue,66194,66,37,36,8,105,25,138,73
25696,Le Soler,66195,66,940,1805,678,2415,1457,4550,2745
25697,Sorède,66196,66,757,497,206,1160,348,1714,1254
25698,Souanyas,66197,66,16,12,0,20,4,24,28
25699,Sournia,66198,66,70,95,30,105,65,200,165
25700,Taillet,66199,66,25,31,0,45,20,65,56
25701,Tarerach,66201,66,20,12,0,24,4,28,32
25702,Targassonne,66202,66,5,40,5,70,55,130,45
25703,Taulis,66203,66,12,4,0,28,4,32,16
25704,Taurinya,66204,66,24,77,23,99,53,175,101
25705,Tautavel,66205,66,144,168,64,340,136,540,312
25706,Le Tech,66206,66,6,16,3,51,3,57,22
25707,Terrats,66207,66,90,145,40,240,150,430,235
25708,Théza,66208,66,230,369,228,535,339,1102,599
25709,Thuès-Entre-Valls,66209,66,4,4,0,4,16,20,8
25710,Thuir,66210,66,1252,1545,628,2438,1010,4076,2797
25711,Tordères,66211,66,6,30,15,60,20,95,36
25712,Torreilles,66212,66,373,941,240,1189,842,2271,1314
25713,Toulouges,66213,66,941,1602,678,2274,1136,4088,2543
25714,Tresserre,66214,66,55,270,145,320,245,710,325
25715,Trévillach,66215,66,36,24,0,52,24,76,60
25716,Trilla,66216,66,4,17,4,17,20,41,21
25717,Trouillas,66217,66,233,495,204,565,395,1164,728
25718,Ur,66218,66,33,60,25,92,40,157,93
25719,Urbanya,66219,66,3,3,0,13,6,19,6
25720,Valcebollère,66220,66,0,0,0,35,0,35,0
25721,Valmanya,66221,66,15,15,0,20,0,20,30
25722,Vernet-les-Bains,66222,66,325,179,80,506,170,756,504
25723,Villefranche-de-Conflent,66223,66,20,35,20,94,35,149,55
25724,Villelongue-de-la-Salanque,66224,66,343,883,316,1055,643,2014,1226
25725,Villelongue-dels-Monts,66225,66,255,325,90,590,265,945,580
25726,Villemolaque,66226,66,108,335,122,422,189,733,443
25727,Villeneuve-de-la-Raho,66227,66,526,765,338,1562,580,2480,1291
25728,Villeneuve-la-Rivière,66228,66,150,345,95,440,235,770,495
25729,Vinça,66230,66,402,388,148,708,248,1104,790
25730,Vingrau,66231,66,65,135,60,230,105,395,200
25731,Vira,66232,66,8,4,0,20,0,20,12
25732,Vivès,66233,66,20,29,6,62,19,87,49
25733,Le Vivier,66234,66,25,0,0,35,5,40,25
25734,Achenheim,67001,67,238,366,216,868,255,1339,604
25735,Adamswiller,67002,67,30,70,75,185,35,295,100
25736,Albé,67003,67,70,95,50,160,90,300,165
25737,Sommerau,67004,67,172,388,118,517,266,901,560
25738,Alteckendorf,67005,67,100,168,104,300,184,588,268
25739,Altenheim,67006,67,20,44,28,76,32,136,64
25740,Altorf,67008,67,170,260,140,420,240,800,430
25741,Altwiller,67009,67,47,109,9,119,89,217,156
25742,Andlau,67010,67,247,388,159,532,336,1027,635
25743,Artolsheim,67011,67,123,277,51,237,244,532,400
25744,Aschbach,67012,67,90,200,50,225,140,415,290
25745,Asswiller,67013,67,28,56,40,108,52,200,84
25746,Auenheim,67014,67,108,236,60,300,192,552,344
25747,Avolsheim,67016,67,56,148,74,255,142,471,204
25748,Baerendorf,67017,67,36,88,36,108,52,196,124
25749,Balbronn,67018,67,79,145,60,265,100,425,224
25750,Baldenheim,67019,67,132,300,124,340,248,712,432
25751,Barembach,67020,67,125,235,45,259,220,524,360
25752,Barr,67021,67,768,1739,840,2100,1392,4332,2507
25753,Bassemberg,67022,67,30,60,35,100,25,160,90
25754,Batzendorf,67023,67,90,225,75,340,215,630,315
25755,Beinheim,67025,67,295,305,130,775,375,1280,600
25756,Bellefosse,67026,67,20,25,12,36,16,64,45
25757,Belmont,67027,67,25,30,5,75,25,105,55
25758,Benfeld,67028,67,492,1419,816,1554,1214,3584,1911
25759,Berg,67029,67,40,80,15,160,75,250,120
25760,Bergbieten,67030,67,72,172,44,264,124,432,244
25761,Bernardswiller,67031,67,132,365,156,499,291,946,497
25762,Bernardvillé,67032,67,17,38,16,82,30,128,55
25763,Bernolsheim,67033,67,50,155,70,195,140,405,205
25764,Berstett,67034,67,275,583,164,845,534,1543,858
25765,Berstheim,67035,67,17,108,28,184,55,267,125
25766,Bettwiller,67036,67,44,60,20,79,53,152,104
25767,Biblisheim,67037,67,48,55,13,125,50,188,103
25768,Bietlenheim,67038,67,30,55,35,120,53,208,85
25769,Bilwisheim,67039,67,16,95,53,145,81,279,111
25770,Bindernheim,67040,67,116,233,100,285,245,630,349
25771,Bischheim,67043,67,1870,4300,2179,5080,3558,10817,6170
25772,Bischholtz,67044,67,20,60,35,110,55,200,80
25773,Bischoffsheim,67045,67,289,780,308,1238,644,2190,1069
25774,Bischwiller,67046,67,1081,3110,1563,3400,2312,7275,4191
25775,Bissert,67047,67,12,37,12,62,12,86,49
25776,Bitschhoffen,67048,67,36,95,29,117,95,241,131
25777,Blaesheim,67049,67,161,270,110,565,190,865,431
25778,Blancherupt,67050,67,5,10,0,0,25,25,15
25779,Blienschwiller,67051,67,35,73,20,140,58,218,108
25780,Boersch,67052,67,254,589,192,893,446,1531,843
25781,Boesenbiesen,67053,67,48,84,8,88,76,172,132
25782,Bolsenheim,67054,67,35,120,30,130,141,301,155
25783,Boofzheim,67055,67,137,316,105,422,263,790,453
25784,Bootzheim,67056,67,56,170,71,183,168,422,226
25785,Bosselshausen,67057,67,16,39,3,44,28,75,55
25786,Bossendorf,67058,67,22,107,51,134,76,261,129
25787,Bourg-Bruche,67059,67,88,106,57,158,33,248,194
25788,Bourgheim,67060,67,28,132,88,176,144,408,160
25789,Bouxwiller,67061,67,426,1027,345,1291,844,2480,1453
25790,Breitenau,67062,67,45,70,40,90,70,200,115
25791,Breitenbach,67063,67,108,155,37,169,140,346,263
25792,Breuschwickersheim,67065,67,245,270,100,375,285,760,515
25793,La Broque,67066,67,364,650,238,957,505,1700,1014
25794,Brumath,67067,67,969,2221,1062,3110,1915,6087,3190
25795,Buswiller,67068,67,50,70,20,60,45,125,120
25796,Buhl,67069,67,49,130,33,128,132,293,179
25797,Burbach,67070,67,32,34,42,76,42,160,66
25798,Bust,67071,67,60,128,44,140,80,264,188
25799,Butten,67072,67,88,160,60,252,120,432,248
25800,Châtenois,67073,67,403,982,338,1336,858,2532,1385
25801,Cleebourg,67074,67,92,155,38,281,90,409,247
25802,Climbach,67075,67,10,104,5,222,87,314,114
25803,Colroy-la-Roche,67076,67,60,136,16,196,76,288,196
25804,Cosswiller,67077,67,35,125,55,196,102,353,160
25805,Crastatt,67078,67,0,60,15,95,70,180,60
25806,Croettwiller,67079,67,30,55,10,55,35,100,85
25807,Dachstein,67080,67,149,436,239,628,309,1176,585
25808,Dahlenheim,67081,67,75,235,70,245,160,475,310
25809,Dalhunden,67082,67,120,212,88,364,232,684,332
25810,Dambach,67083,67,100,135,35,330,150,515,235
25811,Dambach-la-Ville,67084,67,351,486,156,581,414,1151,837
25812,Dangolsheim,67085,67,68,226,28,200,198,426,294
25813,Daubensand,67086,67,36,84,20,140,76,236,120
25814,Dauendorf,67087,67,108,300,140,540,248,928,408
25815,Dehlingen,67088,67,45,70,26,126,50,202,115
25816,Dettwiller,67089,67,375,610,250,960,445,1655,985
25817,Diebolsheim,67090,67,55,205,75,195,165,435,260
25818,Diedendorf,67091,67,33,55,37,92,50,179,88
25819,Dieffenbach-au-Val,67092,67,106,145,17,190,123,330,251
25820,Dieffenbach-lès-Woerth,67093,67,60,76,24,104,76,204,136
25821,Dieffenthal,67094,67,20,55,20,95,60,175,75
25822,Diemeringen,67095,67,147,334,151,533,288,972,481
25823,Dimbsthal,67096,67,33,53,8,156,34,198,86
25824,Dingsheim,67097,67,152,346,72,555,206,833,498
25825,Dinsheim-sur-Bruche,67098,67,116,320,120,504,312,936,436
25826,Domfessel,67099,67,30,65,40,110,55,205,95
25827,Donnenheim,67100,67,45,65,25,90,55,170,110
25828,Dorlisheim,67101,67,274,552,224,880,461,1565,826
25829,Dossenheim-Kochersberg,67102,67,24,53,16,82,44,142,77
25830,Dossenheim-sur-Zinsel,67103,67,89,230,75,406,197,678,319
25831,Drachenbronn-Birlenbach,67104,67,89,220,80,210,185,475,309
25832,Drulingen,67105,67,192,368,124,420,288,832,560
25833,Drusenheim,67106,67,580,1190,545,1684,1013,3242,1770
25834,Duntzenheim,67107,67,37,148,40,218,127,385,185
25835,Duppigheim,67108,67,171,320,138,584,241,963,491
25836,Durningen,67109,67,80,145,45,240,105,390,225
25837,Durrenbach,67110,67,92,264,108,420,196,724,356
25838,Durstel,67111,67,50,85,30,140,85,255,135
25839,Duttlenheim,67112,67,331,632,263,915,629,1807,963
25840,Eberbach-Seltz,67113,67,30,117,35,165,86,286,147
25841,Ebersheim,67115,67,376,565,250,641,433,1324,941
25842,Ebersmunster,67116,67,49,112,43,153,99,295,161
25843,Eckartswiller,67117,67,52,54,38,161,56,255,106
25844,Eckbolsheim,67118,67,787,1535,897,1934,1425,4256,2322
25845,Eckwersheim,67119,67,175,220,185,572,145,902,395
25846,Eichhoffen,67120,67,56,152,56,136,160,352,208
25847,Elsenheim,67121,67,132,193,116,209,161,486,325
25848,Wangenbourg-Engenthal,67122,67,220,255,95,530,270,895,475
25849,Engwiller,67123,67,56,106,58,131,99,288,162
25850,Entzheim,67124,67,139,559,256,723,388,1367,698
25851,Epfig,67125,67,290,535,279,724,425,1428,825
25852,Erckartswiller,67126,67,30,60,40,140,50,230,90
25853,Ergersheim,67127,67,80,304,180,372,312,864,384
25854,Ernolsheim-Bruche,67128,67,168,384,176,624,424,1224,552
25855,Ernolsheim-lès-Saverne,67129,67,75,145,30,210,120,360,220
25856,Erstein,67130,67,1074,2409,1416,3727,2288,7431,3483
25857,Eschau,67131,67,602,1130,523,1685,854,3062,1732
25858,Eschbach,67132,67,67,215,79,321,177,577,282
25859,Eschbourg,67133,67,75,100,15,180,110,305,175
25860,Eschwiller,67134,67,5,55,20,55,61,136,60
25861,Ettendorf,67135,67,83,167,70,260,128,458,250
25862,Eywiller,67136,67,30,75,10,90,70,170,105
25863,Fegersheim,67137,67,631,1397,604,1843,975,3422,2028
25864,Fessenheim-le-Bas,67138,67,45,130,50,190,105,345,175
25865,Flexbourg,67139,67,30,130,45,195,80,320,160
25866,Forstfeld,67140,67,90,130,65,300,135,500,220
25867,Forstheim,67141,67,95,135,75,220,85,380,230
25868,Fort-Louis,67142,67,10,70,15,100,95,210,80
25869,Fouchy,67143,67,90,180,30,210,145,385,270
25870,Fouday,67144,67,28,72,36,172,48,256,100
25871,Friedolsheim,67145,67,5,60,40,95,40,175,65
25872,Friesenheim,67146,67,75,160,50,190,145,385,235
25873,Froeschwiller,67147,67,60,155,30,140,135,305,215
25874,Frohmuhl,67148,67,35,50,0,50,50,100,85
25875,Furchhausen,67149,67,12,110,9,119,120,248,122
25876,Furdenheim,67150,67,112,353,116,424,296,836,465
25877,Gambsheim,67151,67,592,1032,407,1630,916,2953,1624
25878,Geispolsheim,67152,67,802,1663,726,2453,1282,4461,2465
25879,Geiswiller,67153,67,12,40,12,76,38,126,52
25880,Gerstheim,67154,67,346,834,276,1041,716,2033,1180
25881,Gertwiller,67155,67,140,337,145,295,342,782,477
25882,Geudertheim,67156,67,298,516,275,780,464,1519,814
25883,Goerlingen,67159,67,16,64,32,80,44,156,80
25884,Goersdorf,67160,67,145,210,90,395,205,690,355
25885,Gottenhouse,67161,67,70,75,55,155,40,250,145
25886,Gottesheim,67162,67,51,49,24,132,41,197,100
25887,Gougenheim,67163,67,50,135,35,180,135,350,185
25888,Goxwiller,67164,67,105,220,50,304,194,548,325
25889,Grandfontaine,67165,67,28,112,20,176,80,276,140
25890,Grassendorf,67166,67,16,57,21,63,60,144,73
25891,Grendelbruch,67167,67,220,300,80,390,250,720,520
25892,Gresswiller,67168,67,142,396,113,558,323,994,538
25893,Gries,67169,67,340,605,260,1130,415,1805,945
25894,Griesheim-près-Molsheim,67172,67,151,480,240,859,333,1432,631
25895,Griesheim-sur-Souffel,67173,67,125,305,60,425,230,715,430
25896,Gumbrechtshoffen,67174,67,196,184,133,387,188,708,380
25897,Gundershoffen,67176,67,378,851,340,1199,814,2353,1229
25898,Gunstett,67177,67,65,160,55,290,115,460,225
25899,Gungwiller,67178,67,35,70,20,80,74,174,105
25900,Haegen,67179,67,75,159,85,205,162,452,234
25901,Haguenau,67180,67,3790,7783,4227,10833,6623,21683,11573
25902,Handschuheim,67181,67,45,60,20,95,65,180,105
25903,Hangenbieten,67182,67,139,355,167,556,327,1050,494
25904,Harskirchen,67183,67,79,172,47,324,157,528,251
25905,Hatten,67184,67,160,445,170,710,435,1315,605
25906,Hattmatt,67185,67,71,145,56,228,99,383,216
25907,Hegeney,67186,67,42,133,10,84,163,257,175
25908,Heidolsheim,67187,67,50,93,65,150,103,318,143
25909,Heiligenberg,67188,67,88,148,44,244,108,396,236
25910,Heiligenstein,67189,67,120,205,70,385,180,635,325
25911,Hengwiller,67190,67,35,38,9,69,26,104,73
25912,Herbitzheim,67191,67,260,360,200,680,345,1225,620
25913,Herbsheim,67192,67,91,218,92,250,188,530,309
25914,Herrlisheim,67194,67,592,1021,426,1743,845,3014,1613
25915,Hessenheim,67195,67,78,157,25,215,138,378,235
25916,Hilsenheim,67196,67,155,732,205,835,545,1585,887
25917,Hindisheim,67197,67,138,326,127,471,241,839,464
25918,Hinsbourg,67198,67,16,18,3,39,6,48,34
25919,Hinsingen,67199,67,0,20,5,40,15,60,20
25920,Hipsheim,67200,67,109,246,85,295,201,581,355
25921,Hirschland,67201,67,44,109,30,85,79,194,153
25922,Hochfelden,67202,67,378,856,319,1106,686,2111,1234
25923,Hochstett,67203,67,16,94,25,107,73,205,110
25924,Hoenheim,67204,67,1601,2326,1247,3626,1971,6844,3927
25925,Hoerdt,67205,67,443,1024,418,1542,737,2697,1467
25926,Hoffen,67206,67,110,239,127,421,243,791,349
25927,Hohengoeft,67208,67,53,109,31,175,85,291,162
25928,Hohfrankenheim,67209,67,16,44,28,100,64,192,60
25929,Le Hohwald,67210,67,40,98,25,220,79,324,138
25930,Holtzheim,67212,67,380,773,473,1130,755,2358,1153
25931,Hunspach,67213,67,95,110,52,224,93,369,205
25932,Hurtigheim,67214,67,81,117,111,151,124,386,198
25933,Huttendorf,67215,67,60,95,70,215,65,350,155
25934,Huttenheim,67216,67,285,668,280,915,489,1684,953
25935,Ichtratzheim,67217,67,52,54,12,75,36,123,106
25936,Illkirch-Graffenstaden,67218,67,3387,6006,3451,8053,5134,16638,9393
25937,Ingenheim,67220,67,25,74,12,93,60,165,99
25938,Ingolsheim,67221,67,20,85,15,95,70,180,105
25939,Ingwiller,67222,67,510,871,448,1476,630,2554,1381
25940,Innenheim,67223,67,133,297,79,373,228,680,430
25941,Issenhausen,67225,67,6,21,12,22,24,58,27
25942,Ittenheim,67226,67,234,445,210,830,408,1448,679
25943,Itterswiller,67227,67,45,80,10,85,30,125,125
25944,Neugartheim-Ittlenheim,67228,67,22,229,46,256,172,474,251
25945,Jetterswiller,67229,67,12,40,15,58,32,105,52
25946,Kaltenhouse,67230,67,227,559,299,591,421,1311,786
25947,Kauffenheim,67231,67,6,37,9,75,40,124,43
25948,Keffenach,67232,67,10,35,35,90,25,150,45
25949,Kertzfeld,67233,67,76,308,106,442,238,786,384
25950,Keskastel,67234,67,190,386,150,505,305,960,576
25951,Kesseldorf,67235,67,35,90,15,150,110,275,125
25952,Kienheim,67236,67,68,140,16,224,128,368,208
25953,Kilstett,67237,67,240,660,240,864,536,1640,900
25954,Kindwiller,67238,67,65,140,56,187,117,360,205
25955,Kintzheim,67239,67,331,324,86,467,300,853,655
25956,Kirchheim,67240,67,75,149,60,216,133,409,224
25957,Kirrberg,67241,67,22,33,12,47,34,93,55
25958,Kirrwiller,67242,67,48,140,60,160,124,344,188
25959,Kleingoeft,67244,67,20,25,20,55,20,95,45
25960,Knoersheim,67245,67,12,50,20,64,35,119,62
25961,Kogenheim,67246,67,140,294,124,381,223,728,434
25962,Kolbsheim,67247,67,81,231,95,295,153,543,312
25963,Krautergersheim,67248,67,200,390,135,630,370,1135,590
25964,Krautwiller,67249,67,8,21,43,81,12,136,29
25965,Kriegsheim,67250,67,51,188,80,298,107,485,239
25966,Kurtzenhouse,67252,67,136,228,108,300,248,656,364
25967,Kuttolsheim,67253,67,120,130,50,210,105,365,250
25968,Kutzenhausen,67254,67,128,190,128,260,188,576,318
25969,Lalaye,67255,67,70,70,39,184,55,278,140
25970,Lampertheim,67256,67,430,545,240,1190,470,1900,975
25971,Lampertsloch,67257,67,145,140,79,229,135,443,285
25972,Landersheim,67258,67,13,58,9,67,33,109,71
25973,Langensoultzbach,67259,67,60,231,99,281,188,568,291
25974,Laubach,67260,67,28,72,44,96,68,208,100
25975,Lauterbourg,67261,67,175,460,250,870,464,1584,635
25976,Lembach,67263,67,245,346,139,491,262,892,591
25977,Leutenheim,67264,67,88,204,72,308,196,576,292
25978,Lichtenberg,67265,67,100,102,67,155,78,300,202
25979,Limersheim,67266,67,96,152,48,236,148,432,248
25980,Lingolsheim,67267,67,2062,4228,1970,5722,3374,11066,6290
25981,Lipsheim,67268,67,267,520,270,957,465,1692,787
25982,Littenheim,67269,67,35,65,25,85,75,185,100
25983,Lixhausen,67270,67,25,115,12,122,58,192,140
25984,Lobsann,67271,67,60,110,45,205,85,335,170
25985,Lochwiller,67272,67,70,104,15,163,83,261,174
25986,Lohr,67273,67,52,116,56,192,68,316,168
25987,Lorentzen,67274,67,26,52,16,58,48,122,78
25988,Lupstein,67275,67,100,195,55,250,185,490,295
25989,Lutzelhouse,67276,67,210,382,159,660,316,1135,592
25990,Mackenheim,67277,67,83,150,68,275,133,476,233
25991,Mackwiller,67278,67,85,105,80,209,90,379,190
25992,Maennolsheim,67279,67,10,85,25,55,65,145,95
25993,Maisonsgoutte,67280,67,99,195,47,242,172,461,294
25994,Marckolsheim,67281,67,405,1025,475,1365,790,2630,1430
25995,Marlenheim,67282,67,475,1038,340,1302,825,2467,1513
25996,Marmoutier,67283,67,299,637,250,822,557,1629,936
25997,Matzenheim,67285,67,93,344,100,573,218,891,437
25998,Meistratzheim,67286,67,100,346,118,502,295,915,446
25999,Melsheim,67287,67,41,140,47,187,110,344,181
26000,Memmelshoffen,67288,67,40,68,24,144,60,228,108
26001,Menchhoffen,67289,67,88,128,40,204,128,372,216
26002,Merkwiller-Pechelbronn,67290,67,145,175,85,310,205,600,320
26003,Mertzwiller,67291,67,370,761,328,1102,707,2137,1131
26004,Mietesheim,67292,67,108,104,88,260,92,440,212
26005,Minversheim,67293,67,79,187,54,156,145,355,266
26006,Mittelbergheim,67295,67,95,165,35,310,65,410,260
26007,Mittelhausbergen,67296,67,322,393,233,581,357,1171,715
26008,Mittelschaeffolsheim,67298,67,16,154,43,150,130,323,170
26009,Mollkirch,67299,67,75,280,50,355,155,560,355
26010,Molsheim,67300,67,981,2078,1164,2802,1838,5804,3059
26011,Mommenheim,67301,67,268,377,239,562,254,1055,645
26012,Monswiller,67302,67,224,544,156,692,472,1320,768
26013,Morsbronn-les-Bains,67303,67,45,167,60,190,150,400,212
26014,Morschwiller,67304,67,40,150,70,250,85,405,190
26015,Mothern,67305,67,228,442,216,754,369,1339,670
26016,Muhlbach-sur-Bruche,67306,67,92,156,64,200,116,380,248
26017,Mulhausen,67307,67,43,97,39,122,104,265,140
26018,Munchhausen,67308,67,64,139,49,247,130,426,203
26019,Mundolsheim,67309,67,626,996,430,1918,778,3126,1622
26020,Mussig,67310,67,110,225,120,500,195,815,335
26021,Muttersholtz,67311,67,234,451,203,654,398,1255,685
26022,Mutzenhouse,67312,67,49,95,26,123,102,251,144
26023,Mutzig,67313,67,555,1497,708,1539,1029,3276,2052
26024,Natzwiller,67314,67,75,110,65,220,60,345,185
26025,Neewiller-près-Lauterbourg,67315,67,66,102,59,206,125,390,168
26026,Neubois,67317,67,48,172,34,220,159,413,220
26027,Neuhaeusel,67319,67,35,70,25,135,75,235,105
26028,Neuve-Église,67320,67,104,152,52,204,100,356,256
26029,Neuviller-la-Roche,67321,67,28,101,32,79,79,190,129
26030,Neuwiller-lès-Saverne,67322,67,153,299,68,405,210,683,452
26031,Niederbronn-les-Bains,67324,67,637,829,369,1474,726,2569,1466
26032,Niederhaslach,67325,67,142,393,137,433,229,799,535
26033,Niederhausbergen,67326,67,178,250,156,548,173,877,428
26034,Niederlauterbach,67327,67,124,220,65,363,183,611,344
26035,Niedermodern,67328,67,90,235,70,260,250,580,325
26036,Niedernai,67329,67,79,297,118,401,235,754,376
26037,Niederroedern,67330,67,85,215,85,320,215,620,300
26038,Niederschaeffolsheim,67331,67,139,278,96,503,270,869,417
26039,Niedersoultzbach,67333,67,15,46,13,102,29,144,61
26040,Niedersteinbach,67334,67,45,10,15,45,10,70,55
26041,Nordheim,67335,67,97,199,50,277,171,498,296
26042,Nordhouse,67336,67,225,413,145,539,408,1092,638
26043,Nothalten,67337,67,68,124,32,132,104,268,192
26044,Obenheim,67338,67,172,384,116,441,292,849,556
26045,Betschdorf,67339,67,471,862,445,1312,868,2625,1333
26046,Oberbronn,67340,67,183,351,109,469,244,822,534
26047,Oberdorf-Spachbach,67341,67,24,67,16,154,72,242,91
26048,Oberhaslach,67342,67,150,438,160,564,336,1060,588
26049,Oberhausbergen,67343,67,525,1017,592,1556,1020,3168,1542
26050,Oberhoffen-lès-Wissembourg,67344,67,20,80,40,128,64,232,100
26051,Oberhoffen-sur-Moder,67345,67,357,751,328,1149,707,2184,1108
26052,Oberlauterbach,67346,67,55,113,42,155,111,308,168
26053,Obermodern-Zutzendorf,67347,67,205,382,120,581,382,1083,587
26054,Obernai,67348,67,1471,2167,1361,3392,2078,6831,3638
26055,Oberroedern,67349,67,45,155,55,155,125,335,200
26056,Oberschaeffolsheim,67350,67,300,523,160,854,434,1448,823
26057,Seebach,67351,67,195,361,155,680,280,1115,556
26058,Obersoultzbach,67352,67,45,110,8,122,91,221,155
26059,Obersteinbach,67353,67,25,55,5,126,30,161,80
26060,Odratzheim,67354,67,41,135,8,168,93,269,176
26061,Oermingen,67355,67,123,243,78,282,200,560,366
26062,Offendorf,67356,67,350,520,198,793,463,1454,870
26063,Offwiller,67358,67,85,175,90,320,145,555,260
26064,Ohlungen,67359,67,141,309,88,464,237,789,450
26065,Ohnenheim,67360,67,80,251,132,296,218,646,331
26066,Olwisheim,67361,67,32,108,62,149,91,302,140
26067,Orschwiller,67362,67,80,125,45,230,120,395,205
26068,Osthoffen,67363,67,92,208,64,268,208,540,300
26069,Osthouse,67364,67,124,204,96,356,124,576,328
26070,Ostwald,67365,67,1409,2937,1314,3951,2133,7398,4346
26071,Ottersthal,67366,67,135,120,55,220,135,410,255
26072,Otterswiller,67367,67,180,315,77,424,260,761,495
26073,Ottrott,67368,67,176,295,113,635,220,968,471
26074,Ottwiller,67369,67,44,49,16,70,40,126,93
26075,Petersbach,67370,67,95,155,50,230,120,400,250
26076,La Petite-Pierre,67371,67,56,96,48,280,80,408,152
26077,Val de Moder,67372,67,596,1210,614,1600,922,3136,1806
26078,Pfalzweyer,67373,67,50,75,25,125,60,210,125
26079,Pfulgriesheim,67375,67,184,295,84,467,214,765,479
26080,Plaine,67377,67,136,204,88,352,180,620,340
26081,Plobsheim,67378,67,459,999,442,1448,794,2684,1458
26082,Preuschdorf,67379,67,90,235,90,325,200,615,325
26083,Printzheim,67380,67,22,34,13,65,41,119,56
26084,Puberg,67381,67,64,96,16,100,64,180,160
26085,Quatzenheim,67382,67,110,190,60,255,180,495,300
26086,Rangen,67383,67,15,65,20,58,65,143,80
26087,Ranrupt,67384,67,72,60,20,128,56,204,132
26088,Ratzwiller,67385,67,30,55,10,120,50,180,85
26089,Rauwiller,67386,67,29,33,31,62,23,116,62
26090,Reichsfeld,67387,67,22,66,12,78,68,158,88
26091,Reichshoffen,67388,67,811,1277,517,1788,947,3252,2088
26092,Reichstett,67389,67,687,906,301,1609,776,2686,1593
26093,Reinhardsmunster,67391,67,52,106,33,135,73,241,158
26094,Reipertswiller,67392,67,115,185,75,330,195,600,300
26095,Retschwiller,67394,67,28,45,20,90,54,164,73
26096,Reutenbourg,67395,67,40,85,40,110,83,233,125
26097,Rexingen,67396,67,25,60,5,70,50,125,85
26098,Rhinau,67397,67,296,617,279,924,503,1706,913
26099,Richtolsheim,67398,67,40,75,20,105,90,215,115
26100,Riedseltz,67400,67,145,255,85,330,265,680,400
26101,Rimsdorf,67401,67,76,80,28,72,72,172,156
26102,Ringeldorf,67402,67,4,32,12,32,29,73,36
26103,Ringendorf,67403,67,23,121,27,111,115,253,144
26104,Rittershoffen,67404,67,100,190,100,333,175,608,290
26105,Roeschwoog,67405,67,236,572,272,704,508,1484,808
26106,Rohr,67406,67,32,64,32,108,40,180,96
26107,Rohrwiller,67407,67,196,410,148,520,430,1098,606
26108,Romanswiller,67408,67,143,336,79,418,261,758,479
26109,Roppenheim,67409,67,66,220,66,290,229,585,286
26110,Rosenwiller,67410,67,142,150,35,230,145,410,292
26111,Rosheim,67411,67,716,1084,512,1506,965,2983,1800
26112,Rossfeld,67412,67,90,260,100,350,175,625,350
26113,Rosteig,67413,67,131,85,40,248,60,348,216
26114,Rothau,67414,67,245,365,145,525,260,930,610
26115,Rothbach,67415,67,68,96,47,118,86,251,164
26116,Rott,67416,67,45,115,45,130,145,320,160
26117,Rottelsheim,67417,67,36,67,17,90,58,165,103
26118,Rountzenheim,67418,67,95,220,85,390,220,695,315
26119,Russ,67420,67,145,299,104,444,210,758,444
26120,Saales,67421,67,90,160,70,275,115,460,250
26121,Saasenheim,67422,67,48,160,48,212,124,384,208
26122,Saessolsheim,67423,67,64,136,40,168,120,328,200
26123,Saint-Blaise-la-Roche,67424,67,36,64,16,108,24,148,100
26124,Saint-Jean-Saverne,67425,67,80,115,35,253,100,388,195
26125,Saint-Martin,67426,67,44,54,34,113,52,199,98
26126,Saint-Maurice,67427,67,68,100,48,128,60,236,168
26127,Saint-Nabor,67428,67,82,100,41,125,102,268,182
26128,Saint-Pierre,67429,67,46,125,66,219,72,357,171
26129,Saint-Pierre-Bois,67430,67,92,172,72,288,140,500,264
26130,Salmbach,67432,67,45,123,43,217,81,341,168
26131,Sand,67433,67,84,272,124,468,172,764,356
26132,Sarre-Union,67434,67,408,557,321,963,539,1823,965
26133,Sarrewerden,67435,67,95,200,70,355,170,595,295
26134,Saulxures,67436,67,56,104,52,172,108,332,160
26135,Saverne,67437,67,1535,2556,1422,3523,2075,7020,4091
26136,Schaeffersheim,67438,67,124,196,76,312,132,520,320
26137,Schaffhouse-sur-Zorn,67439,67,44,108,36,88,124,248,152
26138,Schaffhouse-près-Seltz,67440,67,70,140,30,205,130,365,210
26139,Schalkendorf,67441,67,24,80,32,116,60,208,104
26140,Scharrachbergheim-Irmstett,67442,67,112,256,136,408,228,772,368
26141,Scheibenhard,67443,67,64,168,30,354,144,528,232
26142,Scherlenheim,67444,67,21,25,8,41,16,65,46
26143,Scherwiller,67445,67,377,762,246,1078,518,1842,1139
26144,Schillersdorf,67446,67,60,80,32,188,80,300,140
26145,Schiltigheim,67447,67,3093,7609,4535,8763,6800,20098,10702
26146,Schirmeck,67448,67,324,510,254,663,381,1298,834
26147,Schirrhein,67449,67,196,507,202,728,495,1425,703
26148,Schirrhoffen,67450,67,32,132,101,263,109,473,164
26149,Schleithal,67451,67,196,292,144,556,260,960,488
26150,Schnersheim,67452,67,108,412,144,457,371,972,520
26151,Schoenau,67453,67,36,160,72,212,132,416,196
26152,Schoenbourg,67454,67,25,100,30,205,70,305,125
26153,Schoenenbourg,67455,67,60,152,92,240,144,476,212
26154,Schopperten,67456,67,31,131,13,156,84,253,162
26155,Schweighouse-sur-Moder,67458,67,585,1057,506,1599,970,3075,1642
26156,Schwenheim,67459,67,55,180,80,275,155,510,235
26157,Schwindratzheim,67460,67,220,372,140,564,276,980,592
26158,Schwobsheim,67461,67,55,120,20,85,65,170,175
26159,Sélestat,67462,67,2115,4474,2800,5959,3758,12517,6589
26160,Seltz,67463,67,337,779,300,1038,765,2103,1116
26161,Sermersheim,67464,67,55,275,70,305,205,580,330
26162,Sessenheim,67465,67,250,579,206,673,488,1367,829
26163,Siegen,67466,67,45,115,50,200,105,355,160
26164,Siewiller,67467,67,65,125,40,105,65,210,190
26165,Siltzheim,67468,67,116,140,56,216,116,388,256
26166,Solbach,67470,67,14,26,6,52,9,67,40
26167,Souffelweyersheim,67471,67,967,1606,800,2609,1493,4902,2573
26168,Soufflenheim,67472,67,695,1150,460,1570,1030,3060,1845
26169,Soultz-les-Bains,67473,67,114,215,149,274,199,622,329
26170,Soultz-sous-Forêts,67474,67,296,711,321,998,588,1907,1007
26171,Sparsbach,67475,67,30,65,25,90,40,155,95
26172,Stattmatten,67476,67,85,130,80,250,135,465,215
26173,Steige,67477,67,105,140,45,170,120,335,245
26174,Steinbourg,67478,67,315,455,140,760,335,1235,770
26175,Steinseltz,67479,67,131,116,55,212,105,372,247
26176,Still,67480,67,137,444,129,593,363,1085,581
26177,Stotzheim,67481,67,126,239,91,287,192,570,365
26178,Strasbourg,67482,67,24623,66353,53761,67005,54065,174831,90976
26179,Struth,67483,67,45,30,10,95,65,170,75
26180,Stundwiller,67484,67,29,109,33,135,97,265,138
26181,Stutzheim-Offenheim,67485,67,170,300,105,595,210,910,470
26182,Sundhouse,67486,67,132,523,132,464,400,996,655
26183,Surbourg,67487,67,161,336,178,594,325,1097,497
26184,Thal-Drulingen,67488,67,15,55,5,65,35,105,70
26185,Thal-Marmoutier,67489,67,95,121,60,310,110,480,216
26186,Thanvillé,67490,67,115,165,30,190,105,325,280
26187,Tieffenbach,67491,67,29,40,12,95,50,157,69
26188,Traenheim,67492,67,35,155,75,240,145,460,190
26189,Triembach-au-Val,67493,67,59,113,15,158,112,285,172
26190,Trimbach,67494,67,50,170,85,160,115,360,220
26191,Truchtersheim,67495,67,420,893,325,1470,663,2458,1313
26192,Uhlwiller,67497,67,72,182,31,211,141,383,254
26193,Uhrwiller,67498,67,92,172,60,256,140,456,264
26194,Urbeis,67499,67,56,85,25,135,40,200,141
26195,Urmatt,67500,67,184,360,116,504,296,916,544
26196,Uttenheim,67501,67,38,115,36,247,78,361,153
26197,Uttenhoffen,67502,67,15,45,10,80,35,125,60
26198,Uttwiller,67503,67,33,38,0,48,19,67,71
26199,Valff,67504,67,161,271,93,417,274,784,432
26200,La Vancelle,67505,67,38,58,16,196,48,260,96
26201,Vendenheim,67506,67,607,1309,472,2109,917,3498,1916
26202,Villé,67507,67,238,457,134,528,392,1054,695
26203,Voellerdingen,67508,67,37,61,33,129,62,224,98
26204,Volksberg,67509,67,29,77,29,129,42,200,106
26205,Wahlenheim,67510,67,29,92,30,138,77,245,121
26206,Walbourg,67511,67,81,209,28,265,215,508,290
26207,Waldersbach,67513,67,5,25,20,60,25,105,30
26208,Waldhambach,67514,67,95,111,29,212,97,338,206
26209,Waldolwisheim,67515,67,84,140,24,172,132,328,224
26210,Waltenheim-sur-Zorn,67516,67,55,134,38,210,137,385,189
26211,Wangen,67517,67,85,145,60,260,120,440,230
26212,La Wantzenau,67519,67,743,1297,407,2162,1023,3592,2040
26213,Wasselonne,67520,67,580,1270,664,1881,1052,3597,1850
26214,Weinbourg,67521,67,38,78,51,153,75,279,116
26215,Weislingen,67522,67,83,120,55,220,85,360,203
26216,Weitbruch,67523,67,324,667,250,1046,568,1864,991
26217,Weiterswiller,67524,67,95,105,45,185,95,325,200
26218,Westhoffen,67525,67,214,415,140,534,360,1034,629
26219,Westhouse,67526,67,160,360,166,462,320,948,520
26220,Westhouse-Marmoutier,67527,67,26,49,38,53,46,137,75
26221,Weyer,67528,67,75,135,55,195,130,380,210
26222,Weyersheim,67529,67,551,817,219,1119,638,1976,1368
26223,Wickersheim-Wilshausen,67530,67,76,85,35,164,60,259,161
26224,Wildersbach,67531,67,56,70,10,62,63,135,126
26225,Willgottheim,67532,67,75,230,115,365,210,690,305
26226,Wilwisheim,67534,67,62,165,54,253,134,441,227
26227,Wimmenau,67535,67,132,242,93,431,170,694,374
26228,Windstein,67536,67,20,10,15,95,15,125,30
26229,Wingen,67537,67,75,105,49,155,79,283,180
26230,Wingen-sur-Moder,67538,67,299,335,175,524,284,983,634
26231,Wingersheim les Quatre Bans,67539,67,232,520,179,887,414,1480,752
26232,Wintershouse,67540,67,36,264,92,208,300,600,300
26233,Wintzenbach,67541,67,60,115,40,220,125,385,175
26234,Wintzenheim-Kochersberg,67542,67,45,105,15,120,70,205,150
26235,Wisches,67543,67,208,540,155,715,450,1320,748
26236,Wissembourg,67544,67,840,1625,696,2770,1524,4990,2465
26237,Witternheim,67545,67,40,150,70,180,80,330,190
26238,Wittersheim,67546,67,60,132,48,220,124,392,192
26239,Wittisheim,67547,67,215,470,175,825,395,1395,685
26240,Wiwersheim,67548,67,27,227,106,279,169,554,254
26241,Woerth,67550,67,237,411,131,580,285,996,648
26242,Wolfisheim,67551,67,405,861,451,1463,690,2604,1266
26243,Wolfskirchen,67552,67,76,92,36,88,60,184,168
26244,Wolschheim,67553,67,24,75,46,80,47,173,99
26245,Wolxheim,67554,67,128,184,70,319,174,563,312
26246,Zehnacker,67555,67,15,65,20,75,65,160,80
26247,Zeinheim,67556,67,6,54,26,51,47,124,60
26248,Zellwiller,67557,67,45,208,36,224,155,415,253
26249,Zinswiller,67558,67,90,170,70,290,150,510,260
26250,Zittersheim,67559,67,33,37,13,75,45,133,70
26251,Zoebersdorf,67560,67,28,24,16,72,20,108,52
26252,Algolsheim,68001,68,85,300,79,420,260,759,385
26253,Altenach,68002,68,30,72,27,128,64,219,102
26254,Altkirch,68004,68,700,1361,708,1671,1123,3502,2061
26255,Ammerschwihr,68005,68,270,306,160,638,256,1054,576
26256,Bernwiller,68006,68,60,358,79,381,292,752,418
26257,Andolsheim,68007,68,285,510,210,880,285,1375,795
26258,Appenwihr,68008,68,55,135,56,210,111,377,190
26259,Artzenheim,68009,68,64,252,52,252,184,488,316
26260,Aspach,68010,68,155,280,90,375,225,690,435
26261,Aspach-le-Bas,68011,68,89,355,75,470,265,810,444
26262,Aspach-Michelbach,68012,68,155,538,200,640,309,1149,693
26263,Attenschwiller,68013,68,112,196,72,380,152,604,308
26264,Aubure,68014,68,22,65,30,108,67,205,87
26265,Baldersheim,68015,68,218,582,192,1044,432,1668,800
26266,Balgau,68016,68,79,223,101,309,186,596,302
26267,Ballersdorf,68017,68,117,181,66,283,120,469,298
26268,Balschwiller,68018,68,84,183,74,243,141,458,267
26269,Baltzenheim,68019,68,25,125,55,270,90,415,150
26270,Bantzenheim,68020,68,228,344,96,542,328,966,572
26271,Bartenheim,68021,68,409,865,321,1269,780,2370,1274
26272,Battenheim,68022,68,169,328,102,506,294,902,497
26273,Beblenheim,68023,68,101,214,92,309,149,550,315
26274,Bellemagny,68024,68,20,10,40,30,0,70,30
26275,Bendorf,68025,68,10,45,10,95,45,150,55
26276,Bennwihr,68026,68,155,343,107,398,227,732,498
26277,Berentzwiller,68027,68,55,60,10,125,55,190,115
26278,Bergheim,68028,68,190,475,245,630,420,1295,665
26279,Bergholtz,68029,68,152,236,104,376,192,672,388
26280,Bergholtzzell,68030,68,55,130,50,145,75,270,185
26281,Berrwiller,68032,68,112,320,52,440,260,752,432
26282,Bettendorf,68033,68,45,80,80,185,80,345,125
26283,Bettlach,68034,68,28,66,6,133,50,189,94
26284,Biederthal,68035,68,29,70,39,112,34,185,99
26285,Biesheim,68036,68,251,634,221,773,523,1517,885
26286,Biltzheim,68037,68,20,85,60,145,85,290,105
26287,Bischwihr,68038,68,105,220,90,390,155,635,325
26288,Bisel,68039,68,70,110,50,240,80,370,180
26289,Bitschwiller-lès-Thann,68040,68,290,485,195,620,355,1170,775
26290,Blodelsheim,68041,68,121,400,146,725,341,1212,521
26291,Blotzheim,68042,68,365,1075,404,1642,1010,3056,1440
26292,Bollwiller,68043,68,428,923,464,1297,666,2427,1351
26293,Le Bonhomme,68044,68,90,210,65,275,112,452,300
26294,Bourbach-le-Bas,68045,68,65,130,25,205,145,375,195
26295,Bourbach-le-Haut,68046,68,39,103,16,134,96,246,142
26296,Bouxwiller,68049,68,30,76,30,159,58,247,106
26297,Bréchaumont,68050,68,40,95,40,170,60,270,135
26298,Breitenbach-Haut-Rhin,68051,68,115,180,70,336,144,550,295
26299,Bretten,68052,68,8,36,13,67,33,113,44
26300,Brinckheim,68054,68,13,64,19,149,55,223,77
26301,Bruebach,68055,68,96,229,78,416,156,650,325
26302,Brunstatt-Didenheim,68056,68,1135,1543,893,2747,1318,4958,2678
26303,Buethwiller,68057,68,34,73,33,55,44,132,107
26304,Buhl,68058,68,387,832,333,1108,621,2062,1219
26305,Burnhaupt-le-Bas,68059,68,175,459,234,538,417,1189,634
26306,Burnhaupt-le-Haut,68060,68,198,460,140,590,400,1130,658
26307,Buschwiller,68061,68,152,204,80,352,208,640,356
26308,Carspach,68062,68,192,456,211,688,325,1224,648
26309,Cernay,68063,68,1216,2807,1294,3343,2234,6871,4023
26310,Chalampé,68064,68,155,180,65,360,180,605,335
26311,Chavannes-sur-l'Étang,68065,68,40,240,65,160,205,430,280
26312,Colmar,68066,68,8213,16325,9336,18907,13507,41750,24538
26313,Courtavon,68067,68,40,90,30,115,80,225,130
26314,Dannemarie,68068,68,215,555,265,725,380,1370,770
26315,Dessenheim,68069,68,92,394,68,432,301,801,486
26316,Diefmatten,68071,68,15,82,23,54,69,146,97
26317,Dietwiller,68072,68,111,352,90,612,216,918,463
26318,Dolleren,68073,68,44,160,36,120,104,260,204
26319,Durlinsdorf,68074,68,48,141,76,176,104,356,189
26320,Durmenach,68075,68,96,190,95,258,155,508,286
26321,Durrenentzen,68076,68,50,230,85,270,255,610,280
26322,Eglingen,68077,68,28,108,32,84,100,216,136
26323,Eguisheim,68078,68,230,360,165,619,370,1154,590
26324,Elbach,68079,68,16,52,0,86,61,147,68
26325,Emlingen,68080,68,25,65,15,95,80,190,90
26326,Saint-Bernard,68081,68,75,122,27,199,91,317,197
26327,Ensisheim,68082,68,705,1726,961,2053,1509,4523,2431
26328,Eschbach-au-Val,68083,68,70,90,15,140,50,205,160
26329,Eschentzwiller,68084,68,140,384,92,544,332,968,524
26330,Eteimbes,68085,68,56,80,24,136,76,236,136
26331,Falkwiller,68086,68,12,47,12,39,44,95,59
26332,Feldbach,68087,68,30,110,45,168,100,313,140
26333,Feldkirch,68088,68,91,245,79,332,185,596,336
26334,Fellering,68089,68,235,382,115,575,345,1035,617
26335,Ferrette,68090,68,80,145,55,219,155,429,225
26336,Fessenheim,68091,68,170,630,255,754,549,1558,800
26337,Fislis,68092,68,25,110,50,160,70,280,135
26338,Flaxlanden,68093,68,205,312,90,512,257,859,517
26339,Folgensbourg,68094,68,103,273,58,226,212,496,376
26340,Fortschwihr,68095,68,58,286,71,432,220,723,344
26341,Franken,68096,68,40,63,26,110,36,172,103
26342,Fréland,68097,68,176,352,76,492,224,792,528
26343,Friesen,68098,68,90,135,70,215,115,400,225
26344,Froeningen,68099,68,61,111,70,271,106,447,172
26345,Fulleren,68100,68,35,60,15,165,40,220,95
26346,Galfingue,68101,68,55,195,40,320,190,550,250
26347,Geishouse,68102,68,75,80,20,215,60,295,155
26348,Geispitzen,68103,68,46,100,21,135,85,241,146
26349,Geiswasser,68104,68,20,77,27,114,70,211,97
26350,Gildwiller,68105,68,50,65,20,110,55,185,115
26351,Goldbach-Altenbach,68106,68,25,75,20,135,40,195,100
26352,Gommersdorf,68107,68,48,64,52,120,64,236,112
26353,Griesbach-au-Val,68109,68,88,176,56,332,100,488,264
26354,Grussenheim,68110,68,103,193,57,210,182,449,296
26355,Gueberschwihr,68111,68,132,184,48,240,184,472,316
26356,Guebwiller,68112,68,1530,2479,1322,3510,2088,6920,4009
26357,Guémar,68113,68,159,281,107,453,233,793,440
26358,Guevenatten,68114,68,20,24,8,56,24,88,44
26359,Guewenheim,68115,68,130,305,165,498,205,868,435
26360,Gundolsheim,68116,68,45,190,50,300,140,490,235
26361,Gunsbach,68117,68,112,240,76,280,224,580,352
26362,Habsheim,68118,68,542,1138,440,1713,949,3102,1680
26363,Hagenbach,68119,68,37,183,44,218,119,381,220
26364,Hagenthal-le-Bas,68120,68,128,276,100,397,308,805,404
26365,Hagenthal-le-Haut,68121,68,47,151,16,234,110,360,198
26366,Hartmannswiller,68122,68,50,198,35,238,140,413,248
26367,Hattstatt,68123,68,85,155,60,350,140,550,240
26368,Hausgauen,68124,68,35,80,20,200,55,275,115
26369,Hecken,68125,68,13,130,35,158,81,274,143
26370,Hégenheim,68126,68,385,722,261,1344,693,2298,1107
26371,Heidwiller,68127,68,84,108,36,280,96,412,192
26372,Heimersdorf,68128,68,81,186,47,191,119,357,267
26373,Heimsbrunn,68129,68,151,297,26,481,251,758,448
26374,Heiteren,68130,68,92,268,100,348,200,648,360
26375,Heiwiller,68131,68,12,38,9,47,40,96,50
26376,Helfrantzkirch,68132,68,110,125,60,310,105,475,235
26377,Herrlisheim-près-Colmar,68134,68,254,404,110,633,404,1147,658
26378,Hésingue,68135,68,302,620,291,877,517,1685,922
26379,Hettenschlag,68136,68,28,92,20,108,96,224,120
26380,Hindlingen,68137,68,53,158,61,163,122,346,211
26381,Hirsingue,68138,68,270,512,170,695,410,1275,782
26382,Hirtzbach,68139,68,152,308,192,456,272,920,460
26383,Hirtzfelden,68140,68,116,272,132,400,280,812,388
26384,Hochstatt,68141,68,318,424,124,689,366,1179,742
26385,Hohrod,68142,68,64,52,20,80,76,176,116
26386,Porte du Ried,68143,68,155,409,114,700,314,1128,564
26387,Hombourg,68144,68,125,343,99,370,319,788,468
26388,Horbourg-Wihr,68145,68,725,1108,599,1870,1068,3537,1833
26389,Houssen,68146,68,198,453,206,700,407,1313,651
26390,Hunawihr,68147,68,35,152,33,211,113,357,187
26391,Hundsbach,68148,68,46,95,27,104,52,183,141
26392,Huningue,68149,68,775,1703,679,2147,1689,4515,2478
26393,Husseren-les-Châteaux,68150,68,76,112,32,133,122,287,188
26394,Husseren-Wesserling,68151,68,138,167,116,338,138,592,305
26395,Illfurth,68152,68,286,586,338,806,444,1588,872
26396,Illhaeusern,68153,68,80,150,44,219,133,396,230
26397,Illzach,68154,68,1741,3662,1555,4426,2777,8758,5403
26398,Ingersheim,68155,68,583,1050,485,1345,940,2770,1633
26399,Issenheim,68156,68,370,740,325,1230,575,2130,1110
26400,Jebsheim,68157,68,85,348,154,427,244,825,433
26401,Jettingen,68158,68,72,116,35,201,89,325,188
26402,Jungholtz,68159,68,105,210,70,335,195,600,315
26403,Kappelen,68160,68,51,144,43,183,91,317,195
26404,Katzenthal,68161,68,70,133,9,155,108,272,203
26405,Kaysersberg Vignoble,68162,68,772,1101,422,1331,915,2668,1873
26406,Kembs,68163,68,343,1221,623,1679,1017,3319,1564
26407,Kiffis,68165,68,8,49,24,112,27,163,57
26408,Kingersheim,68166,68,1374,2916,1500,4661,2263,8424,4290
26409,Kirchberg,68167,68,97,203,69,290,85,444,300
26410,Knoeringue,68168,68,20,76,20,121,85,226,96
26411,Koestlach,68169,68,50,125,55,130,135,320,175
26412,Koetzingue,68170,68,48,156,28,217,149,394,204
26413,Kruth,68171,68,141,195,56,307,172,535,336
26414,Kunheim,68172,68,170,420,115,628,305,1048,590
26415,Labaroche,68173,68,205,538,131,840,409,1380,743
26416,Landser,68174,68,179,376,98,544,296,938,555
26417,Lapoutroie,68175,68,235,380,182,712,265,1159,615
26418,Largitzen,68176,68,30,90,35,115,60,210,120
26419,Lautenbach,68177,68,202,364,128,501,275,904,566
26420,Lautenbachzell,68178,68,105,200,90,382,195,667,305
26421,Lauw,68179,68,152,211,39,279,167,485,363
26422,Leimbach,68180,68,104,195,60,350,120,530,299
26423,Levoncourt,68181,68,24,44,36,108,24,168,68
26424,Leymen,68182,68,108,233,104,504,208,816,341
26425,Liebenswiller,68183,68,28,44,12,76,48,136,72
26426,Liebsdorf,68184,68,0,82,60,125,60,245,82
26427,Lièpvre,68185,68,209,369,205,551,282,1038,578
26428,Ligsdorf,68186,68,35,70,15,135,60,210,105
26429,Linsdorf,68187,68,24,65,19,87,65,171,89
26430,Linthal,68188,68,100,136,40,180,142,362,236
26431,Logelheim,68189,68,45,240,55,280,230,565,285
26432,Lucelle,68190,68,15,6,0,3,6,9,21
26433,Luemschwiller,68191,68,86,155,40,334,88,462,241
26434,Valdieu-Lutran,68192,68,40,105,35,155,75,265,145
26435,Luttenbach-près-Munster,68193,68,105,175,70,300,100,470,280
26436,Lutter,68194,68,35,40,30,90,60,180,75
26437,Lutterbach,68195,68,742,1400,722,2007,1212,3941,2142
26438,Magny,68196,68,8,67,28,70,74,172,75
26439,Magstatt-le-Bas,68197,68,60,120,40,140,110,290,180
26440,Magstatt-le-Haut,68198,68,24,88,8,84,60,152,112
26441,Malmerspach,68199,68,47,86,44,170,72,286,133
26442,Manspach,68200,68,64,125,85,149,158,392,189
26443,Masevaux-Niederbruck,68201,68,441,883,320,1338,624,2282,1324
26444,Mertzen,68202,68,9,36,44,71,21,136,45
26445,Merxheim,68203,68,105,323,76,449,237,762,428
26446,Metzeral,68204,68,112,230,92,413,217,722,342
26447,Meyenheim,68205,68,140,255,80,325,185,590,395
26448,Michelbach-le-Bas,68207,68,50,125,60,360,120,540,175
26449,Michelbach-le-Haut,68208,68,72,149,48,198,143,389,221
26450,Mittelwihr,68209,68,100,224,80,232,212,524,324
26451,Mittlach,68210,68,30,80,20,135,60,215,110
26452,Mitzach,68211,68,72,64,37,122,67,226,136
26453,Moernach,68212,68,48,164,76,192,108,376,212
26454,Mollau,68213,68,63,56,13,149,45,207,119
26455,Montreux-Jeune,68214,68,48,99,12,124,38,174,147
26456,Montreux-Vieux,68215,68,125,242,60,294,174,528,367
26457,Mooslargue,68216,68,44,100,60,108,112,280,144
26458,Moosch,68217,68,240,350,175,655,225,1055,590
26459,Morschwiller-le-Bas,68218,68,403,947,321,1254,645,2220,1350
26460,Le Haut Soultzbach,68219,68,79,204,101,353,177,631,283
26461,Muespach,68221,68,99,189,45,316,141,502,288
26462,Muespach-le-Haut,68222,68,60,262,129,362,263,754,322
26463,Muhlbach-sur-Munster,68223,68,121,137,31,261,134,426,258
26464,Mulhouse,68224,68,10839,30331,15770,28165,22247,66182,41170
26465,Munchhouse,68225,68,98,393,151,501,371,1023,491
26466,Munster,68226,68,778,919,544,1498,622,2664,1697
26467,Muntzenheim,68227,68,79,258,147,450,175,772,337
26468,Munwiller,68228,68,25,75,39,210,64,313,100
26469,Murbach,68229,68,21,31,4,41,27,72,52
26470,Nambsheim,68230,68,48,164,56,208,108,372,212
26471,Neuf-Brisach,68231,68,212,377,185,686,337,1208,589
26472,Neuwiller,68232,68,95,65,25,230,60,315,160
26473,Niederentzen,68234,68,32,191,78,133,195,406,223
26474,Niederhergheim,68235,68,104,235,120,425,213,758,339
26475,Niedermorschwihr,68237,68,55,95,45,235,105,385,150
26476,Niffer,68238,68,47,244,79,306,216,601,291
26477,Oberbruck,68239,68,40,85,35,180,55,270,125
26478,Illtal,68240,68,108,312,112,513,249,874,420
26479,Oberentzen,68241,68,76,149,72,172,125,369,225
26480,Oberhergheim,68242,68,90,284,77,419,244,740,374
26481,Oberlarg,68243,68,40,20,0,55,30,85,60
26482,Obermorschwihr,68244,68,72,88,20,136,56,212,160
26483,Obermorschwiller,68245,68,27,88,28,156,52,236,115
26484,Obersaasheim,68246,68,116,252,52,350,183,585,368
26485,Oderen,68247,68,178,243,77,426,179,682,421
26486,Oltingue,68248,68,92,168,76,244,144,464,260
26487,Orbey,68249,68,632,724,310,1239,500,2049,1356
26488,Orschwihr,68250,68,144,216,148,324,220,692,360
26489,Osenbach,68251,68,107,194,34,361,129,524,301
26490,Ostheim,68252,68,143,324,197,484,308,989,467
26491,Ottmarsheim,68253,68,162,384,191,609,314,1114,546
26492,Petit-Landau,68254,68,76,199,17,234,220,471,275
26493,Pfaffenheim,68255,68,149,345,130,386,320,836,494
26494,Pfastatt,68256,68,1319,2012,1161,2874,1763,5798,3331
26495,Pfetterhouse,68257,68,136,224,128,356,188,672,360
26496,Pulversheim,68258,68,349,726,232,880,621,1733,1075
26497,Raedersdorf,68259,68,21,97,57,177,83,317,118
26498,Raedersheim,68260,68,50,280,140,445,205,790,330
26499,Rammersmatt,68261,68,12,56,4,124,24,152,68
26500,Ranspach,68262,68,106,183,72,308,104,484,289
26501,Ranspach-le-Bas,68263,68,75,130,65,245,135,445,205
26502,Ranspach-le-Haut,68264,68,35,146,57,223,99,379,181
26503,Rantzwiller,68265,68,29,227,37,281,191,509,256
26504,Réguisheim,68266,68,210,399,193,713,318,1224,609
26505,Reiningue,68267,68,248,447,184,648,378,1210,695
26506,Retzwiller,68268,68,74,161,72,214,119,405,235
26507,Ribeauvillé,68269,68,580,1017,512,1415,915,2842,1597
26508,Richwiller,68270,68,430,730,408,1285,669,2362,1160
26509,Riedisheim,68271,68,1940,2549,1095,4000,2259,7354,4489
26510,Riespach,68273,68,48,168,36,244,132,412,216
26511,Rimbach-près-Guebwiller,68274,68,30,17,8,32,12,52,47
26512,Rimbach-près-Masevaux,68275,68,65,115,40,145,100,285,180
26513,Rimbachzell,68276,68,33,48,12,47,30,89,81
26514,Riquewihr,68277,68,141,261,80,379,248,707,402
26515,Rixheim,68278,68,1447,3235,1443,4524,2819,8786,4682
26516,Roderen,68279,68,110,215,60,380,145,585,325
26517,Rodern,68280,68,72,64,20,116,52,188,136
26518,Roggenhouse,68281,68,55,105,40,150,120,310,160
26519,Romagny,68282,68,32,48,40,56,60,156,80
26520,Rombach-le-Franc,68283,68,180,135,70,261,140,471,315
26521,Roppentzwiller,68284,68,51,153,46,245,154,445,204
26522,Rorschwihr,68285,68,28,94,32,120,71,223,122
26523,Rosenau,68286,68,243,532,148,832,488,1468,775
26524,Rouffach,68287,68,505,1000,430,1180,790,2400,1505
26525,Ruederbach,68288,68,56,96,16,108,88,212,152
26526,Ruelisheim,68289,68,241,423,188,1023,383,1594,664
26527,Rustenhart,68290,68,90,188,100,322,115,537,278
26528,Rumersheim-le-Haut,68291,68,105,290,80,365,270,715,395
26529,Saint-Amarin,68292,68,331,490,260,856,325,1441,821
26530,Saint-Cosme,68293,68,10,55,0,25,25,50,65
26531,Sainte-Croix-aux-Mines,68294,68,244,539,151,609,380,1140,783
26532,Sainte-Croix-en-Plaine,68295,68,375,734,244,940,555,1739,1109
26533,Saint-Hippolyte,68296,68,156,196,90,261,169,520,352
26534,Saint-Louis,68297,68,1842,4697,2549,6412,4341,13302,6539
26535,Sainte-Marie-aux-Mines,68298,68,683,1252,394,1529,903,2826,1935
26536,Saint-Ulrich,68299,68,28,64,28,100,76,204,92
26537,Sausheim,68300,68,818,1178,483,1954,909,3346,1996
26538,Schlierbach,68301,68,116,303,64,377,283,724,419
26539,Schweighouse-Thann,68302,68,98,185,62,283,95,440,283
26540,Schwoben,68303,68,15,35,35,105,25,165,50
26541,Sentheim,68304,68,200,391,145,526,230,901,591
26542,Seppois-le-Bas,68305,68,120,372,120,296,260,676,492
26543,Seppois-le-Haut,68306,68,20,106,57,160,70,287,126
26544,Sewen,68307,68,95,90,65,165,100,330,185
26545,Sickert,68308,68,85,57,24,66,45,135,142
26546,Sierentz,68309,68,216,788,482,921,841,2244,1004
26547,Sondernach,68311,68,84,149,46,193,130,369,233
26548,Sondersdorf,68312,68,25,65,30,140,75,245,90
26549,Soppe-le-Bas,68313,68,60,190,122,270,145,537,250
26550,Soultz-Haut-Rhin,68315,68,827,1671,835,2208,1438,4481,2498
26551,Soultzbach-les-Bains,68316,68,48,176,52,280,192,524,224
26552,Soultzeren,68317,68,152,232,88,383,207,678,384
26553,Soultzmatt,68318,68,239,610,175,743,530,1448,849
26554,Spechbach,68320,68,161,315,113,531,196,840,476
26555,Staffelfelden,68321,68,488,875,489,1243,652,2384,1363
26556,Steinbach,68322,68,174,265,160,563,215,938,439
26557,Steinbrunn-le-Bas,68323,68,92,136,44,252,124,420,228
26558,Steinbrunn-le-Haut,68324,68,75,115,55,225,110,390,190
26559,Steinsoultz,68325,68,36,192,52,328,168,548,228
26560,Sternenberg,68326,68,10,40,0,75,5,80,50
26561,Stetten,68327,68,45,95,5,160,55,220,140
26562,Storckensohn,68328,68,10,56,10,80,60,150,66
26563,Stosswihr,68329,68,148,296,116,500,288,904,444
26564,Strueth,68330,68,32,84,24,104,88,216,116
26565,Sundhoffen,68331,68,256,384,244,760,288,1292,640
26566,Tagolsheim,68332,68,105,215,25,263,219,507,320
26567,Tagsdorf,68333,68,40,79,38,75,40,153,119
26568,Thann,68334,68,1040,1763,866,2401,1531,4798,2803
26569,Thannenkirch,68335,68,56,71,19,165,71,255,127
26570,Traubach-le-Bas,68336,68,88,124,68,128,84,280,212
26571,Traubach-le-Haut,68337,68,60,139,84,181,110,375,199
26572,Turckheim,68338,68,558,695,330,1303,683,2316,1253
26573,Ueberstrass,68340,68,44,128,32,92,88,212,172
26574,Uffheim,68341,68,61,143,64,379,134,577,204
26575,Uffholtz,68342,68,205,371,127,497,353,977,576
26576,Ungersheim,68343,68,188,570,188,676,450,1314,758
26577,Urbès,68344,68,85,90,30,145,75,250,175
26578,Urschenheim,68345,68,76,192,36,240,156,432,268
26579,Vieux-Ferrette,68347,68,42,203,35,210,133,378,245
26580,Vieux-Thann,68348,68,400,675,316,980,515,1811,1075
26581,Village-Neuf,68349,68,545,839,299,1373,780,2452,1384
26582,Voegtlinshoffen,68350,68,64,116,40,208,112,360,180
26583,Vogelgrun,68351,68,44,172,52,216,188,456,216
26584,Volgelsheim,68352,68,219,597,214,699,534,1447,816
26585,Wahlbach,68353,68,16,136,40,172,120,332,152
26586,Walbach,68354,68,116,168,44,432,104,580,284
26587,Waldighofen,68355,68,156,328,184,496,292,972,484
26588,Walheim,68356,68,105,202,80,358,173,611,307
26589,Waltenheim,68357,68,25,156,35,245,91,371,181
26590,Wasserbourg,68358,68,36,81,22,223,67,312,117
26591,Wattwiller,68359,68,265,355,110,675,271,1056,620
26592,Weckolsheim,68360,68,16,172,48,176,200,424,188
26593,Wegscheid,68361,68,65,85,0,110,70,180,150
26594,Wentzwiller,68362,68,120,152,32,235,159,426,272
26595,Werentzhouse,68363,68,50,120,60,235,110,405,170
26596,Westhalten,68364,68,145,230,110,290,200,600,375
26597,Wettolsheim,68365,68,299,320,130,687,250,1067,619
26598,Wickerschwihr,68366,68,65,177,53,275,137,465,242
26599,Widensolen,68367,68,74,313,90,355,288,733,387
26600,Wihr-au-Val,68368,68,140,270,120,540,195,855,410
26601,Wildenstein,68370,68,15,55,15,75,30,120,70
26602,Willer,68371,68,48,56,28,132,60,220,104
26603,Willer-sur-Thur,68372,68,240,380,195,727,280,1202,620
26604,Winkel,68373,68,75,60,25,110,50,185,135
26605,Wintzenheim,68374,68,1055,1640,715,2500,1365,4580,2695
26606,Wittelsheim,68375,68,1528,2424,984,3325,1983,6292,3952
26607,Wittenheim,68376,68,1951,3548,1595,4698,2676,8969,5499
26608,Wittersdorf,68377,68,104,187,73,227,168,468,291
26609,Wolfersdorf,68378,68,28,71,25,128,48,201,99
26610,Wolfgantzen,68379,68,124,212,60,357,187,604,336
26611,Wolschwiller,68380,68,28,96,40,216,96,352,124
26612,Wuenheim,68381,68,134,180,68,285,69,422,314
26613,Zaessingue,68382,68,28,89,16,107,109,232,117
26614,Zellenberg,68383,68,50,55,35,135,55,225,105
26615,Zillisheim,68384,68,382,549,248,993,420,1661,931
26616,Zimmerbach,68385,68,125,200,55,370,110,535,325
26617,Zimmersheim,68386,68,120,210,90,447,185,722,330
26618,Affoux,69001,69,28,116,16,88,100,204,144
26619,Aigueperse,69002,69,40,68,16,92,36,144,108
26620,Albigny-sur-Saône,69003,69,215,585,222,775,466,1463,800
26621,Alix,69004,69,32,219,22,165,142,329,251
26622,Ambérieux,69005,69,48,167,32,157,142,331,215
26623,Amplepuis,69006,69,658,1166,433,1585,784,2802,1824
26624,Ampuis,69007,69,252,564,368,884,488,1740,816
26625,Ancy,69008,69,56,168,40,192,140,372,224
26626,Anse,69009,69,548,2001,656,1754,1535,3945,2549
26627,L'Arbresle,69010,69,603,1716,656,1850,1143,3649,2319
26628,Les Ardillats,69012,69,68,148,52,224,132,408,216
26629,Arnas,69013,69,334,931,294,1185,680,2159,1265
26630,Aveize,69014,69,150,250,85,305,185,575,400
26631,Avenas,69015,69,10,35,15,40,30,85,45
26632,Azolette,69016,69,40,35,10,40,5,55,75
26633,Bagnols,69017,69,69,165,30,245,97,372,234
26634,Beaujeu,69018,69,300,504,208,488,396,1092,804
26635,Belleville,69019,69,855,2239,1033,2158,1674,4865,3094
26636,Belmont-d'Azergues,69020,69,62,188,48,177,101,326,250
26637,Bessenay,69021,69,265,605,149,707,449,1305,870
26638,Bibost,69022,69,46,157,42,147,126,315,203
26639,Blacé,69023,69,161,369,100,486,255,841,530
26640,Le Bois-d'Oingt,69024,69,357,604,101,694,415,1210,961
26641,Le Breuil,69026,69,33,150,33,92,145,270,183
26642,Brignais,69027,69,1361,2983,1141,3518,2173,6832,4344
26643,Brindas,69028,69,499,1694,525,2011,1046,3582,2193
26644,Bron,69029,69,4744,10038,5282,10336,7116,22734,14782
26645,Brullioles,69030,69,100,220,76,264,160,500,320
26646,Brussieu,69031,69,90,407,129,373,268,770,497
26647,Bully,69032,69,160,572,208,572,448,1228,732
26648,Cailloux-sur-Fontaines,69033,69,188,742,160,887,564,1611,930
26649,Caluire-et-Cuire,69034,69,6466,9986,4625,12271,8182,25078,16452
26650,Cenves,69035,69,44,112,32,140,72,244,156
26651,Cercié,69036,69,105,345,60,313,280,653,450
26652,Chambost-Allières,69037,69,62,235,61,229,178,468,297
26653,Chambost-Longessaigne,69038,69,92,292,64,288,216,568,384
26654,Chamelet,69039,69,60,152,59,192,98,349,212
26655,Champagne-au-Mont-d'Or,69040,69,1007,1246,707,1717,995,3419,2253
26656,La Chapelle-sur-Coise,69042,69,20,176,40,192,128,360,196
26657,Chaponost,69043,69,951,2072,662,2995,1396,5053,3023
26658,Charbonnières-les-Bains,69044,69,863,1244,406,1711,709,2826,2107
26659,Charentay,69045,69,112,314,124,418,250,792,426
26660,Charly,69046,69,541,1201,396,1606,622,2624,1742
26661,Charnay,69047,69,60,217,86,351,182,619,277
26662,Chassagny,69048,69,129,357,114,412,238,764,486
26663,Chasselay,69049,69,357,652,152,973,408,1533,1009
26664,Châtillon,69050,69,282,549,145,689,418,1252,831
26665,Chaussan,69051,69,71,291,104,351,185,640,362
26666,Chazay-d'Azergues,69052,69,451,1045,347,1487,730,2564,1496
26667,Chénas,69053,69,44,149,52,163,100,315,193
26668,Chénelette,69054,69,57,71,33,85,45,163,128
26669,Les Chères,69055,69,88,392,156,488,312,956,480
26670,Chessy,69056,69,149,519,138,612,376,1126,668
26671,Chevinay,69057,69,88,145,30,143,145,318,233
26672,Chiroubles,69058,69,52,100,16,128,112,256,152
26673,Civrieux-d'Azergues,69059,69,176,440,136,464,304,904,616
26674,Claveisolles,69060,69,115,200,60,155,140,355,315
26675,Cogny,69061,69,145,320,105,390,205,700,465
26676,Coise,69062,69,90,245,15,240,180,435,335
26677,Collonges-au-Mont-d'Or,69063,69,402,1007,315,1416,739,2470,1409
26678,Condrieu,69064,69,549,896,450,1117,638,2205,1445
26679,Corcelles-en-Beaujolais,69065,69,96,251,80,280,176,536,347
26680,Cours,69066,69,938,951,404,1558,616,2578,1889
26681,Courzieu,69067,69,154,205,93,361,188,642,359
26682,Couzon-au-Mont-d'Or,69068,69,261,603,216,841,438,1495,864
26683,Craponne,69069,69,1450,2635,1284,3222,1991,6497,4085
26684,Cublize,69070,69,119,352,76,354,245,675,471
26685,Curis-au-Mont-d'Or,69071,69,86,313,75,397,220,692,399
26686,Dardilly,69072,69,716,2343,764,2919,1444,5127,3059
26687,Dareizé,69073,69,38,145,34,147,117,298,183
26688,Denicé,69074,69,120,342,117,551,213,881,462
26689,Dième,69075,69,12,76,12,40,56,108,88
26690,Dommartin,69076,69,283,676,190,911,425,1526,959
26691,Dracé,69077,69,45,252,75,340,240,655,297
26692,Duerne,69078,69,64,221,61,245,139,445,285
26693,Échalas,69080,69,184,497,149,485,314,948,681
26694,Écully,69081,69,2829,4371,1995,4984,2723,9702,7200
26695,Émeringes,69082,69,12,68,24,72,64,160,80
26696,Éveux,69083,69,101,289,116,408,220,744,390
26697,Fleurie,69084,69,174,296,99,359,246,704,470
26698,Fleurieu-sur-Saône,69085,69,132,380,128,436,308,872,512
26699,Fleurieux-sur-l'Arbresle,69086,69,235,635,190,823,462,1475,870
26700,Fontaines-Saint-Martin,69087,69,288,815,268,960,482,1710,1103
26701,Fontaines-sur-Saône,69088,69,862,1775,677,1979,1285,3941,2637
26702,Francheville,69089,69,1459,3989,1551,4079,2786,8416,5448
26703,Frontenas,69090,69,44,211,58,303,125,486,255
26704,Givors,69091,69,2069,5652,2390,5140,3680,11210,7721
26705,Gleizé,69092,69,1065,1888,714,2390,1311,4415,2953
26706,Grandris,69093,69,146,254,67,311,172,550,400
26707,Grézieu-la-Varenne,69094,69,694,1368,570,1660,969,3199,2062
26708,Grézieu-le-Marché,69095,69,44,224,80,272,144,496,268
26709,Grigny,69096,69,804,2661,1139,2553,2125,5817,3465
26710,Les Haies,69097,69,84,224,64,260,164,488,308
26711,Les Halles,69098,69,27,158,18,127,119,264,185
26712,Haute-Rivoire,69099,69,126,344,111,454,232,797,470
26713,Irigny,69100,69,905,2322,713,2689,1613,5015,3227
26714,Jarnioux,69101,69,75,184,21,204,139,364,259
26715,Joux,69102,69,43,184,59,249,90,398,227
26716,Juliénas,69103,69,103,178,66,322,143,531,281
26717,Jullié,69104,69,57,99,42,124,73,239,156
26718,Lacenas,69105,69,87,295,80,309,180,569,382
26719,Lachassagne,69106,69,121,298,50,352,225,627,419
26720,Lamure-sur-Azergues,69107,69,160,300,72,256,216,544,460
26721,Lancié,69108,69,110,298,92,264,225,581,408
26722,Lantignié,69109,69,95,253,82,248,147,477,348
26723,Larajasse,69110,69,212,461,143,544,353,1040,673
26724,Légny,69111,69,50,215,50,155,190,395,265
26725,Lentilly,69112,69,419,1423,446,1827,1080,3353,1842
26726,Létra,69113,69,55,245,55,250,205,510,300
26727,Liergues,69114,69,235,525,140,610,410,1160,760
26728,Limas,69115,69,704,1283,306,1464,763,2533,1987
26729,Limonest,69116,69,275,867,446,1127,531,2104,1142
26730,Lissieu,69117,69,289,920,230,1172,509,1911,1209
26731,Loire-sur-Rhône,69118,69,292,669,204,811,438,1453,961
26732,Longes,69119,69,60,240,92,312,192,596,300
26733,Longessaigne,69120,69,65,154,40,155,110,305,219
26734,Lozanne,69121,69,295,624,343,746,535,1624,919
26735,Lucenay,69122,69,195,500,115,670,285,1070,695
26736,Lyon,69123,69,48658,110908,108848,116278,106765,331891,159566
26737,Marchampt,69124,69,47,105,38,114,94,246,152
26738,Marcilly-d'Azergues,69125,69,93,204,59,268,171,498,297
26739,Marcy,69126,69,47,158,20,283,104,407,205
26740,Marcy-l'Étoile,69127,69,272,794,622,950,571,2143,1066
26741,Meaux-la-Montagne,69130,69,60,40,25,70,35,130,100
26742,Messimy,69131,69,261,980,329,1187,610,2126,1241
26743,Meys,69132,69,76,220,40,316,160,516,296
26744,Millery,69133,69,444,1125,431,1268,796,2495,1569
26745,Moiré,69134,69,15,50,20,85,20,125,65
26746,Monsols,69135,69,130,210,70,290,165,525,340
26747,Montagny,69136,69,300,759,180,854,535,1569,1059
26748,Montmelas-Saint-Sorlin,69137,69,28,128,33,125,77,235,156
26749,Montromant,69138,69,34,123,22,140,89,251,157
26750,Montrottier,69139,69,157,330,78,428,290,796,487
26751,Morancé,69140,69,295,580,105,615,405,1125,875
26752,Mornant,69141,69,612,1414,464,1787,1030,3281,2026
26753,La Mulatière,69142,69,901,1410,674,1871,1310,3855,2311
26754,Neuville-sur-Saône,69143,69,1123,1609,959,2014,1346,4319,2732
26755,Odenas,69145,69,115,290,90,225,230,545,405
26756,Oingt,69146,69,61,178,63,239,87,389,239
26757,Les Olmes,69147,69,60,215,75,255,175,505,275
26758,Orliénas,69148,69,216,659,188,798,465,1451,875
26759,Oullins,69149,69,3105,6361,3991,6970,5343,16304,9466
26760,Ouroux,69150,69,32,69,28,96,55,179,101
26761,Le Perréon,69151,69,137,444,156,477,263,896,581
26762,Pierre-Bénite,69152,69,908,2850,1374,2958,2020,6352,3758
26763,Poleymieux-au-Mont-d'Or,69153,69,110,300,75,350,200,625,410
26764,Pollionnay,69154,69,152,568,201,640,432,1273,720
26765,Pomeys,69155,69,94,299,58,372,253,683,393
26766,Pommiers,69156,69,279,729,107,755,523,1385,1008
26767,Pontcharra-sur-Turdine,69157,69,364,702,234,745,506,1485,1066
26768,Pouilly-le-Monial,69159,69,85,269,63,317,189,569,354
26769,Poule-les-Écharmeaux,69160,69,110,275,90,415,200,705,385
26770,Propières,69161,69,90,97,25,194,73,292,187
26771,Quincié-en-Beaujolais,69162,69,204,293,112,425,250,787,497
26772,Quincieux,69163,69,335,994,332,1021,651,2004,1329
26773,Ranchal,69164,69,72,68,24,88,76,188,140
26774,Régnié-Durette,69165,69,114,285,113,341,170,624,399
26775,Riverie,69166,69,28,76,4,88,72,164,104
26776,Rivolet,69167,69,61,173,30,149,119,298,234
26777,Rochetaillée-sur-Saône,69168,69,130,500,125,425,315,865,630
26778,Ronno,69169,69,68,152,48,284,76,408,220
26779,Rontalon,69170,69,112,342,176,276,284,736,454
26780,Sain-Bel,69171,69,180,580,250,815,435,1500,760
26781,Salles-Arbuissonnas-en-Beaujolais,69172,69,60,268,64,240,184,488,328
26782,Sarcey,69173,69,50,240,120,349,180,649,290
26783,Les Sauvages,69174,69,40,156,80,216,128,424,196
26784,Savigny,69175,69,185,525,230,695,359,1284,710
26785,Soucieu-en-Jarrest,69176,69,321,1191,461,1278,908,2647,1512
26786,Sourcieux-les-Mines,69177,69,188,544,180,688,388,1256,732
26787,Souzy,69178,69,59,218,69,232,168,469,277
26788,Saint-Andéol-le-Château,69179,69,152,446,168,611,345,1124,598
26789,Saint-André-la-Côte,69180,69,16,84,12,84,72,168,100
26790,Saint-Appolinaire,69181,69,12,48,24,52,40,116,60
26791,Saint-Bonnet-des-Bruyères,69182,69,66,65,40,126,55,221,131
26792,Saint-Bonnet-le-Troncy,69183,69,32,80,4,124,68,196,112
26793,Sainte-Catherine,69184,69,106,229,111,283,182,576,335
26794,Saint-Christophe,69185,69,25,55,19,71,33,123,80
26795,Saint-Clément-de-Vers,69186,69,26,47,34,46,34,114,73
26796,Saint-Clément-les-Places,69187,69,36,180,40,220,140,400,216
26797,Saint-Clément-sur-Valsonne,69188,69,67,271,63,171,203,437,338
26798,Sainte-Colombe,69189,69,246,430,220,614,328,1162,676
26799,Sainte-Consorce,69190,69,211,524,166,625,372,1163,735
26800,Saint-Cyr-au-Mont-d'Or,69191,69,638,1275,428,1975,849,3252,1913
26801,Saint-Cyr-le-Chatoux,69192,69,15,40,5,30,45,80,55
26802,Saint-Cyr-sur-le-Rhône,69193,69,145,363,74,454,280,808,508
26803,Saint-Didier-au-Mont-d'Or,69194,69,1025,1482,475,2398,805,3678,2507
26804,Saint-Didier-sous-Riverie,69195,69,109,350,88,413,214,715,459
26805,Saint-Didier-sur-Beaujeu,69196,69,39,195,65,195,140,400,234
26806,Saint-Étienne-des-Oullières,69197,69,245,643,211,542,435,1188,888
26807,Saint-Étienne-la-Varenne,69198,69,53,201,33,242,166,441,254
26808,Saint-Fons,69199,69,1793,5439,2200,4294,3748,10242,7232
26809,Saint-Forgeux,69200,69,169,372,135,439,297,871,541
26810,Sainte-Foy-l'Argentière,69201,69,265,312,83,379,265,727,577
26811,Sainte-Foy-lès-Lyon,69202,69,3449,5326,1859,6860,3712,12431,8775
26812,Saint-Genis-l'Argentière,69203,69,80,260,56,416,208,680,340
26813,Saint-Genis-Laval,69204,69,2515,5410,2190,6617,3664,12471,7925
26814,Saint-Genis-les-Ollières,69205,69,470,1112,482,1757,744,2983,1582
26815,Saint-Georges-de-Reneins,69206,69,394,1148,520,1442,810,2772,1542
26816,Saint-Germain-au-Mont-d'Or,69207,69,254,794,394,861,683,1938,1048
26817,Saint-Germain-Nuelles,69208,69,225,695,204,768,437,1409,920
26818,Saint-Igny-de-Vers,69209,69,101,104,36,174,66,276,205
26819,Saint-Jacques-des-Arrêts,69210,69,6,13,0,35,22,57,19
26820,Saint-Jean-d'Ardières,69211,69,280,1293,373,918,1069,2360,1573
26821,Saint-Jean-des-Vignes,69212,69,35,120,53,155,60,268,155
26822,Saint-Jean-de-Touslas,69213,69,74,220,95,265,169,529,294
26823,Saint-Jean-la-Bussière,69214,69,85,375,100,393,260,753,460
26824,Saint-Julien,69215,69,104,164,104,316,116,536,268
26825,Saint-Julien-sur-Bibost,69216,69,76,148,72,172,100,344,224
26826,Saint-Just-d'Avray,69217,69,120,185,45,270,115,430,305
26827,Saint-Lager,69218,69,128,277,116,252,204,572,405
26828,Saint-Laurent-d'Agny,69219,69,185,575,170,795,380,1345,760
26829,Saint-Laurent-de-Chamousset,69220,69,208,420,220,576,304,1100,628
26830,Saint-Laurent-d'Oingt,69222,69,84,216,28,332,152,512,300
26831,Saint-Loup,69223,69,137,269,53,268,223,544,406
26832,Saint-Mamert,69224,69,8,8,8,24,4,36,16
26833,Saint-Marcel-l'Éclairé,69225,69,41,133,47,147,88,282,174
26834,Saint-Martin-en-Haut,69227,69,482,1045,270,1194,713,2177,1527
26835,Saint-Maurice-sur-Dargoire,69228,69,244,570,182,730,422,1334,814
26836,Saint-Nizier-d'Azergues,69229,69,57,241,58,267,109,434,298
26837,Sainte-Paule,69230,69,24,104,44,92,84,220,128
26838,Saint-Pierre-la-Palud,69231,69,124,715,305,872,503,1680,839
26839,Saint-Romain-au-Mont-d'Or,69233,69,91,337,95,424,185,704,428
26840,Saint-Romain-de-Popey,69234,69,112,402,153,421,339,913,514
26841,Saint-Romain-en-Gal,69235,69,196,387,193,644,290,1127,583
26842,Saint-Romain-en-Gier,69236,69,62,161,42,136,128,306,223
26843,Saint-Sorlin,69237,69,48,128,88,248,72,408,176
26844,Saint-Symphorien-sur-Coise,69238,69,560,842,243,1078,673,1994,1402
26845,Saint-Vérand,69239,69,111,290,114,315,251,680,401
26846,Saint-Vincent-de-Reins,69240,69,96,132,68,236,132,436,228
26847,Taluyers,69241,69,232,675,241,741,488,1470,907
26848,Taponas,69242,69,96,287,90,253,202,545,383
26849,Tarare,69243,69,1574,2802,1123,3016,1861,6000,4376
26850,Tassin-la-Demi-Lune,69244,69,2488,5264,2887,6224,4488,13599,7752
26851,Ternand,69245,69,120,185,40,259,105,404,305
26852,Theizé,69246,69,124,267,96,377,225,698,391
26853,Thizy-les-Bourgs,69248,69,798,1464,548,2073,946,3567,2262
26854,Thurins,69249,69,288,819,322,822,669,1813,1107
26855,La Tour-de-Salvagny,69250,69,513,964,309,1413,732,2454,1477
26856,Trades,69251,69,20,25,15,40,10,65,45
26857,Trèves,69252,69,32,220,68,204,188,460,252
26858,Tupin-et-Semons,69253,69,56,164,28,192,156,376,220
26859,Valsonne,69254,69,100,260,92,208,224,524,360
26860,Vaugneray,69255,69,589,1421,450,1537,1028,3015,2010
26861,Vaulx-en-Velin,69256,69,3573,14614,6425,10488,9294,26207,18187
26862,Vaux-en-Beaujolais,69257,69,62,288,114,308,232,654,350
26863,Vauxrenard,69258,69,29,66,52,94,42,188,95
26864,Vénissieux,69259,69,6240,19436,8234,15075,12290,35599,25676
26865,Vernaison,69260,69,311,1358,342,1324,963,2629,1669
26866,Vernay,69261,69,16,28,8,12,20,40,44
26867,Villechenève,69263,69,56,324,52,256,208,516,380
26868,Villefranche-sur-Saône,69264,69,4261,9475,5380,8666,7421,21467,13736
26869,Ville-sur-Jarnioux,69265,69,48,222,60,308,185,553,270
26870,Villeurbanne,69266,69,13836,36729,29942,33544,30833,94319,50565
26871,Villié-Morgon,69267,69,236,553,160,653,444,1257,789
26872,Vourles,69268,69,311,894,239,1204,526,1969,1205
26873,Yzeron,69269,69,60,296,96,288,238,622,356
26874,Chaponnay,69270,69,428,1017,389,1364,700,2453,1445
26875,Chassieu,69271,69,1163,2555,1000,3307,1698,6005,3718
26876,Communay,69272,69,443,1073,343,1561,738,2642,1516
26877,Corbas,69273,69,997,2536,1036,3196,1918,6150,3533
26878,Décines-Charpieu,69275,69,3109,7108,3458,7741,5460,16659,10217
26879,Feyzin,69276,69,866,2577,1111,2909,1732,5752,3443
26880,Genas,69277,69,1218,3295,1171,4192,2297,7660,4513
26881,Genay,69278,69,526,1444,610,1763,966,3339,1970
26882,Jonage,69279,69,602,1511,556,2122,1080,3758,2113
26883,Jons,69280,69,130,355,159,423,285,867,485
26884,Marennes,69281,69,169,373,122,613,266,1001,542
26885,Meyzieu,69282,69,3738,9013,3211,9240,6214,18665,12751
26886,Mions,69283,69,1207,3544,1333,3950,2472,7755,4751
26887,Montanay,69284,69,274,780,260,1094,518,1872,1054
26888,Pusignan,69285,69,317,1086,415,1227,846,2488,1403
26889,Rillieux-la-Pape,69286,69,3296,9072,3485,8766,5554,17805,12368
26890,Saint-Bonnet-de-Mure,69287,69,558,1791,567,2323,1267,4157,2349
26891,Saint-Laurent-de-Mure,69288,69,527,1467,506,1816,1029,3351,1994
26892,Saint-Pierre-de-Chandieu,69289,69,580,1220,395,1425,898,2718,1800
26893,Saint-Priest,69290,69,5036,12346,5563,12282,8731,26576,17382
26894,Saint-Symphorien-d'Ozon,69291,69,430,1470,577,1644,1276,3497,1900
26895,Sathonay-Camp,69292,69,434,1440,734,1454,1214,3402,1874
26896,Sathonay-Village,69293,69,188,648,176,748,492,1416,836
26897,Sérézin-du-Rhône,69294,69,255,641,276,870,526,1672,896
26898,Simandres,69295,69,102,465,163,548,318,1029,567
26899,Solaize,69296,69,335,756,311,992,544,1847,1091
26900,Ternay,69297,69,500,1435,374,1770,1133,3277,1935
26901,Toussieu,69298,69,236,702,230,905,519,1654,938
26902,Colombier-Saugnieu,69299,69,180,618,248,798,536,1582,798
26903,Abelcourt,70001,70,30,95,30,125,75,230,125
26904,Aboncourt-Gesincourt,70002,70,65,35,25,65,40,130,100
26905,Achey,70003,70,25,10,5,10,10,25,35
26906,Adelans-et-le-Val-de-Bithaine,70004,70,30,70,30,85,65,180,100
26907,Aillevans,70005,70,20,35,20,60,19,99,55
26908,Aillevillers-et-Lyaumont,70006,70,195,370,125,579,300,1004,565
26909,Ailloncourt,70007,70,35,90,30,65,85,180,125
26910,Ainvelle,70008,70,25,15,25,85,5,115,40
26911,Aisey-et-Richecourt,70009,70,12,18,16,25,16,57,30
26912,Alaincourt,70010,70,10,40,15,40,20,75,50
26913,Amage,70011,70,40,85,10,145,65,220,125
26914,Amance,70012,70,55,183,60,265,80,405,238
26915,Ambiévillers,70013,70,10,3,3,35,6,44,13
26916,Amblans-et-Velotte,70014,70,40,100,48,108,76,232,140
26917,Amoncourt,70015,70,40,64,30,100,29,159,104
26918,Amont-et-Effreney,70016,70,36,36,8,64,32,104,72
26919,Anchenoncourt-et-Chazel,70017,70,33,47,13,63,43,119,80
26920,Ancier,70018,70,46,110,25,163,90,278,156
26921,Andelarre,70019,70,12,28,0,54,16,70,40
26922,Andelarrot,70020,70,8,72,16,72,60,148,80
26923,Andornay,70021,70,12,60,20,57,35,112,72
26924,Angirey,70022,70,15,25,15,60,15,90,40
26925,Anjeux,70023,70,28,31,10,21,23,54,59
26926,Apremont,70024,70,35,130,45,155,85,285,165
26927,Arbecey,70025,70,40,80,5,80,50,135,120
26928,Arc-lès-Gray,70026,70,584,518,175,831,306,1312,1102
26929,Argillières,70027,70,10,30,5,40,10,55,40
26930,Aroz,70028,70,15,25,7,60,23,90,40
26931,Arpenans,70029,70,10,86,31,62,45,138,96
26932,Arsans,70030,70,0,12,4,20,4,28,12
26933,Athesans-Étroitefontaine,70031,70,80,220,55,175,155,385,300
26934,Attricourt,70032,70,0,12,4,4,12,20,12
26935,Augicourt,70035,70,37,30,8,41,12,61,67
26936,Aulx-lès-Cromary,70036,70,8,44,4,60,36,100,52
26937,Autet,70037,70,54,65,15,85,40,140,119
26938,Authoison,70038,70,25,89,16,70,74,160,114
26939,Autoreille,70039,70,20,92,12,108,76,196,112
26940,Autrey-lès-Cerre,70040,70,20,58,17,64,38,119,78
26941,Autrey-lès-Gray,70041,70,30,75,30,149,95,274,105
26942,Autrey-le-Vay,70042,70,8,35,0,24,20,44,43
26943,Auvet-et-la-Chapelotte,70043,70,30,50,30,95,25,150,80
26944,Auxon,70044,70,35,100,20,165,90,275,135
26945,Avrigney-Virey,70045,70,52,108,36,144,80,260,160
26946,Les Aynans,70046,70,50,90,25,120,55,200,140
26947,Baignes,70047,70,4,24,4,37,17,58,28
26948,Bard-lès-Pesmes,70048,70,21,17,22,58,8,88,38
26949,Barges,70049,70,16,19,6,19,9,34,35
26950,La Barre,70050,70,5,40,5,25,40,70,45
26951,La Basse-Vaivre,70051,70,0,12,0,13,15,28,12
26952,Bassigney,70052,70,20,28,8,40,32,80,48
26953,Les Bâties,70053,70,12,12,0,28,8,36,24
26954,Battrans,70054,70,12,52,0,66,56,122,64
26955,Baudoncourt,70055,70,75,171,45,170,123,338,246
26956,Baulay,70056,70,85,50,10,95,50,155,135
26957,Bay,70057,70,0,38,12,38,26,76,38
26958,Beaujeu-Saint-Vallier-Pierrejux-et-Quitteur,70058,70,98,230,38,300,145,483,328
26959,Beaumotte-Aubertans,70059,70,16,109,32,147,65,244,125
26960,Beaumotte-lès-Pin,70060,70,8,90,25,81,74,180,98
26961,Belfahy,70061,70,35,10,10,20,5,35,45
26962,Belmont,70062,70,16,24,20,40,16,76,40
26963,Belonchamp,70063,70,60,30,10,85,25,120,90
26964,Belverne,70064,70,16,45,0,52,16,68,61
26965,Besnans,70065,70,8,32,0,24,16,40,40
26966,Betaucourt,70066,70,39,33,4,24,26,54,72
26967,Betoncourt-lès-Brotte,70067,70,4,41,21,20,35,76,45
26968,Betoncourt-Saint-Pancras,70069,70,0,5,0,30,5,35,5
26969,Betoncourt-sur-Mance,70070,70,18,0,0,12,0,12,18
26970,Beulotte-Saint-Laurent,70071,70,20,0,0,36,0,36,20
26971,Beveuge,70072,70,8,17,0,32,12,44,25
26972,Blondefontaine,70074,70,30,70,25,90,45,160,100
26973,Bonboillon,70075,70,4,57,4,55,44,103,61
26974,Bonnevent-Velloreille,70076,70,32,76,28,120,72,220,108
26975,Borey,70077,70,45,55,10,85,40,135,100
26976,Bougey,70078,70,24,24,0,24,20,44,48
26977,Bougnon,70079,70,31,153,43,146,117,306,184
26978,Bouhans-et-Feurg,70080,70,55,70,30,60,45,135,125
26979,Bouhans-lès-Lure,70081,70,30,105,30,75,85,190,135
26980,Bouhans-lès-Montbozon,70082,70,12,36,0,36,20,56,48
26981,Bouligney,70083,70,95,75,35,175,40,250,170
26982,Boulot,70084,70,81,182,35,139,166,340,263
26983,Boult,70085,70,60,189,84,120,158,362,249
26984,Bourbévelle,70086,70,16,8,0,44,12,56,24
26985,Bourguignon-lès-Conflans,70087,70,12,32,16,32,32,80,44
26986,Bourguignon-lès-la-Charité,70088,70,16,38,3,25,25,53,54
26987,Bourguignon-lès-Morey,70089,70,25,15,5,5,10,20,40
26988,Boursières,70090,70,0,25,0,15,20,35,25
26989,Bousseraucourt,70091,70,15,5,10,15,0,25,20
26990,Bresilley,70092,70,25,40,15,75,30,120,65
26991,Breuches,70093,70,160,155,65,174,135,374,315
26992,Breuchotte,70094,70,48,40,28,132,44,204,88
26993,Breurey-lès-Faverney,70095,70,20,172,39,221,138,398,192
26994,Brevilliers,70096,70,107,113,49,176,114,339,220
26995,Briaucourt,70097,70,52,40,16,112,20,148,92
26996,Brotte-lès-Luxeuil,70098,70,30,45,25,65,45,135,75
26997,Brotte-lès-Ray,70099,70,20,4,8,28,4,40,24
26998,Broye-les-Loups-et-Verfontaine,70100,70,4,41,0,16,24,40,45
26999,Broye-Aubigney-Montseugny,70101,70,78,65,51,194,42,287,143
27000,Brussey,70102,70,55,70,30,75,40,145,125
27001,La Bruyère,70103,70,12,54,4,93,26,123,66
27002,Bucey-lès-Gy,70104,70,62,155,43,149,154,346,217
27003,Bucey-lès-Traves,70105,70,25,25,10,25,25,60,50
27004,Buffignécourt,70106,70,12,28,20,40,24,84,40
27005,Bussières,70107,70,34,91,52,108,68,228,125
27006,Buthiers,70109,70,26,72,6,90,51,147,98
27007,Calmoutier,70111,70,20,56,48,72,48,168,76
27008,Cemboing,70112,70,60,16,15,91,10,116,76
27009,Cenans,70113,70,15,25,15,45,20,80,40
27010,Cendrecourt,70114,70,45,50,25,75,40,140,95
27011,Cerre-lès-Noroy,70115,70,36,53,8,62,37,107,89
27012,Chagey,70116,70,68,156,44,272,112,428,224
27013,Châlonvillars,70117,70,147,343,58,413,222,693,490
27014,Chambornay-lès-Bellevaux,70118,70,28,36,12,48,44,104,64
27015,Chambornay-lès-Pin,70119,70,24,72,48,135,56,239,96
27016,Champagney,70120,70,568,1030,283,1189,760,2232,1598
27017,Champey,70121,70,130,240,70,285,140,495,370
27018,Champlitte,70122,70,243,358,102,612,259,973,601
27019,Champtonnay,70124,70,8,25,0,16,24,40,33
27020,Champvans,70125,70,5,41,15,87,31,133,46
27021,Chancey,70126,70,30,45,15,40,45,100,75
27022,Chantes,70127,70,10,30,5,50,25,80,40
27023,La Chapelle-lès-Luxeuil,70128,70,40,95,10,160,55,225,135
27024,La Chapelle-Saint-Quillain,70129,70,21,34,0,33,30,63,55
27025,Charcenne,70130,70,25,62,20,120,60,200,87
27026,Chargey-lès-Gray,70132,70,65,153,42,211,125,378,218
27027,Chargey-lès-Port,70133,70,50,60,30,70,35,135,110
27028,Chariez,70134,70,22,37,15,73,34,122,59
27029,Charmes-Saint-Valbert,70135,70,12,0,8,20,0,28,12
27030,Charmoille,70136,70,40,112,60,160,96,316,152
27031,Chassey-lès-Montbozon,70137,70,20,45,15,115,20,150,65
27032,Chassey-lès-Scey,70138,70,5,25,10,50,15,75,30
27033,Châteney,70140,70,8,8,0,16,12,28,16
27034,Châtenois,70141,70,8,30,4,54,21,79,38
27035,Chaumercenne,70142,70,16,28,22,40,24,86,44
27036,Chauvirey-le-Châtel,70143,70,20,20,4,40,32,76,40
27037,Chauvirey-le-Vieil,70144,70,9,16,0,3,9,12,25
27038,Chaux-la-Lotière,70145,70,20,118,36,117,97,250,138
27039,Chaux-lès-Port,70146,70,9,19,9,37,36,82,28
27040,Chavanne,70147,70,25,50,20,75,55,150,75
27041,Chemilly,70148,70,3,17,6,25,18,49,20
27042,Chenebier,70149,70,45,165,50,305,105,460,210
27043,Chenevrey-et-Morogne,70150,70,12,104,32,100,52,184,116
27044,Chevigney,70151,70,0,0,0,20,12,32,0
27045,Choye,70152,70,45,95,30,101,100,231,140
27046,Cintrey,70153,70,10,31,0,60,15,75,41
27047,Cirey,70154,70,36,92,16,88,96,200,128
27048,Citers,70155,70,93,215,50,250,170,470,308
27049,Citey,70156,70,20,16,8,36,16,60,36
27050,Clairegoutte,70157,70,45,100,10,155,70,235,145
27051,Clans,70158,70,9,24,9,24,19,52,33
27052,Cognières,70159,70,3,12,15,31,15,61,15
27053,Coisevaux,70160,70,10,100,30,125,80,235,110
27054,Colombe-lès-Vesoul,70162,70,60,110,50,195,60,305,170
27055,Colombier,70163,70,72,130,25,114,63,202,202
27056,Colombotte,70164,70,8,29,8,28,0,36,37
27057,Combeaufontaine,70165,70,45,136,35,167,91,293,181
27058,Comberjon,70166,70,16,28,12,92,32,136,44
27059,Conflandey,70167,70,45,94,24,100,64,188,139
27060,Conflans-sur-Lanterne,70168,70,80,145,80,225,105,410,225
27061,Confracourt,70169,70,32,68,4,68,40,112,100
27062,Contréglise,70170,70,5,30,10,50,35,95,35
27063,Corbenay,70171,70,132,324,88,460,284,832,456
27064,La Corbière,70172,70,16,8,12,34,8,54,24
27065,Cordonnet,70174,70,16,28,8,76,16,100,44
27066,Cornot,70175,70,10,25,15,75,10,100,35
27067,Corravillers,70176,70,45,35,10,80,10,100,80
27068,Corre,70177,70,80,120,40,272,60,372,200
27069,La Côte,70178,70,68,117,21,152,109,282,185
27070,Coulevon,70179,70,16,32,36,92,16,144,48
27071,Courchaton,70180,70,90,95,15,135,110,260,185
27072,Courcuire,70181,70,10,30,5,65,15,85,40
27073,Courmont,70182,70,0,32,4,36,28,68,32
27074,Courtesoult-et-Gatey,70183,70,12,15,0,15,16,31,27
27075,Couthenans,70184,70,104,138,97,239,161,497,242
27076,Cresancey,70185,70,10,25,35,90,15,140,35
27077,La Creuse,70186,70,4,24,0,36,4,40,28
27078,Crevans-et-la-Chapelle-lès-Granges,70187,70,35,55,12,80,25,117,90
27079,Creveney,70188,70,20,25,0,5,20,25,45
27080,Cromary,70189,70,24,76,12,88,52,152,100
27081,Cubry-lès-Faverney,70190,70,15,40,25,60,25,110,55
27082,Cugney,70192,70,21,39,12,54,31,97,60
27083,Cult,70193,70,15,70,30,80,50,160,85
27084,Cuve,70194,70,36,36,15,46,15,76,72
27085,Dambenoît-lès-Colombe,70195,70,15,50,40,120,55,215,65
27086,Dampierre-lès-Conflans,70196,70,32,84,20,80,60,160,116
27087,Dampierre-sur-Linotte,70197,70,72,256,72,256,152,480,328
27088,Dampierre-sur-Salon,70198,70,125,272,79,460,246,785,397
27089,Dampvalley-lès-Colombe,70199,70,0,28,0,48,28,76,28
27090,Dampvalley-Saint-Pancras,70200,70,5,5,0,15,5,20,10
27091,Delain,70201,70,50,40,30,75,15,120,90
27092,Demangevelle,70202,70,56,33,9,114,42,165,89
27093,La Demie,70203,70,10,40,10,25,60,95,50
27094,Denèvre,70204,70,22,54,12,41,18,71,76
27095,Échavanne,70205,70,24,48,16,84,36,136,72
27096,Échenans-sous-Mont-Vaudois,70206,70,78,120,35,180,95,310,198
27097,Échenoz-la-Méline,70207,70,364,753,322,1093,586,2001,1117
27098,Échenoz-le-Sec,70208,70,15,70,25,110,65,200,85
27099,Écromagny,70210,70,16,34,12,55,20,87,50
27100,Écuelle,70211,70,12,12,0,24,3,27,24
27101,Éhuns,70213,70,9,70,10,87,56,153,79
27102,Équevilley,70214,70,30,20,0,40,25,65,50
27103,Errevet,70215,70,9,59,12,94,42,148,68
27104,Esboz-Brest,70216,70,60,127,25,150,96,271,187
27105,Esmoulières,70217,70,16,12,4,64,0,68,28
27106,Esmoulins,70218,70,25,30,0,40,35,75,55
27107,Esprels,70219,70,108,172,56,236,120,412,280
27108,Essertenne-et-Cecey,70220,70,66,93,20,113,68,201,159
27109,Étobon,70221,70,35,70,10,105,65,180,105
27110,Étrelles-et-la-Montbleuse,70222,70,10,10,10,20,20,50,20
27111,Étuz,70224,70,38,162,43,222,135,400,200
27112,Fahy-lès-Autrey,70225,70,12,29,8,33,21,62,41
27113,Fallon,70226,70,38,72,12,88,68,168,110
27114,Faucogney-et-la-Mer,70227,70,75,110,40,215,95,350,185
27115,Faverney,70228,70,98,251,41,315,188,544,349
27116,Faymont,70229,70,53,50,4,92,34,130,103
27117,Fédry,70230,70,30,30,10,29,20,59,60
27118,Ferrières-lès-Ray,70231,70,5,15,10,15,10,35,20
27119,Ferrières-lès-Scey,70232,70,3,39,3,52,26,81,42
27120,Les Fessey,70233,70,20,32,4,48,32,84,52
27121,Filain,70234,70,8,52,4,73,52,129,60
27122,Flagy,70235,70,0,25,0,90,25,115,25
27123,Fleurey-lès-Faverney,70236,70,77,114,21,95,118,234,191
27124,Fleurey-lès-Lavoncourt,70237,70,33,8,0,30,4,34,41
27125,Fleurey-lès-Saint-Loup,70238,70,15,30,0,65,25,90,45
27126,Fondremand,70239,70,25,40,28,50,50,128,65
27127,Fontaine-lès-Luxeuil,70240,70,202,284,96,560,202,858,486
27128,Fontenois-la-Ville,70242,70,12,44,0,56,28,84,56
27129,Fontenois-lès-Montbozon,70243,70,40,68,40,92,52,184,108
27130,Fouchécourt,70244,70,10,25,5,55,15,75,35
27131,Fougerolles,70245,70,508,775,306,1308,624,2238,1283
27132,Fouvent-Saint-Andoche,70247,70,37,20,6,97,36,139,57
27133,Frahier-et-Chatebier,70248,70,148,371,101,358,312,771,519
27134,Francalmont,70249,70,10,35,10,45,20,75,45
27135,Franchevelle,70250,70,25,85,60,130,95,285,110
27136,Francourt,70251,70,10,30,25,30,15,70,40
27137,Framont,70252,70,25,39,5,50,49,104,64
27138,Frasne-le-Château,70253,70,15,85,15,90,84,189,100
27139,Frédéric-Fontaine,70254,70,30,75,25,85,45,155,105
27140,Fresne-Saint-Mamès,70255,70,65,115,30,225,75,330,180
27141,Fresse,70256,70,106,130,36,240,142,418,236
27142,Fretigney-et-Velloreille,70257,70,71,201,58,167,155,380,272
27143,Froideconche,70258,70,285,436,170,700,414,1284,721
27144,Froideterre,70259,70,48,72,24,127,45,196,120
27145,Frotey-lès-Lure,70260,70,80,168,60,196,180,436,248
27146,Frotey-lès-Vesoul,70261,70,239,305,114,495,210,819,544
27147,Genevreuille,70262,70,0,39,22,54,28,104,39
27148,Genevrey,70263,70,5,40,40,60,85,185,45
27149,Georfans,70264,70,10,5,5,20,5,30,15
27150,Germigney,70265,70,40,40,5,70,25,100,80
27151,Gevigney-et-Mercey,70267,70,72,76,28,176,68,272,148
27152,Gézier-et-Fontenelay,70268,70,25,53,4,53,32,89,78
27153,Girefontaine,70269,70,10,10,0,15,0,15,20
27154,Gouhenans,70271,70,55,95,30,150,65,245,150
27155,Gourgeon,70272,70,36,64,20,52,52,124,100
27156,Grammont,70273,70,9,13,6,16,19,41,22
27157,Grandecourt,70274,70,4,8,0,16,4,20,12
27158,Grandvelle-et-le-Perrenot,70275,70,20,99,16,129,72,217,119
27159,Granges-la-Ville,70276,70,20,40,15,90,25,130,60
27160,Granges-le-Bourg,70277,70,40,100,15,105,120,240,140
27161,Grattery,70278,70,40,32,28,68,28,124,72
27162,Gray,70279,70,762,1173,530,1559,818,2907,1935
27163,Gray-la-Ville,70280,70,164,174,86,354,121,561,338
27164,Gy,70282,70,140,276,92,364,176,632,416
27165,Haut-du-Them-Château-Lambert,70283,70,70,46,55,196,20,271,116
27166,Hautevelle,70284,70,28,75,45,41,25,111,103
27167,Héricourt,70285,70,1257,2188,1011,3346,1816,6173,3445
27168,Hugier,70286,70,11,62,0,56,10,66,73
27169,Hurecourt,70287,70,5,0,0,25,0,25,5
27170,Hyet,70288,70,29,17,9,20,30,59,46
27171,Igny,70289,70,32,52,8,36,56,100,84
27172,Jasney,70290,70,30,70,15,75,55,145,100
27173,Jonvelle,70291,70,10,25,5,60,10,75,35
27174,Jussey,70292,70,294,406,125,519,242,886,700
27175,Lambrey,70293,70,15,25,15,25,10,50,40
27176,Lantenot,70294,70,22,87,34,93,81,208,109
27177,La Lanterne-et-les-Armonts,70295,70,28,44,20,44,72,136,72
27178,Larians-et-Munans,70296,70,12,60,28,96,44,168,72
27179,Larret,70297,70,0,20,10,15,15,40,20
27180,Lavigney,70298,70,10,50,10,40,25,75,60
27181,Lavoncourt,70299,70,94,56,20,85,56,161,150
27182,Lieffrans,70301,70,0,15,20,0,25,45,15
27183,Lieucourt,70302,70,12,37,4,16,20,40,49
27184,Liévans,70303,70,6,57,10,48,12,70,63
27185,Linexert,70304,70,32,20,0,60,12,72,52
27186,Loeuilley,70305,70,4,40,0,40,36,76,44
27187,Lomont,70306,70,40,70,51,149,65,265,110
27188,Longevelle,70307,70,8,32,12,44,28,84,40
27189,La Longine,70308,70,80,40,5,70,30,105,120
27190,Loulans-Verchamp,70309,70,60,135,35,165,75,275,195
27191,Lure,70310,70,1032,1962,890,2397,1480,4767,2994
27192,Luxeuil-les-Bains,70311,70,1047,1455,757,2246,1120,4123,2502
27193,Luze,70312,70,70,175,50,300,115,465,245
27194,Lyoffans,70313,70,25,115,25,125,95,245,140
27195,Magnivray,70314,70,10,60,10,60,35,105,70
27196,Magnoncourt,70315,70,76,84,64,148,48,260,160
27197,Le Magnoray,70316,70,5,35,0,30,35,65,40
27198,Les Magny,70317,70,25,20,10,50,30,90,45
27199,Magny-Danigon,70318,70,30,135,20,145,115,280,165
27200,Magny-Jobert,70319,70,4,36,4,17,30,51,40
27201,Magny-lès-Jussey,70320,70,25,35,5,40,15,60,60
27202,Magny-Vernois,70321,70,145,260,90,572,220,882,405
27203,Mailleroncourt-Charette,70322,70,41,47,26,89,29,144,88
27204,Mailleroncourt-Saint-Pancras,70323,70,18,39,13,65,28,106,57
27205,Mailley-et-Chazelot,70324,70,60,127,49,239,97,385,187
27206,Maizières,70325,70,34,86,34,97,49,180,120
27207,La Malachère,70326,70,16,84,18,62,70,150,100
27208,Malans,70327,70,30,25,0,40,35,75,55
27209,Malbouhans,70328,70,54,75,15,87,86,188,129
27210,Malvillers,70329,70,15,10,0,30,10,40,25
27211,Mandrevillars,70330,70,21,72,4,74,44,122,93
27212,Mantoche,70331,70,80,70,20,175,85,280,150
27213,Marast,70332,70,4,0,4,20,4,28,4
27214,Marnay,70334,70,199,351,84,456,275,815,550
27215,Maussans,70335,70,10,20,0,15,20,35,30
27216,Mélecey,70336,70,16,28,28,68,24,120,44
27217,Melin,70337,70,3,7,6,15,9,30,10
27218,Melincourt,70338,70,50,60,10,95,20,125,110
27219,Mélisey,70339,70,248,288,132,688,288,1108,536
27220,Membrey,70340,70,38,30,10,95,24,129,68
27221,Menoux,70341,70,25,70,46,93,40,179,95
27222,Mercey-sur-Saône,70342,70,20,40,10,35,30,75,60
27223,Mersuay,70343,70,40,60,50,100,40,190,100
27224,Meurcourt,70344,70,24,88,40,104,56,200,112
27225,Miellin,70345,70,30,10,5,30,5,40,40
27226,Mignavillers,70347,70,50,55,25,145,60,230,105
27227,Moffans-et-Vacheresse,70348,70,50,135,75,250,130,455,185
27228,Moimay,70349,70,28,44,24,64,48,136,72
27229,Molay,70350,70,10,10,0,25,10,35,20
27230,Mollans,70351,70,18,40,26,72,40,138,58
27231,La Montagne,70352,70,0,3,0,23,6,29,3
27232,Montagney,70353,70,45,125,25,130,100,255,170
27233,Montarlot-lès-Rioz,70355,70,10,75,25,85,70,180,85
27234,Montboillon,70356,70,28,60,28,88,44,160,88
27235,Montbozon,70357,70,50,140,75,156,130,361,190
27236,Montcey,70358,70,45,65,20,55,75,150,110
27237,Montcourt,70359,70,5,11,15,32,0,47,16
27238,Montdoré,70360,70,16,21,4,8,16,28,37
27239,Montessaux,70361,70,19,49,6,36,48,90,68
27240,Montigny-lès-Cherlieu,70362,70,25,40,10,81,10,101,65
27241,Montigny-lès-Vesoul,70363,70,80,150,65,235,110,410,230
27242,Montjustin-et-Velotte,70364,70,15,26,3,42,12,57,41
27243,Villers-Chemin-et-Mont-lès-Étrelles,70366,70,15,22,25,21,9,55,37
27244,Mont-le-Vernois,70367,70,10,35,20,55,30,105,45
27245,Montot,70368,70,24,28,4,52,20,76,52
27246,Mont-Saint-Léger,70369,70,15,10,5,20,0,25,25
27247,Montureux-et-Prantigny,70371,70,20,53,24,44,40,108,73
27248,Montureux-lès-Baulay,70372,70,34,35,6,36,15,57,69
27249,La Roche-Morey,70373,70,35,64,8,113,21,142,99
27250,Motey-Besuche,70374,70,16,24,4,48,16,68,40
27251,Motey-sur-Saône,70375,70,4,12,0,16,0,16,16
27252,Nantilly,70376,70,64,157,35,132,157,324,221
27253,Navenne,70378,70,265,365,110,585,260,955,630
27254,Neurey-en-Vaux,70380,70,8,39,4,59,40,103,47
27255,Neurey-lès-la-Demie,70381,70,15,50,10,100,15,125,65
27256,Neuvelle-lès-Cromary,70383,70,51,89,43,101,48,192,140
27257,Neuvelle-lès-la-Charité,70384,70,35,60,10,75,60,145,95
27258,La Neuvelle-lès-Lure,70385,70,35,75,5,125,80,210,110
27259,La Neuvelle-lès-Scey,70386,70,17,49,17,59,20,96,66
27260,Noidans-le-Ferroux,70387,70,90,155,45,250,125,420,245
27261,Noidans-lès-Vesoul,70388,70,205,452,186,742,377,1305,657
27262,Noiron,70389,70,16,4,8,8,0,16,20
27263,Noroy-le-Bourg,70390,70,44,104,52,164,96,312,148
27264,Oigney,70392,70,12,8,4,20,4,28,20
27265,Oiselay-et-Grachaux,70393,70,34,100,35,97,85,217,134
27266,Onay,70394,70,15,10,5,25,5,35,25
27267,Oppenans,70395,70,12,4,4,36,0,40,16
27268,Oricourt,70396,70,16,0,0,12,0,12,16
27269,Ormenans,70397,70,16,21,8,16,12,36,37
27270,Ormoiche,70398,70,5,0,5,40,10,55,5
27271,Ormoy,70399,70,45,35,25,60,35,120,80
27272,Ouge,70400,70,15,25,5,50,20,75,40
27273,Ovanches,70401,70,21,16,4,53,12,69,37
27274,Oyrières,70402,70,69,85,25,164,35,224,154
27275,Palante,70403,70,20,55,20,55,65,140,75
27276,Passavant-la-Rochère,70404,70,125,145,50,215,100,365,270
27277,Pennesières,70405,70,8,52,8,44,64,116,60
27278,Percey-le-Grand,70406,70,12,16,8,28,16,52,28
27279,Perrouse,70407,70,21,52,20,85,38,143,73
27280,Pesmes,70408,70,215,225,40,440,165,645,440
27281,Pierrecourt,70409,70,9,15,6,38,12,56,24
27282,Pin,70410,70,66,170,74,209,100,383,236
27283,La Pisseure,70411,70,0,5,5,15,5,25,5
27284,Plainemont,70412,70,4,16,8,28,8,44,20
27285,Plancher-Bas,70413,70,160,535,110,680,470,1260,695
27286,Plancher-les-Mines,70414,70,151,230,41,306,193,540,381
27287,Polaincourt-et-Clairefontaine,70415,70,90,95,60,260,90,410,185
27288,Pomoy,70416,70,20,63,12,75,21,108,83
27289,Pontcey,70417,70,12,64,25,102,60,187,76
27290,La Romaine,70418,70,50,119,44,161,88,293,169
27291,Pont-du-Bois,70419,70,10,20,5,50,20,75,30
27292,Pont-sur-l'Ognon,70420,70,5,30,0,25,10,35,35
27293,Port-sur-Saône,70421,70,372,735,376,962,524,1862,1107
27294,Poyans,70422,70,19,33,3,31,24,58,52
27295,Preigney,70423,70,15,10,0,55,20,75,25
27296,La Proiselière-et-Langle,70425,70,20,45,10,55,20,85,65
27297,Provenchère,70426,70,7,73,20,86,45,151,80
27298,Purgerot,70427,70,65,95,35,130,45,210,160
27299,Pusey,70428,70,99,398,93,510,285,888,497
27300,Pusy-et-Épenoux,70429,70,80,130,35,205,95,335,210
27301,La Quarte,70430,70,8,16,4,25,8,37,24
27302,Quenoche,70431,70,8,56,32,76,60,168,64
27303,Quers,70432,70,44,88,48,144,48,240,132
27304,Quincey,70433,70,120,344,88,540,271,899,464
27305,Raddon-et-Chapendu,70435,70,120,204,61,353,148,562,324
27306,Raincourt,70436,70,25,55,0,20,40,60,80
27307,Ranzevelle,70437,70,0,0,0,10,5,15,0
27308,Ray-sur-Saône,70438,70,22,45,23,47,32,102,67
27309,Raze,70439,70,47,101,0,87,77,164,148
27310,Recologne,70440,70,0,9,0,12,6,18,9
27311,Recologne-lès-Rioz,70441,70,12,63,9,54,67,130,75
27312,Renaucourt,70442,70,5,15,0,70,10,80,20
27313,La Grande-Résie,70443,70,24,24,4,24,16,44,48
27314,La Résie-Saint-Martin,70444,70,20,55,5,55,25,85,75
27315,Rignovelle,70445,70,8,17,12,38,12,62,25
27316,Rigny,70446,70,69,125,45,222,140,407,194
27317,Rioz,70447,70,175,700,270,500,540,1310,875
27318,Roche-et-Raucourt,70448,70,39,45,5,55,20,80,84
27319,Roche-sur-Linotte-et-Sorans-les-Cordiers,70449,70,9,15,12,18,9,39,24
27320,La Rochelle,70450,70,10,5,0,5,15,20,15
27321,Ronchamp,70451,70,338,704,215,958,548,1721,1042
27322,Rosey,70452,70,25,70,20,85,74,179,95
27323,La Rosière,70453,70,20,20,5,50,0,55,40
27324,Rosières-sur-Mance,70454,70,6,13,0,38,12,50,19
27325,Roye,70455,70,153,397,95,462,263,820,550
27326,Ruhans,70456,70,10,60,20,45,25,90,70
27327,Rupt-sur-Saône,70457,70,10,15,10,75,5,90,25
27328,Saint-Barthélemy,70459,70,135,252,60,422,227,709,387
27329,Saint-Bresson,70460,70,87,80,50,156,76,282,167
27330,Saint-Broing,70461,70,8,16,8,80,12,100,24
27331,Saint-Ferjeux,70462,70,10,25,5,25,5,35,35
27332,Saint-Gand,70463,70,20,40,4,24,40,68,60
27333,Saint-Germain,70464,70,199,312,95,384,265,744,511
27334,Saint-Loup-Nantouard,70466,70,6,19,9,33,15,57,25
27335,Saint-Loup-sur-Semouse,70467,70,526,725,190,1140,490,1820,1251
27336,Saint-Marcel,70468,70,18,23,0,31,12,43,41
27337,Sainte-Marie-en-Chanois,70469,70,30,40,15,85,40,140,70
27338,Sainte-Marie-en-Chaux,70470,70,0,48,12,60,44,116,48
27339,Sainte-Reine,70471,70,0,20,0,15,15,30,20
27340,Saint-Remy,70472,70,50,35,15,95,55,165,85
27341,Saint-Sauveur,70473,70,265,370,160,665,265,1090,635
27342,Saint-Sulpice,70474,70,25,25,0,65,10,75,50
27343,Saint-Valbert,70475,70,40,68,16,60,64,140,108
27344,Saponcourt,70476,70,4,0,14,36,0,50,4
27345,Saulnot,70477,70,97,199,70,274,143,487,296
27346,Saulx,70478,70,64,236,136,196,176,508,300
27347,Sauvigney-lès-Gray,70479,70,19,19,9,16,22,47,38
27348,Sauvigney-lès-Pesmes,70480,70,10,30,15,65,15,95,40
27349,Savoyeux,70481,70,35,40,10,85,45,140,75
27350,Scey-sur-Saône-et-Saint-Albin,70482,70,261,265,152,561,184,897,526
27351,Scye,70483,70,12,24,8,52,28,88,36
27352,Secenans,70484,70,20,50,5,55,35,95,70
27353,Selles,70485,70,29,32,3,85,40,128,61
27354,Semmadon,70486,70,19,13,6,35,12,53,32
27355,Senargent-Mignafans,70487,70,60,75,55,85,40,180,135
27356,Senoncourt,70488,70,36,48,20,68,44,132,84
27357,Servance,70489,70,150,100,60,355,75,490,250
27358,Servigney,70490,70,10,35,0,45,30,75,45
27359,Seveux,70491,70,55,115,50,165,70,285,170
27360,Soing-Cubry-Charentenay,70492,70,100,109,44,192,52,288,209
27361,Sorans-lès-Breurey,70493,70,12,128,24,136,120,280,140
27362,Sornay,70494,70,17,105,26,88,69,183,122
27363,Tartécourt,70496,70,0,4,4,12,8,24,4
27364,Tavey,70497,70,36,151,20,126,154,300,187
27365,Ternuay-Melay-et-Saint-Hilaire,70498,70,68,108,36,248,68,352,176
27366,Theuley,70499,70,10,25,25,25,15,65,35
27367,Thieffrans,70500,70,20,35,5,60,55,120,55
27368,Thiénans,70501,70,12,25,4,24,4,32,37
27369,Tincey-et-Pontrebeau,70502,70,30,15,15,15,15,45,45
27370,Traitiéfontaine,70503,70,20,52,16,44,36,96,72
27371,Traves,70504,70,42,75,29,102,45,176,117
27372,Le Tremblois,70505,70,24,45,20,65,35,120,69
27373,Trémoins,70506,70,52,80,40,124,68,232,132
27374,Trésilley,70507,70,16,67,16,70,56,142,83
27375,Tromarey,70509,70,10,20,0,30,25,55,30
27376,Vadans,70510,70,20,52,16,20,36,72,72
27377,Vaite,70511,70,19,62,15,46,41,102,81
27378,La Vaivre,70512,70,40,48,24,48,40,112,88
27379,Vaivre-et-Montoille,70513,70,220,523,210,1043,363,1616,743
27380,Valay,70514,70,90,195,60,150,160,370,285
27381,Le Val-de-Gouhenans,70515,70,15,0,5,30,5,40,15
27382,Vallerois-le-Bois,70516,70,60,70,10,60,50,120,130
27383,Vallerois-Lorioz,70517,70,28,127,20,100,89,209,155
27384,Le Val-Saint-Éloi,70518,70,7,25,0,52,12,64,32
27385,Vandelans,70519,70,8,32,12,40,28,80,40
27386,Vanne,70520,70,20,20,0,55,5,60,40
27387,Vantoux-et-Longevelle,70521,70,12,48,20,56,32,108,60
27388,Varogne,70522,70,12,21,3,46,23,72,33
27389,Vars,70523,70,40,56,12,72,12,96,96
27390,Vauchoux,70524,70,12,28,3,27,19,49,40
27391,Vauconcourt-Nervezain,70525,70,45,75,5,55,55,115,120
27392,Vauvillers,70526,70,104,155,80,205,125,410,259
27393,Vaux-le-Moncelot,70527,70,5,20,0,40,0,40,25
27394,Velesmes-Échevanne,70528,70,30,145,30,205,100,335,175
27395,Velet,70529,70,70,94,9,136,38,183,164
27396,Vellechevreux-et-Courbenans,70530,70,34,21,6,43,9,58,55
27397,Velleclaire,70531,70,20,50,0,25,25,50,70
27398,Vellefaux,70532,70,36,97,30,169,83,282,133
27399,Vellefrey-et-Vellefrange,70533,70,4,25,12,32,21,65,29
27400,Vellefrie,70534,70,12,48,8,28,40,76,60
27401,Velleguindry-et-Levrecey,70535,70,12,52,12,64,32,108,64
27402,Velle-le-Châtel,70536,70,16,36,24,56,20,100,52
27403,Velleminfroy,70537,70,12,100,20,96,64,180,112
27404,Vellemoz,70538,70,9,8,18,12,12,42,17
27405,Vellexon-Queutrey-et-Vaudey,70539,70,68,156,44,100,128,272,224
27406,Velloreille-lès-Choye,70540,70,15,30,20,10,10,40,45
27407,Velorcey,70541,70,0,100,48,60,32,140,100
27408,Venère,70542,70,35,65,20,45,45,110,100
27409,La Vergenne,70544,70,10,30,5,70,5,80,40
27410,Venisey,70545,70,16,21,5,73,20,98,37
27411,Vereux,70546,70,35,65,20,70,55,145,100
27412,Verlans,70547,70,8,56,12,48,54,114,64
27413,Vernois-sur-Mance,70548,70,45,20,15,40,25,80,65
27414,La Vernotte,70549,70,0,30,0,25,25,50,30
27415,Vesoul,70550,70,1943,2986,2054,4847,2650,9551,4929
27416,Villafans,70552,70,36,54,20,33,43,96,90
27417,Villargent,70553,70,9,25,9,39,13,61,34
27418,Villars-le-Pautel,70554,70,40,36,16,84,20,120,76
27419,La Villedieu-en-Fontenette,70555,70,15,55,0,75,35,110,70
27420,Villefrancon,70557,70,8,44,9,36,26,71,52
27421,La Villeneuve-Bellenoye-et-la-Maize,70558,70,20,24,4,64,20,88,44
27422,Villeparois,70559,70,5,80,10,70,60,140,85
27423,Villers-Bouton,70560,70,32,37,13,29,19,61,69
27424,Villersexel,70561,70,150,268,124,359,198,681,418
27425,Villers-la-Ville,70562,70,10,40,5,55,25,85,50
27426,Villers-le-Sec,70563,70,32,99,12,232,92,336,131
27427,Villers-lès-Luxeuil,70564,70,30,75,30,115,50,195,105
27428,Villers-Pater,70565,70,4,16,0,4,16,20,20
27429,Villers-sur-Port,70566,70,20,42,9,72,33,114,62
27430,Villers-sur-Saulnot,70567,70,0,41,20,55,35,110,41
27431,Villers-Vaudey,70568,70,12,16,0,24,16,40,28
27432,Vilory,70569,70,0,0,0,51,5,56,0
27433,Visoncourt,70571,70,0,8,8,8,4,20,8
27434,Vitrey-sur-Mance,70572,70,75,50,20,85,40,145,125
27435,La Voivre,70573,70,20,35,10,60,20,90,55
27436,Volon,70574,70,4,8,0,36,16,52,12
27437,Voray-sur-l'Ognon,70575,70,55,235,70,289,170,529,290
27438,Vougécourt,70576,70,22,30,3,49,26,78,52
27439,Vouhenans,70577,70,27,73,26,129,77,232,100
27440,Vregille,70578,70,9,29,19,46,35,100,38
27441,Vyans-le-Val,70579,70,60,105,35,190,70,295,165
27442,Vy-le-Ferroux,70580,70,16,40,0,48,44,92,56
27443,Vy-lès-Lure,70581,70,45,180,50,248,145,443,225
27444,Vy-lès-Rupt,70582,70,16,24,8,32,16,56,40
27445,Vy-lès-Filain,70583,70,4,29,16,57,8,81,33
27446,L'Abergement-de-Cuisery,71001,71,84,176,48,288,160,496,260
27447,L'Abergement-Sainte-Colombe,71002,71,76,309,100,422,254,776,385
27448,Allerey-sur-Saône,71003,71,105,190,60,310,150,520,295
27449,Allériot,71004,71,98,264,100,385,188,673,362
27450,Aluze,71005,71,53,65,20,75,45,140,118
27451,Amanzé,71006,71,33,39,0,69,21,90,72
27452,Ameugny,71007,71,20,20,24,56,32,112,40
27453,Anglure-sous-Dun,71008,71,45,41,5,55,25,85,86
27454,Anost,71009,71,178,90,60,317,80,457,268
27455,Antully,71010,71,92,200,60,308,164,532,292
27456,Anzy-le-Duc,71011,71,48,98,26,190,56,272,146
27457,Artaix,71012,71,55,68,23,107,34,164,123
27458,Authumes,71013,71,65,50,15,100,30,145,115
27459,Autun,71014,71,2694,2558,1218,4734,2032,7984,5252
27460,Auxy,71015,71,92,256,60,372,204,636,348
27461,Azé,71016,71,145,194,73,352,216,641,339
27462,Ballore,71017,71,3,23,0,33,20,53,26
27463,Bantanges,71018,71,80,132,32,196,112,340,212
27464,Barizey,71019,71,3,27,3,56,20,79,30
27465,Barnay,71020,71,48,8,16,32,8,56,56
27466,Baron,71021,71,12,76,36,104,56,196,88
27467,Baudemont,71022,71,94,120,15,290,119,424,214
27468,Baudrières,71023,71,112,252,84,332,164,580,364
27469,Baugy,71024,71,95,90,50,210,60,320,185
27470,Beaubery,71025,71,90,65,30,144,45,219,155
27471,Beaumont-sur-Grosne,71026,71,43,96,20,97,58,175,139
27472,Beaurepaire-en-Bresse,71027,71,80,173,52,217,100,369,253
27473,Beauvernois,71028,71,24,28,12,16,28,56,52
27474,Bellevesvre,71029,71,36,47,46,68,37,151,83
27475,Bergesserin,71030,71,13,32,3,74,13,90,45
27476,Berzé-le-Châtel,71031,71,12,17,0,0,12,12,29
27477,Berzé-la-Ville,71032,71,85,165,53,228,66,347,250
27478,Bey,71033,71,72,213,67,238,161,466,285
27479,Bissey-sous-Cruchaud,71034,71,35,69,57,123,28,208,104
27480,Bissy-la-Mâconnaise,71035,71,25,50,35,90,30,155,75
27481,Bissy-sous-Uxelles,71036,71,5,5,5,35,15,55,10
27482,Bissy-sur-Fley,71037,71,5,15,0,50,15,65,20
27483,Les Bizots,71038,71,25,105,25,215,105,345,130
27484,Blanot,71039,71,18,30,6,57,22,85,48
27485,Blanzy,71040,71,910,1251,518,2577,952,4047,2161
27486,Bois-Sainte-Marie,71041,71,10,10,20,40,10,70,20
27487,Bonnay,71042,71,45,55,15,60,65,140,100
27488,Les Bordes,71043,71,28,12,8,28,16,52,40
27489,Bosjean,71044,71,52,44,32,148,28,208,96
27490,Bouhans,71045,71,21,33,8,52,29,89,54
27491,La Boulaye,71046,71,4,24,8,36,16,60,28
27492,Bourbon-Lancy,71047,71,888,872,360,1911,738,3009,1760
27493,Bourg-le-Comte,71048,71,15,20,10,125,5,140,35
27494,Bourgvilain,71050,71,40,58,30,105,58,193,98
27495,Bouzeron,71051,71,18,14,16,65,9,90,32
27496,Boyer,71052,71,84,140,48,236,124,408,224
27497,Bragny-sur-Saône,71054,71,101,123,28,180,95,303,224
27498,Brandon,71055,71,44,64,28,68,80,176,108
27499,Branges,71056,71,440,530,125,890,405,1420,970
27500,Bray,71057,71,21,31,4,41,20,65,52
27501,Bresse-sur-Grosne,71058,71,28,48,12,68,40,120,76
27502,Le Breuil,71059,71,593,703,190,1456,460,2106,1296
27503,Briant,71060,71,45,35,0,98,40,138,80
27504,Brienne,71061,71,60,115,45,120,115,280,175
27505,Brion,71062,71,78,37,12,119,23,154,115
27506,Broye,71063,71,83,168,31,274,126,431,251
27507,Bruailles,71064,71,234,211,29,292,143,464,445
27508,Buffières,71065,71,41,42,18,92,43,153,83
27509,Burgy,71066,71,38,30,0,16,22,38,68
27510,Burnand,71067,71,16,29,8,46,25,79,45
27511,Burzy,71068,71,12,16,4,24,20,48,28
27512,Bussières,71069,71,50,135,60,265,70,395,185
27513,Buxy,71070,71,381,448,130,702,305,1137,829
27514,Céron,71071,71,70,55,15,95,30,140,125
27515,Cersot,71072,71,12,28,12,48,28,88,40
27516,Chagny,71073,71,717,1369,647,1595,1173,3415,2086
27517,Chaintré,71074,71,77,129,12,160,109,281,206
27518,Chalmoux,71075,71,141,123,35,251,91,377,264
27519,Chalon-sur-Saône,71076,71,6630,9813,6184,13137,7863,27184,16443
27520,Chambilly,71077,71,100,103,28,158,62,248,203
27521,Chamilly,71078,71,21,36,4,28,40,72,57
27522,Champagnat,71079,71,80,100,30,200,60,290,180
27523,Champagny-sous-Uxelles,71080,71,8,16,8,44,8,60,24
27524,Champforgeuil,71081,71,298,634,182,812,443,1437,932
27525,Champlecy,71082,71,12,59,0,86,36,122,71
27526,Chânes,71084,71,95,141,10,221,95,326,236
27527,Change,71085,71,30,45,15,85,35,135,75
27528,Changy,71086,71,72,116,28,124,112,264,188
27529,Chapaize,71087,71,15,30,5,70,35,110,45
27530,La Chapelle-au-Mans,71088,71,42,34,22,72,18,112,76
27531,La Chapelle-de-Bragny,71089,71,35,55,20,110,40,170,90
27532,La Chapelle-de-Guinchay,71090,71,374,1182,283,1110,912,2305,1556
27533,La Chapelle-du-Mont-de-France,71091,71,24,44,4,56,64,124,68
27534,La Chapelle-Naude,71092,71,96,152,32,188,108,328,248
27535,La Chapelle-Saint-Sauveur,71093,71,89,85,34,282,76,392,174
27536,La Chapelle-sous-Brancion,71094,71,28,0,4,72,16,92,28
27537,La Chapelle-sous-Dun,71095,71,119,74,12,135,55,202,193
27538,La Chapelle-sous-Uchon,71096,71,26,30,6,46,35,87,56
27539,La Chapelle-Thècle,71097,71,95,47,15,172,54,241,142
27540,Charbonnat,71098,71,48,40,12,112,24,148,88
27541,Charbonnières,71099,71,40,45,25,152,55,232,85
27542,Chardonnay,71100,71,44,32,12,80,32,124,76
27543,Charette-Varennes,71101,71,100,105,31,102,47,180,205
27544,La Charmée,71102,71,74,169,34,321,105,460,243
27545,Charmoy,71103,71,40,35,34,93,50,177,75
27546,Charnay-lès-Chalon,71104,71,45,22,3,44,28,75,67
27547,Charnay-lès-Mâcon,71105,71,1240,1374,506,2312,1098,3916,2614
27548,Charolles,71106,71,525,465,275,885,315,1475,990
27549,Charrecey,71107,71,36,84,12,104,88,204,120
27550,Chasselas,71108,71,20,40,0,55,55,110,60
27551,Chassey-le-Camp,71109,71,32,86,8,83,85,176,118
27552,Chassigny-sous-Dun,71110,71,80,137,15,186,102,303,217
27553,Chassy,71111,71,36,77,15,98,58,171,113
27554,Château,71112,71,30,60,0,95,45,140,90
27555,Châteauneuf,71113,71,10,25,10,40,25,75,35
27556,Châtel-Moron,71115,71,4,40,0,20,26,46,44
27557,Châtenay,71116,71,27,20,9,43,19,71,47
27558,Châtenoy-en-Bresse,71117,71,90,320,34,390,245,669,410
27559,Châtenoy-le-Royal,71118,71,1089,1380,616,1931,934,3481,2469
27560,Chaudenay,71119,71,72,308,88,316,284,688,380
27561,Chauffailles,71120,71,778,652,276,1352,446,2074,1430
27562,La Chaux,71121,71,45,38,33,106,29,168,83
27563,Cheilly-lès-Maranges,71122,71,56,152,68,136,120,324,208
27564,Chenay-le-Châtel,71123,71,84,100,52,128,48,228,184
27565,Chenôves,71124,71,28,35,13,43,51,107,63
27566,Chérizet,71125,71,10,0,0,5,0,5,10
27567,Chevagny-les-Chevrières,71126,71,67,151,28,187,110,325,218
27568,Chevagny-sur-Guye,71127,71,15,10,5,30,10,45,25
27569,Chiddes,71128,71,15,30,10,10,30,50,45
27570,Chissey-en-Morvan,71129,71,56,30,20,85,36,141,86
27571,Chissey-lès-Mâcon,71130,71,60,40,5,105,15,125,100
27572,Ciel,71131,71,75,243,75,231,151,457,318
27573,Ciry-le-Noble,71132,71,334,469,174,879,330,1383,803
27574,La Clayette,71133,71,421,235,113,514,250,877,656
27575,Clermain,71134,71,40,60,5,50,65,120,100
27576,Clessé,71135,71,60,235,39,294,155,488,295
27577,Clessy,71136,71,30,54,10,113,53,176,84
27578,Cluny,71137,71,710,905,615,1413,760,2788,1615
27579,Collonge-en-Charollais,71139,71,15,30,0,75,15,90,45
27580,Collonge-la-Madeleine,71140,71,8,12,0,12,12,24,20
27581,Colombier-en-Brionnais,71141,71,8,60,40,132,60,232,68
27582,La Comelle,71142,71,24,53,8,42,58,108,77
27583,Condal,71143,71,100,110,30,108,80,218,210
27584,Cordesse,71144,71,16,26,21,66,26,113,42
27585,Cormatin,71145,71,158,156,20,107,87,214,314
27586,Cortambert,71146,71,21,57,4,76,49,129,78
27587,Cortevaix,71147,71,64,40,12,92,40,144,104
27588,Coublanc,71148,71,80,170,70,330,140,540,250
27589,Couches,71149,71,246,257,97,421,218,736,503
27590,Crêches-sur-Saône,71150,71,351,643,264,1101,468,1833,994
27591,Créot,71151,71,4,13,8,16,16,40,17
27592,Cressy-sur-Somme,71152,71,18,34,10,59,40,109,52
27593,Le Creusot,71153,71,4223,4309,2371,6886,3363,12620,8532
27594,Crissey,71154,71,233,725,130,877,565,1572,958
27595,Cronat,71155,71,103,122,21,156,100,277,225
27596,Cruzille,71156,71,12,72,4,120,40,164,84
27597,Cuiseaux,71157,71,311,407,124,611,304,1039,718
27598,Cuisery,71158,71,303,314,95,524,216,835,617
27599,Culles-les-Roches,71159,71,40,45,15,75,20,110,85
27600,Curbigny,71160,71,47,63,25,105,26,156,110
27601,Curdin,71161,71,16,64,33,125,53,211,80
27602,Curgy,71162,71,148,260,34,397,212,643,408
27603,Curtil-sous-Buffières,71163,71,12,8,8,32,20,60,20
27604,Curtil-sous-Burnand,71164,71,12,24,0,47,34,81,36
27605,Cussy-en-Morvan,71165,71,89,73,12,179,53,244,162
27606,Cuzy,71166,71,30,25,20,45,15,80,55
27607,Damerey,71167,71,45,155,40,210,115,365,200
27608,Dampierre-en-Bresse,71168,71,36,36,0,60,44,104,72
27609,Davayé,71169,71,83,126,39,243,102,384,209
27610,Demigny,71170,71,152,518,142,575,350,1067,670
27611,Dennevy,71171,71,21,60,25,133,30,188,81
27612,Dettey,71172,71,15,15,10,20,15,45,30
27613,Devrouze,71173,71,55,85,25,65,85,175,140
27614,Dezize-lès-Maranges,71174,71,40,30,10,60,31,101,70
27615,Diconne,71175,71,60,96,20,80,90,190,156
27616,Digoin,71176,71,1488,1386,661,3007,965,4633,2874
27617,Dommartin-lès-Cuiseaux,71177,71,129,180,55,279,150,484,309
27618,Dompierre-les-Ormes,71178,71,125,210,110,314,140,564,335
27619,Dompierre-sous-Sanvignes,71179,71,16,20,0,15,13,28,36
27620,Donzy-le-National,71180,71,16,48,4,92,32,128,64
27621,Donzy-le-Pertuis,71181,71,0,34,8,66,21,95,34
27622,Dracy-le-Fort,71182,71,175,264,65,561,170,796,439
27623,Dracy-lès-Couches,71183,71,19,44,6,41,22,69,63
27624,Dracy-Saint-Loup,71184,71,60,105,50,225,120,395,165
27625,Dyo,71185,71,19,77,19,118,65,202,96
27626,Écuelles,71186,71,55,80,45,60,40,145,135
27627,Écuisses,71187,71,162,388,117,639,318,1074,550
27628,Épertully,71188,71,4,4,0,48,8,56,8
27629,Épervans,71189,71,108,426,132,560,354,1046,534
27630,Épinac,71190,71,351,476,160,755,386,1301,827
27631,Essertenne,71191,71,50,90,34,183,76,293,140
27632,Étang-sur-Arroux,71192,71,362,390,130,615,270,1015,752
27633,Étrigny,71193,71,67,83,35,139,95,269,150
27634,Farges-lès-Chalon,71194,71,66,155,48,298,106,452,221
27635,Farges-lès-Mâcon,71195,71,50,30,10,80,45,135,80
27636,Le Fay,71196,71,90,121,23,238,95,356,211
27637,Flacey-en-Bresse,71198,71,39,62,52,107,65,224,101
27638,Flagy,71199,71,35,25,5,65,25,95,60
27639,Fleury-la-Montagne,71200,71,88,156,32,244,136,412,244
27640,Fley,71201,71,44,28,16,60,16,92,72
27641,Fontaines,71202,71,257,402,126,684,333,1143,659
27642,Fontenay,71203,71,5,5,0,15,0,15,10
27643,Fragnes-La Loyère,71204,71,87,371,109,598,276,983,458
27644,Frangy-en-Bresse,71205,71,160,125,55,215,95,365,285
27645,La Frette,71206,71,32,48,24,104,44,172,80
27646,Fretterans,71207,71,55,65,5,115,40,160,120
27647,Frontenard,71208,71,50,50,20,65,50,135,100
27648,Frontenaud,71209,71,124,120,55,190,125,370,244
27649,Fuissé,71210,71,40,82,20,109,81,210,122
27650,Génelard,71212,71,285,215,105,563,200,868,500
27651,La Genête,71213,71,84,132,21,207,76,304,216
27652,Genouilly,71214,71,75,65,35,160,75,270,140
27653,Gergy,71215,71,305,615,180,924,530,1634,920
27654,Germagny,71216,71,40,50,5,80,55,140,90
27655,Germolles-sur-Grosne,71217,71,13,22,9,49,12,70,35
27656,Gibles,71218,71,125,150,65,145,125,335,275
27657,Gigny-sur-Saône,71219,71,48,140,24,180,132,336,188
27658,Gilly-sur-Loire,71220,71,96,112,44,172,88,304,208
27659,Givry,71221,71,533,795,267,1386,555,2208,1328
27660,Gourdon,71222,71,148,200,44,364,148,556,348
27661,La Grande-Verrière,71223,71,91,81,25,212,68,305,172
27662,Grandvaux,71224,71,15,20,0,30,20,50,35
27663,Granges,71225,71,20,156,20,188,136,344,176
27664,Grevilly,71226,71,5,15,0,25,5,30,20
27665,Grury,71227,71,120,80,40,215,75,330,200
27666,Guerfand,71228,71,20,65,10,50,55,115,85
27667,Les Guerreaux,71229,71,39,40,18,63,38,119,79
27668,Gueugnon,71230,71,1693,1218,413,2682,1046,4141,2911
27669,La Guiche,71231,71,91,66,18,173,60,251,157
27670,Hautefond,71232,71,12,56,4,100,36,140,68
27671,L'Hôpital-le-Mercier,71233,71,50,50,30,125,35,190,100
27672,Huilly-sur-Seille,71234,71,40,72,32,104,80,216,112
27673,Hurigny,71235,71,270,465,110,687,330,1127,735
27674,Igé,71236,71,60,216,80,288,212,580,276
27675,Igornay,71237,71,76,128,48,176,104,328,204
27676,Iguerande,71238,71,140,245,95,370,155,620,385
27677,Issy-l'Évêque,71239,71,165,125,28,233,117,378,290
27678,Jalogny,71240,71,42,85,8,117,55,180,127
27679,Jambles,71241,71,84,124,16,168,76,260,208
27680,Joncy,71242,71,90,115,10,180,100,290,205
27681,Joudes,71243,71,65,74,9,103,82,194,139
27682,Jouvençon,71244,71,64,72,24,204,48,276,136
27683,Jugy,71245,71,39,69,12,89,64,165,108
27684,Juif,71246,71,25,53,8,81,51,140,78
27685,Jully-lès-Buxy,71247,71,44,92,16,120,68,204,136
27686,Lacrost,71248,71,152,143,51,222,98,371,295
27687,Laives,71249,71,150,269,130,324,155,609,419
27688,Laizé,71250,71,80,288,100,416,208,724,368
27689,Laizy,71251,71,65,110,25,270,125,420,175
27690,Lalheue,71252,71,34,100,35,143,80,258,134
27691,Lans,71253,71,64,226,64,356,185,605,290
27692,Lays-sur-le-Doubs,71254,71,12,8,4,78,20,102,20
27693,Lesme,71255,71,25,35,15,60,45,120,60
27694,Lessard-en-Bresse,71256,71,95,146,30,160,120,310,241
27695,Lessard-le-National,71257,71,34,122,39,256,98,393,156
27696,Leynes,71258,71,52,136,48,204,80,332,188
27697,Ligny-en-Brionnais,71259,71,50,90,15,129,75,219,140
27698,Loisy,71261,71,132,128,84,188,88,360,260
27699,Longepierre,71262,71,45,40,15,75,15,105,85
27700,Louhans,71263,71,1317,1104,514,2246,789,3549,2421
27701,Lournand,71264,71,38,52,8,120,57,185,90
27702,Lucenay-l'Évêque,71266,71,69,68,18,102,44,164,137
27703,Lugny,71267,71,121,158,94,304,107,505,279
27704,Lugny-lès-Charolles,71268,71,32,112,20,112,80,212,144
27705,Lux,71269,71,265,339,264,587,349,1200,604
27706,Mâcon,71270,71,4866,7549,4395,9424,5990,19809,12415
27707,Mailly,71271,71,38,17,4,59,8,71,55
27708,Malay,71272,71,56,38,20,73,28,121,94
27709,Maltat,71273,71,24,61,15,93,57,165,85
27710,Mancey,71274,71,51,79,15,133,53,201,130
27711,Marcigny,71275,71,417,284,103,689,195,987,701
27712,Marcilly-la-Gueurce,71276,71,12,20,0,50,20,70,32
27713,Marcilly-lès-Buxy,71277,71,54,214,25,242,179,446,268
27714,Marigny,71278,71,21,19,3,45,22,70,40
27715,Le Rousset-Marizy,71279,71,118,133,44,249,86,379,251
27716,Marly-sous-Issy,71280,71,12,24,0,36,16,52,36
27717,Marly-sur-Arroux,71281,71,78,40,30,139,50,219,118
27718,Marmagne,71282,71,179,244,90,402,245,737,423
27719,Marnay,71283,71,48,106,50,198,99,347,154
27720,Martailly-lès-Brancion,71284,71,24,24,8,41,24,73,48
27721,Martigny-le-Comte,71285,71,24,100,24,200,72,296,124
27722,Mary,71286,71,40,50,15,95,35,145,90
27723,Massilly,71287,71,55,70,10,175,65,250,125
27724,Massy,71288,71,6,12,3,20,12,35,18
27725,Matour,71289,71,176,240,72,360,180,612,416
27726,Mazille,71290,71,50,50,10,147,40,197,100
27727,Melay,71291,71,148,252,53,299,142,494,400
27728,Mellecey,71292,71,160,295,85,470,215,770,455
27729,Ménetreuil,71293,71,95,81,8,134,51,193,176
27730,Mercurey,71294,71,180,256,95,400,190,685,436
27731,Mervans,71295,71,240,320,125,450,270,845,560
27732,Messey-sur-Grosne,71296,71,54,183,38,249,145,432,237
27733,Mesvres,71297,71,190,145,60,275,95,430,335
27734,Milly-Lamartine,71299,71,72,105,24,96,72,192,177
27735,Le Miroir,71300,71,80,124,48,172,91,311,204
27736,Mont,71301,71,12,35,9,57,55,121,47
27737,Montagny-lès-Buxy,71302,71,9,46,9,83,30,122,55
27738,Montagny-près-Louhans,71303,71,50,80,70,185,50,305,130
27739,Montagny-sur-Grosne,71304,71,4,36,4,48,28,80,40
27740,Montbellet,71305,71,105,195,65,290,145,500,300
27741,Montceau-les-Mines,71306,71,3443,3709,2000,6330,2675,11005,7152
27742,Montceaux-l'Étoile,71307,71,36,84,28,84,68,180,120
27743,Montceaux-Ragny,71308,71,5,0,0,15,0,15,5
27744,Montcenis,71309,71,409,410,152,790,339,1281,819
27745,Montchanin,71310,71,857,1108,501,1675,892,3068,1965
27746,Montcony,71311,71,44,84,16,84,68,168,128
27747,Montcoy,71312,71,3,63,12,80,64,156,66
27748,Monthelon,71313,71,44,116,20,128,76,224,160
27749,Montjay,71314,71,45,15,20,105,5,130,60
27750,Mont-lès-Seurre,71315,71,12,52,8,72,40,120,64
27751,Montmelard,71316,71,58,57,9,99,62,170,115
27752,Montmort,71317,71,15,45,5,90,35,130,60
27753,Montpont-en-Bresse,71318,71,220,165,60,491,145,696,385
27754,Montret,71319,71,90,200,132,199,124,455,290
27755,Mont-Saint-Vincent,71320,71,74,50,35,119,20,174,124
27756,Morey,71321,71,25,56,20,75,56,151,81
27757,Morlet,71322,71,16,8,12,32,0,44,24
27758,Mornay,71323,71,20,10,0,42,23,65,30
27759,Moroges,71324,71,84,132,41,175,91,307,216
27760,La Motte-Saint-Jean,71325,71,114,273,58,475,251,784,387
27761,Mouthier-en-Bresse,71326,71,64,89,32,150,58,240,153
27762,Mussy-sous-Dun,71327,71,31,78,20,103,57,180,109
27763,Nanton,71328,71,60,172,44,228,128,400,232
27764,Navilly,71329,71,90,75,20,179,45,244,165
27765,Neuvy-Grandchamp,71330,71,120,175,50,300,140,490,295
27766,Nochize,71331,71,8,16,4,36,16,56,24
27767,Ormes,71332,71,62,126,26,183,84,293,188
27768,Oslon,71333,71,124,376,56,436,248,740,500
27769,Oudry,71334,71,32,100,24,160,80,264,132
27770,Ouroux-sous-le-Bois-Sainte-Marie,71335,71,3,17,6,22,14,42,20
27771,Ouroux-sur-Saône,71336,71,352,822,268,856,716,1840,1174
27772,Oyé,71337,71,56,62,0,90,49,139,118
27773,Ozenay,71338,71,32,56,20,80,52,152,88
27774,Ozolles,71339,71,75,75,50,185,50,285,150
27775,Palinges,71340,71,295,345,70,440,335,845,640
27776,Palleau,71341,71,12,60,20,40,88,148,72
27777,Paray-le-Monial,71342,71,1936,1442,891,2986,1108,4985,3378
27778,Paris-l'Hôpital,71343,71,48,78,8,42,71,121,126
27779,Passy,71344,71,16,17,4,30,4,38,33
27780,Péronne,71345,71,60,165,40,255,110,405,225
27781,Perrecy-les-Forges,71346,71,329,368,145,480,352,977,697
27782,Perreuil,71347,71,59,155,10,165,145,320,214
27783,Perrigny-sur-Loire,71348,71,20,35,5,65,20,90,55
27784,La Petite-Verrière,71349,71,16,0,3,15,3,21,16
27785,Pierreclos,71350,71,125,215,70,305,175,550,340
27786,Pierre-de-Bresse,71351,71,319,347,135,721,207,1063,666
27787,Le Planois,71352,71,36,24,4,32,8,44,60
27788,Plottes,71353,71,85,82,55,196,108,359,167
27789,Poisson,71354,71,90,155,60,203,90,353,245
27790,Pontoux,71355,71,28,63,30,27,73,130,91
27791,Pouilloux,71356,71,88,268,60,348,228,636,356
27792,Pourlans,71357,71,17,21,13,93,20,126,38
27793,Pressy-sous-Dondin,71358,71,16,22,0,28,17,45,38
27794,Préty,71359,71,120,90,45,225,80,350,210
27795,Prissé,71360,71,283,515,190,595,430,1215,798
27796,Prizy,71361,71,20,28,0,20,12,32,48
27797,Pruzilly,71362,71,24,72,16,100,76,192,96
27798,Le Puley,71363,71,8,12,0,39,24,63,20
27799,La Racineuse,71364,71,30,30,10,55,45,110,60
27800,Rancy,71365,71,80,89,30,196,68,294,169
27801,Ratenelle,71366,71,50,110,25,90,105,220,160
27802,Ratte,71367,71,55,80,10,165,60,235,135
27803,Reclesne,71368,71,45,85,35,85,70,190,130
27804,Remigny,71369,71,40,95,25,205,75,305,135
27805,Rigny-sur-Arroux,71370,71,96,158,55,236,125,416,254
27806,La Roche-Vineuse,71371,71,250,308,92,605,247,944,558
27807,Romanèche-Thorins,71372,71,200,494,185,602,339,1126,694
27808,Romenay,71373,71,285,266,125,620,188,933,551
27809,Rosey,71374,71,25,30,5,80,25,110,55
27810,Roussillon-en-Morvan,71376,71,29,27,21,98,35,154,56
27811,Royer,71377,71,17,12,13,52,13,78,29
27812,Rully,71378,71,152,368,128,604,324,1056,520
27813,Sagy,71379,71,185,245,90,480,205,775,430
27814,Saillenard,71380,71,148,144,68,260,140,468,292
27815,Sailly,71381,71,10,30,0,40,20,60,40
27816,Saint-Agnan,71382,71,140,170,65,210,125,400,310
27817,Saint-Albain,71383,71,50,135,60,149,110,319,185
27818,Saint-Ambreuil,71384,71,25,117,10,187,95,292,142
27819,Saint-Amour-Bellevue,71385,71,104,128,40,172,80,292,232
27820,Saint-André-en-Bresse,71386,71,20,20,5,40,15,60,40
27821,Saint-André-le-Désert,71387,71,40,50,10,105,35,150,90
27822,Saint-Aubin-en-Charollais,71388,71,48,144,28,156,104,288,192
27823,Saint-Aubin-sur-Loire,71389,71,40,80,20,108,56,184,120
27824,Saint-Berain-sous-Sanvignes,71390,71,180,275,60,360,215,635,455
27825,Saint-Bérain-sur-Dheune,71391,71,80,170,25,165,115,305,250
27826,Saint-Boil,71392,71,60,140,16,192,80,288,200
27827,Saint-Bonnet-de-Cray,71393,71,53,116,29,136,92,257,169
27828,Saint-Bonnet-de-Joux,71394,71,188,103,35,258,103,396,291
27829,Saint-Bonnet-de-Vieille-Vigne,71395,71,29,50,10,74,40,124,79
27830,Saint-Bonnet-en-Bresse,71396,71,96,100,32,188,64,284,196
27831,Sainte-Cécile,71397,71,55,70,30,100,35,165,125
27832,Saint-Christophe-en-Bresse,71398,71,89,314,85,293,293,671,403
27833,Saint-Christophe-en-Brionnais,71399,71,108,100,24,196,84,304,208
27834,Saint-Clément-sur-Guye,71400,71,25,15,10,70,10,90,40
27835,Sainte-Croix,71401,71,82,114,48,200,88,336,196
27836,Saint-Cyr,71402,71,76,200,30,276,165,471,276
27837,Saint-Denis-de-Vaux,71403,71,5,55,10,136,45,191,60
27838,Saint-Désert,71404,71,90,200,90,295,150,535,290
27839,Saint-Didier-en-Bresse,71405,71,24,36,8,40,28,76,60
27840,Saint-Didier-en-Brionnais,71406,71,36,28,4,52,36,92,64
27841,Saint-Didier-sur-Arroux,71407,71,32,44,12,120,32,164,76
27842,Saint-Edmond,71408,71,48,92,4,124,88,216,140
27843,Saint-Émiland,71409,71,45,100,30,90,94,214,145
27844,Saint-Étienne-en-Bresse,71410,71,68,228,60,280,188,528,296
27845,Saint-Eugène,71411,71,6,20,7,64,25,96,26
27846,Saint-Eusèbe,71412,71,140,268,108,392,212,712,408
27847,Saint-Firmin,71413,71,106,221,52,282,153,487,327
27848,Saint-Forgeot,71414,71,69,70,50,220,60,330,139
27849,Sainte-Foy,71415,71,13,26,16,44,12,72,39
27850,Saint-Gengoux-de-Scissé,71416,71,113,140,39,193,79,311,253
27851,Saint-Gengoux-le-National,71417,71,184,156,76,364,168,608,340
27852,Saint-Germain-du-Bois,71419,71,528,328,104,604,300,1008,856
27853,Saint-Germain-du-Plain,71420,71,244,544,128,764,448,1340,788
27854,Saint-Germain-en-Brionnais,71421,71,28,52,20,64,36,120,80
27855,Saint-Germain-lès-Buxy,71422,71,10,90,10,100,75,185,100
27856,Saint-Gervais-en-Vallière,71423,71,55,120,55,130,75,260,175
27857,Saint-Gervais-sur-Couches,71424,71,30,50,15,60,40,115,80
27858,Saint-Gilles,71425,71,48,54,15,97,27,139,102
27859,Sainte-Hélène,71426,71,16,133,25,129,90,244,149
27860,Saint-Huruge,71427,71,16,7,0,21,0,21,23
27861,Saint-Igny-de-Roche,71428,71,79,241,48,151,194,393,320
27862,Saint-Jean-de-Vaux,71430,71,45,105,25,125,90,240,150
27863,Saint-Jean-de-Trézy,71431,71,48,84,24,104,84,212,132
27864,Saint-Julien-de-Civry,71433,71,85,101,42,149,75,266,186
27865,Saint-Julien-de-Jonzy,71434,71,65,69,21,84,43,148,134
27866,Saint-Julien-sur-Dheune,71435,71,20,40,35,90,45,170,60
27867,Saint-Laurent-d'Andenay,71436,71,125,270,60,375,195,630,395
27868,Saint-Laurent-en-Brionnais,71437,71,75,50,35,140,30,205,125
27869,Saint-Léger-du-Bois,71438,71,20,125,65,280,40,385,145
27870,Saint-Léger-lès-Paray,71439,71,48,177,48,276,133,457,225
27871,Saint-Léger-sous-Beuvray,71440,71,76,78,7,131,47,185,154
27872,Saint-Léger-sous-la-Bussière,71441,71,26,44,20,81,38,139,70
27873,Saint-Léger-sur-Dheune,71442,71,220,348,152,488,336,976,568
27874,Saint-Loup-Géanges,71443,71,95,484,115,507,339,961,579
27875,Saint-Loup-de-Varennes,71444,71,120,252,116,452,188,756,372
27876,Saint-Marcel,71445,71,819,1408,526,2057,937,3520,2227
27877,Saint-Marcelin-de-Cray,71446,71,35,40,5,55,45,105,75
27878,Saint-Mard-de-Vaux,71447,71,24,68,16,136,32,184,92
27879,Saint-Martin-Belle-Roche,71448,71,197,322,109,429,235,773,519
27880,Saint-Martin-d'Auxy,71449,71,8,24,8,28,20,56,32
27881,Saint-Martin-de-Commune,71450,71,15,20,20,50,10,80,35
27882,Saint-Martin-de-Lixy,71451,71,3,9,6,50,6,62,12
27883,Saint-Martin-de-Salencey,71452,71,5,15,25,60,10,95,20
27884,Saint-Martin-du-Lac,71453,71,25,54,15,69,48,132,79
27885,Saint-Martin-du-Mont,71454,71,20,55,10,75,45,130,75
27886,Saint-Martin-du-Tartre,71455,71,20,13,12,62,12,86,33
27887,Saint-Martin-en-Bresse,71456,71,242,435,170,663,365,1198,677
27888,Saint-Martin-en-Gâtinois,71457,71,13,25,0,37,29,66,38
27889,Saint-Martin-la-Patrouille,71458,71,16,24,8,12,12,32,40
27890,Saint-Martin-sous-Montaigu,71459,71,22,77,26,134,46,206,99
27891,Saint-Maurice-de-Satonnay,71460,71,35,139,25,150,89,264,174
27892,Saint-Maurice-des-Champs,71461,71,0,15,5,30,0,35,15
27893,Saint-Maurice-en-Rivière,71462,71,48,148,52,204,116,372,196
27894,Saint-Maurice-lès-Châteauneuf,71463,71,66,129,48,119,118,285,195
27895,Saint-Maurice-lès-Couches,71464,71,34,54,12,42,30,84,88
27896,Saint-Micaud,71465,71,36,64,32,56,72,160,100
27897,Saint-Nizier-sur-Arroux,71466,71,8,48,0,52,36,88,56
27898,Saint-Pierre-de-Varennes,71468,71,54,168,27,363,156,546,222
27899,Saint-Pierre-le-Vieux,71469,71,30,54,8,143,69,220,84
27900,Saint-Point,71470,71,60,55,20,130,70,220,115
27901,Saint-Privé,71471,71,3,7,6,27,6,39,10
27902,Saint-Prix,71472,71,30,35,15,90,35,140,65
27903,Saint-Racho,71473,71,78,35,5,40,25,70,113
27904,Sainte-Radegonde,71474,71,40,15,10,70,25,105,55
27905,Saint-Rémy,71475,71,1037,1481,607,2060,1171,3838,2518
27906,Saint-Romain-sous-Gourdon,71477,71,52,92,26,164,76,266,144
27907,Saint-Romain-sous-Versigny,71478,71,15,15,15,30,5,50,30
27908,Saint-Sernin-du-Bois,71479,71,220,476,96,696,404,1196,696
27909,Saint-Sernin-du-Plain,71480,71,84,120,25,240,114,379,204
27910,Saint-Symphorien-d'Ancelles,71481,71,75,313,118,377,212,707,388
27911,Saint-Symphorien-de-Marmagne,71482,71,90,200,75,339,155,569,290
27912,Saint-Symphorien-des-Bois,71483,71,40,110,50,160,80,290,150
27913,Saint-Usuge,71484,71,236,294,97,394,217,708,530
27914,Saint-Vallerin,71485,71,45,65,45,75,35,155,110
27915,Saint-Vallier,71486,71,1702,1658,656,3160,1341,5157,3360
27916,Saint-Vérand,71487,71,0,35,10,80,45,135,35
27917,Saint-Vincent-des-Prés,71488,71,30,25,5,35,20,60,55
27918,Saint-Vincent-en-Bresse,71489,71,50,130,45,190,135,370,180
27919,Saint-Vincent-Bragny,71490,71,116,284,64,304,244,612,400
27920,Saint-Yan,71491,71,172,252,80,432,228,740,424
27921,Saint-Ythaire,71492,71,25,15,0,85,5,90,40
27922,Saisy,71493,71,39,70,5,133,65,203,109
27923,La Salle,71494,71,60,130,30,250,90,370,190
27924,Salornay-sur-Guye,71495,71,179,147,94,211,75,380,326
27925,Sampigny-lès-Maranges,71496,71,20,21,10,72,20,102,41
27926,Sancé,71497,71,196,400,167,725,302,1194,596
27927,Santilly,71498,71,28,14,6,46,16,68,42
27928,Sanvignes-les-Mines,71499,71,862,986,335,1493,744,2572,1848
27929,Sarry,71500,71,32,20,0,52,12,64,52
27930,Sassangy,71501,71,30,39,10,53,25,88,69
27931,Sassenay,71502,71,174,390,100,555,350,1005,564
27932,Saules,71503,71,30,35,24,35,15,74,65
27933,Saunières,71504,71,35,10,0,15,25,40,45
27934,Savianges,71505,71,0,5,0,50,15,65,5
27935,Savigny-en-Revermont,71506,71,140,304,96,352,296,744,444
27936,Savigny-sur-Grosne,71507,71,24,44,20,52,36,108,68
27937,Savigny-sur-Seille,71508,71,63,75,34,165,80,279,138
27938,La Celle-en-Morvan,71509,71,68,104,64,156,88,308,172
27939,Semur-en-Brionnais,71510,71,124,112,20,228,48,296,236
27940,Sennecey-le-Grand,71512,71,414,701,336,845,607,1788,1115
27941,Senozan,71513,71,96,279,60,421,198,679,375
27942,Sens-sur-Seille,71514,71,56,60,60,160,36,256,116
27943,Sercy,71515,71,40,15,0,10,15,25,55
27944,Serley,71516,71,105,115,115,168,95,378,220
27945,Sermesse,71517,71,15,77,40,50,71,161,92
27946,Serrières,71518,71,48,68,8,116,44,168,116
27947,Serrigny-en-Bresse,71519,71,30,45,25,60,25,110,75
27948,Sevrey,71520,71,100,255,95,350,155,600,355
27949,Sigy-le-Châtel,71521,71,28,21,4,21,12,37,49
27950,Simandre,71522,71,272,420,140,532,316,988,692
27951,Simard,71523,71,124,292,108,456,224,788,416
27952,Sivignon,71524,71,39,22,8,51,21,80,61
27953,Sologny,71525,71,40,190,45,180,125,350,230
27954,Solutré-Pouilly,71526,71,42,63,53,118,46,217,105
27955,Sommant,71527,71,20,55,15,70,55,140,75
27956,Sornay,71528,71,286,498,94,742,362,1198,784
27957,Suin,71529,71,60,35,25,120,30,175,95
27958,Sully,71530,71,115,90,30,200,70,300,205
27959,La Tagnière,71531,71,25,65,15,103,40,158,90
27960,Taizé,71532,71,5,15,0,30,5,35,20
27961,Tancon,71533,71,73,153,16,181,92,289,226
27962,Le Tartre,71534,71,10,25,5,45,30,80,35
27963,Tavernay,71535,71,62,103,24,184,63,271,165
27964,Thil-sur-Arroux,71537,71,20,28,12,40,48,100,48
27965,Thurey,71538,71,71,92,22,135,77,234,163
27966,Tintry,71539,71,4,4,12,38,4,54,8
27967,Torcy,71540,71,407,818,280,1000,498,1778,1225
27968,Torpes,71541,71,74,68,18,95,77,190,142
27969,Toulon-sur-Arroux,71542,71,370,290,60,525,250,835,660
27970,Tournus,71543,71,1170,1067,549,1758,842,3149,2237
27971,Toutenant,71544,71,20,39,13,63,21,97,59
27972,Tramayes,71545,71,156,176,44,416,140,600,332
27973,Trambly,71546,71,65,90,30,125,85,240,155
27974,Trivy,71547,71,50,35,8,84,42,134,85
27975,Tronchy,71548,71,21,57,8,84,46,138,78
27976,La Truchère,71549,71,62,33,12,54,25,91,95
27977,Uchizy,71550,71,145,209,75,269,140,484,354
27978,Uchon,71551,71,12,40,0,32,24,56,52
27979,Uxeau,71552,71,92,96,44,216,80,340,188
27980,Vareilles,71553,71,45,65,0,90,65,155,110
27981,Varenne-l'Arconce,71554,71,12,12,16,43,9,68,24
27982,Varennes-le-Grand,71555,71,165,421,116,695,303,1114,586
27983,Varennes-lès-Mâcon,71556,71,70,145,50,155,130,335,215
27984,Varenne-Saint-Germain,71557,71,40,190,27,239,142,408,230
27985,Varennes-Saint-Sauveur,71558,71,166,232,62,318,187,567,398
27986,Varennes-sous-Dun,71559,71,150,105,35,215,80,330,255
27987,Vauban,71561,71,58,30,12,77,19,108,88
27988,Vaudebarrier,71562,71,8,60,4,116,40,160,68
27989,Vaux-en-Pré,71563,71,19,13,3,25,12,40,32
27990,Vendenesse-lès-Charolles,71564,71,96,145,83,220,128,431,241
27991,Vendenesse-sur-Arroux,71565,71,65,120,70,215,110,395,185
27992,Verdun-sur-le-Doubs,71566,71,153,273,116,289,212,617,426
27993,Vergisson,71567,71,36,28,32,105,20,157,64
27994,Vérissey,71568,71,6,16,0,12,23,35,22
27995,Verjux,71570,71,39,117,24,203,87,314,156
27996,Verosvres,71571,71,29,112,24,148,72,244,141
27997,Vers,71572,71,4,47,9,95,46,150,51
27998,Versaugues,71573,71,45,50,20,90,20,130,95
27999,Verzé,71574,71,88,149,84,294,120,498,237
28000,Le Villars,71576,71,39,55,20,70,80,170,94
28001,Villegaudin,71577,71,12,60,24,40,60,124,72
28002,Clux-Villeneuve,71578,71,51,67,29,122,50,201,118
28003,Villeneuve-en-Montagne,71579,71,21,38,8,50,17,75,59
28004,Vincelles,71580,71,60,80,20,175,80,275,140
28005,Vindecy,71581,71,37,61,15,44,48,107,98
28006,La Vineuse,71582,71,30,45,20,130,50,200,75
28007,Vinzelles,71583,71,100,130,70,290,105,465,230
28008,Viré,71584,71,128,268,96,408,228,732,396
28009,Virey-le-Grand,71585,71,95,343,65,603,235,903,438
28010,Viry,71586,71,44,52,12,72,68,152,96
28011,Vitry-lès-Cluny,71587,71,35,8,0,12,8,20,43
28012,Vitry-en-Charollais,71588,71,120,275,40,430,230,700,395
28013,Vitry-sur-Loire,71589,71,70,95,40,145,80,265,165
28014,Volesvres,71590,71,55,135,45,310,70,425,190
28015,Fleurville,71591,71,104,118,29,125,76,230,222
28016,Aigné,72001,72,88,457,114,543,323,980,545
28017,Aillières-Beauvoir,72002,72,29,64,29,38,31,98,93
28018,Allonnes,72003,72,1451,2772,1160,3188,1709,6057,4223
28019,Amné,72004,72,26,173,34,106,161,301,199
28020,Ancinnes,72005,72,140,252,40,312,204,556,392
28021,Arçonnay,72006,72,270,415,185,660,225,1070,685
28022,Ardenay-sur-Mérize,72007,72,35,155,45,85,135,265,190
28023,Arnage,72008,72,841,1098,402,1966,696,3064,1939
28024,Arthezé,72009,72,10,130,30,100,110,240,140
28025,Asnières-sur-Vègre,72010,72,44,111,33,116,72,221,155
28026,Assé-le-Boisne,72011,72,100,275,85,334,140,559,375
28027,Assé-le-Riboul,72012,72,60,155,40,180,85,305,215
28028,Aubigné-Racan,72013,72,396,424,140,796,320,1256,820
28029,Les Aulneaux,72015,72,20,65,20,24,20,64,85
28030,Auvers-le-Hamon,72016,72,170,424,117,382,288,787,594
28031,Auvers-sous-Montfaucon,72017,72,23,63,20,59,38,117,86
28032,Avesnes-en-Saosnois,72018,72,3,13,6,28,23,57,16
28033,Avessé,72019,72,40,105,45,145,40,230,145
28034,Avezé,72020,72,55,214,65,287,144,496,269
28035,Avoise,72021,72,75,140,45,205,120,370,215
28036,Le Bailleul,72022,72,155,335,110,285,280,675,490
28037,Ballon-Saint Mars,72023,72,298,546,156,650,438,1244,844
28038,La Bazoge,72024,72,351,958,333,1286,706,2325,1309
28039,Bazouges-sur-le-Loir,72025,72,219,367,70,310,317,697,586
28040,Beaufay,72026,72,240,394,130,461,259,850,634
28041,Beaumont-sur-Dême,72027,72,60,91,10,110,75,195,151
28042,Beaumont-Pied-de-Boeuf,72028,72,70,155,20,155,105,280,225
28043,Beaumont-sur-Sarthe,72029,72,519,413,143,510,273,926,932
28044,Beillé,72031,72,60,152,64,112,124,300,212
28045,Berfay,72032,72,15,75,15,130,105,250,90
28046,Bernay-en-Champagne,72033,72,55,135,20,120,85,225,190
28047,Bérus,72034,72,52,124,32,156,84,272,176
28048,Bessé-sur-Braye,72035,72,430,440,120,800,355,1275,870
28049,Béthon,72036,72,5,95,25,100,89,214,100
28050,Blèves,72037,72,15,15,10,35,24,69,30
28051,Boëssé-le-Sec,72038,72,60,185,55,160,150,365,245
28052,Bonnétable,72039,72,861,815,375,1160,495,2030,1676
28053,La Bosse,72040,72,12,33,8,32,28,68,45
28054,Bouër,72041,72,5,125,50,60,95,205,130
28055,Bouloire,72042,72,405,490,155,595,405,1155,895
28056,Bourg-le-Roi,72043,72,40,85,20,110,70,200,125
28057,Bousse,72044,72,35,145,45,95,120,260,180
28058,Brains-sur-Gée,72045,72,36,284,94,172,197,463,320
28059,Le Breil-sur-Mérize,72046,72,180,404,144,404,372,920,584
28060,Brette-les-Pins,72047,72,266,665,97,500,515,1112,931
28061,Briosne-lès-Sables,72048,72,48,164,52,152,124,328,212
28062,La Bruère-sur-Loir,72049,72,45,70,15,65,65,145,115
28063,Brûlon,72050,72,230,340,135,550,255,940,570
28064,Cérans-Foulletourte,72051,72,260,994,328,1026,734,2088,1254
28065,Chahaignes,72052,72,175,115,35,260,90,385,290
28066,Challes,72053,72,150,335,120,365,235,720,485
28067,Champagné,72054,72,264,903,354,1144,592,2090,1167
28068,Champfleur,72056,72,97,360,47,418,329,794,457
28069,Champrond,72057,72,0,20,10,30,20,60,20
28070,Changé,72058,72,749,1612,387,2270,1076,3733,2361
28071,Chantenay-Villedieu,72059,72,85,260,115,265,150,530,345
28072,La Chapelle-aux-Choux,72060,72,33,34,12,99,37,148,67
28073,La Chapelle-d'Aligné,72061,72,164,455,140,514,375,1029,619
28074,La Chapelle-du-Bois,72062,72,55,250,100,300,180,580,305
28075,La Chapelle-Gaugain,72063,72,55,40,20,85,30,135,95
28076,La Chapelle-Huon,72064,72,75,150,15,250,85,350,225
28077,La Chapelle-Saint-Aubin,72065,72,359,545,195,885,355,1435,904
28078,La Chapelle-Saint-Fray,72066,72,28,152,44,144,108,296,180
28079,La Chapelle-Saint-Rémy,72067,72,63,259,97,260,215,572,322
28080,La Chartre-sur-le-Loir,72068,72,376,252,84,472,132,688,628
28081,Chassillé,72070,72,20,65,35,90,50,175,85
28082,Château-du-Loir,72071,72,909,881,448,1452,592,2492,1790
28083,Château-l'Hermitage,72072,72,20,112,16,68,72,156,132
28084,Chaufour-Notre-Dame,72073,72,75,270,135,395,175,705,345
28085,Chemiré-en-Charnie,72074,72,60,30,10,65,35,110,90
28086,Chemiré-le-Gaudin,72075,72,35,295,33,270,257,560,330
28087,Chenay,72076,72,25,45,20,75,40,135,70
28088,Chenu,72077,72,70,85,40,125,90,255,155
28089,Chérancé,72078,72,72,88,32,120,80,232,160
28090,Chérisay,72079,72,25,84,28,105,70,203,109
28091,Cherré,72080,72,279,469,150,558,294,1002,748
28092,Cherreau,72081,72,121,263,49,307,166,522,384
28093,Le Chevain,72082,72,10,135,70,255,100,425,145
28094,Chevillé,72083,72,35,105,35,125,70,230,140
28095,Clermont-Créans,72084,72,145,330,155,404,230,789,475
28096,Cogners,72085,72,20,48,20,80,28,128,68
28097,Commerveil,72086,72,12,38,16,30,25,71,50
28098,Conflans-sur-Anille,72087,72,65,123,35,222,90,347,188
28099,Congé-sur-Orne,72088,72,20,100,40,105,70,215,120
28100,Conlie,72089,72,440,405,170,595,250,1015,845
28101,Connerré,72090,72,665,696,210,792,482,1484,1361
28102,Contilly,72091,72,8,17,4,75,12,91,25
28103,Cormes,72093,72,89,203,113,217,210,540,292
28104,Coudrecieux,72094,72,105,147,65,180,115,360,252
28105,Coulaines,72095,72,901,1894,795,2090,1186,4071,2795
28106,Coulans-sur-Gée,72096,72,115,469,125,455,388,968,584
28107,Coulombiers,72097,72,25,135,45,159,110,314,160
28108,Coulongé,72098,72,65,130,20,215,105,340,195
28109,Courceboeufs,72099,72,52,216,52,164,140,356,268
28110,Courcelles-la-Forêt,72100,72,26,129,55,88,71,214,155
28111,Courcemont,72101,72,44,176,116,208,140,464,220
28112,Courcival,72102,72,4,16,16,36,16,68,20
28113,Courdemanche,72103,72,125,115,65,215,105,385,240
28114,Courgains,72104,72,55,180,35,220,120,375,235
28115,Courgenard,72105,72,52,115,37,168,76,281,167
28116,Courtillers,72106,72,20,316,84,296,216,596,336
28117,Crannes-en-Champagne,72107,72,25,70,50,155,45,250,95
28118,Cré-sur-Loir,72108,72,65,230,95,235,165,495,295
28119,Crissé,72109,72,89,200,45,158,125,328,289
28120,Crosmières,72110,72,56,351,108,276,237,621,407
28121,Cures,72111,72,15,161,45,206,85,336,176
28122,Dangeul,72112,72,80,100,60,165,65,290,180
28123,Degré,72113,72,25,235,75,275,185,535,260
28124,Dehault,72114,72,19,74,22,58,67,147,93
28125,Dissay-sous-Courcillon,72115,72,166,249,74,234,164,472,415
28126,Dissé-sous-Ballon,72116,72,20,35,15,50,15,80,55
28127,Dissé-sous-le-Lude,72117,72,70,125,15,229,115,359,195
28128,Dollon,72118,72,170,410,75,495,310,880,580
28129,Domfront-en-Champagne,72119,72,92,284,100,352,208,660,376
28130,Doucelles,72120,72,5,95,20,60,85,165,100
28131,Douillet,72121,72,24,88,60,88,64,212,112
28132,Duneau,72122,72,165,300,65,285,245,595,465
28133,Dureil,72123,72,4,9,0,20,12,32,13
28134,Écommoy,72124,72,650,1120,388,1514,870,2772,1770
28135,Écorpain,72125,72,20,75,25,95,70,190,95
28136,Épineu-le-Chevreuil,72126,72,44,76,4,96,76,176,120
28137,Étival-lès-le-Mans,72127,72,225,535,140,745,305,1190,760
28138,Évaillé,72128,72,74,67,35,87,49,171,141
28139,Fatines,72129,72,24,254,88,236,192,516,278
28140,Fay,72130,72,44,196,56,224,100,380,240
28141,Fercé-sur-Sarthe,72131,72,33,177,38,145,154,337,210
28142,La Ferté-Bernard,72132,72,1709,1691,973,2677,1326,4976,3400
28143,Fillé,72133,72,110,440,80,560,305,945,550
28144,Flée,72134,72,57,116,61,151,93,305,173
28145,La Fontaine-Saint-Martin,72135,72,55,166,49,177,110,336,221
28146,Fontenay-sur-Vègre,72136,72,6,93,35,100,65,200,99
28147,Villeneuve-en-Perseigne,72137,72,224,565,163,818,445,1426,789
28148,Fresnay-sur-Sarthe,72138,72,454,353,149,647,230,1026,807
28149,Fyé,72139,72,112,272,116,292,188,596,384
28150,Gesnes-le-Gandelin,72141,72,60,280,80,270,250,600,340
28151,Grandchamp,72142,72,16,40,20,56,16,92,56
28152,Le Grand-Lucé,72143,72,332,344,120,485,280,885,676
28153,Gréez-sur-Roc,72144,72,125,45,20,120,40,180,170
28154,Le Grez,72145,72,37,78,12,166,47,225,115
28155,Guécélard,72146,72,352,793,191,943,558,1692,1145
28156,La Guierche,72147,72,79,274,102,350,210,662,353
28157,Jauzé,72148,72,6,12,12,25,6,43,18
28158,Joué-en-Charnie,72149,72,38,175,68,153,141,362,213
28159,Joué-l'Abbé,72150,72,125,335,145,405,265,815,460
28160,Juigné-sur-Sarthe,72151,72,110,295,115,460,150,725,405
28161,Juillé,72152,72,105,110,20,175,60,255,215
28162,Jupilles,72153,72,95,110,60,220,80,360,205
28163,La Flèche,72154,72,2137,3350,1428,5126,2136,8690,5487
28164,Laigné-en-Belin,72155,72,176,684,188,792,516,1496,860
28165,Lamnay,72156,72,80,331,55,313,216,584,411
28166,Lavardin,72157,72,69,187,53,226,163,442,256
28167,Lavaré,72158,72,110,230,65,260,180,505,340
28168,Lavenay,72159,72,48,62,10,131,55,196,110
28169,Lavernat,72160,72,70,150,45,230,130,405,220
28170,Lhomme,72161,72,223,163,44,335,87,466,386
28171,Ligron,72163,72,25,160,65,145,110,320,185
28172,Livet-en-Saosnois,72164,72,0,13,6,25,12,43,13
28173,Lombron,72165,72,185,518,165,648,349,1162,703
28174,Longnes,72166,72,33,115,29,90,53,172,148
28175,Louailles,72167,72,28,284,68,188,176,432,312
28176,Loué,72168,72,388,508,216,676,348,1240,896
28177,Louplande,72169,72,129,427,71,443,317,831,556
28178,Louvigny,72170,72,24,52,24,64,24,112,76
28179,Louzes,72171,72,25,9,4,38,8,50,34
28180,Le Luart,72172,72,240,360,108,412,288,808,600
28181,Luceau,72173,72,195,335,70,415,225,710,530
28182,Lucé-sous-Ballon,72174,72,9,27,0,30,33,63,36
28183,Luché-Pringé,72175,72,289,345,135,476,251,862,634
28184,Le Lude,72176,72,712,725,293,1460,567,2320,1437
28185,Maigné,72177,72,15,81,26,102,61,189,96
28186,Maisoncelles,72178,72,8,60,4,48,56,108,68
28187,Malicorne-sur-Sarthe,72179,72,420,435,195,539,323,1057,855
28188,Mamers,72180,72,1066,1070,505,1611,770,2886,2136
28189,Le Mans,72181,72,19924,33428,20525,41215,25216,86956,53352
28190,Mansigné,72182,72,236,364,128,488,264,880,600
28191,Marçon,72183,72,148,212,108,372,144,624,360
28192,Mareil-en-Champagne,72184,72,28,81,60,109,46,215,109
28193,Mareil-sur-Loir,72185,72,42,162,85,204,128,417,204
28194,Maresché,72186,72,124,268,140,252,132,524,392
28195,Marigné-Laillé,72187,72,136,440,172,508,380,1060,576
28196,Marollette,72188,72,25,30,10,55,30,95,55
28197,Marolles-les-Braults,72189,72,460,420,205,580,265,1050,880
28198,Marolles-lès-Saint-Calais,72190,72,15,55,15,140,50,205,70
28199,Mayet,72191,72,627,658,240,1054,483,1777,1285
28200,Les Mées,72192,72,20,25,15,50,15,80,45
28201,Melleray,72193,72,67,95,16,139,98,253,162
28202,Meurcé,72194,72,20,84,32,68,68,168,104
28203,Mézeray,72195,72,182,558,147,510,415,1072,740
28204,Mézières-sur-Ponthouin,72196,72,50,199,35,215,183,433,249
28205,Mézières-sous-Lavardin,72197,72,32,224,108,152,188,448,256
28206,La Milesse,72198,72,217,585,271,947,413,1631,802
28207,Moitron-sur-Sarthe,72199,72,40,72,4,48,56,108,112
28208,Moncé-en-Belin,72200,72,271,1011,234,1119,794,2147,1282
28209,Moncé-en-Saosnois,72201,72,15,64,10,73,48,131,79
28210,Monhoudou,72202,72,15,46,27,44,46,117,61
28211,Montabon,72203,72,96,164,56,308,132,496,260
28212,Montaillé,72204,72,55,125,30,155,135,320,180
28213,Montbizot,72205,72,185,549,148,468,442,1058,734
28214,Montmirail,72208,72,96,60,28,112,60,200,156
28215,Montreuil-le-Chétif,72209,72,54,65,22,43,81,146,119
28216,Montreuil-le-Henri,72210,72,15,105,20,104,75,199,120
28217,Mont-Saint-Jean,72211,72,92,164,35,205,128,368,256
28218,Moulins-le-Carbonnel,72212,72,79,169,45,255,110,410,248
28219,Mulsanne,72213,72,385,1271,405,1910,841,3156,1656
28220,Nauvay,72214,72,0,0,0,10,0,10,0
28221,Neufchâtel-en-Saosnois,72215,72,80,288,104,336,164,604,368
28222,Neuvillalais,72216,72,72,220,32,124,148,304,292
28223,Neuville-sur-Sarthe,72217,72,205,595,165,952,425,1542,800
28224,Neuvillette-en-Charnie,72218,72,36,84,45,88,56,189,120
28225,Neuvy-en-Champagne,72219,72,10,95,60,170,40,270,105
28226,Nogent-le-Bernard,72220,72,80,225,68,304,188,560,305
28227,Nogent-sur-Loir,72221,72,75,65,30,130,60,220,140
28228,Nouans,72222,72,30,80,10,110,55,175,110
28229,Noyen-sur-Sarthe,72223,72,507,647,224,793,476,1493,1154
28230,Nuillé-le-Jalais,72224,72,44,164,40,129,108,277,208
28231,Oisseau-le-Petit,72225,72,90,180,55,180,140,375,270
28232,Oizé,72226,72,80,445,180,295,325,800,525
28233,Panon,72227,72,0,15,0,0,25,25,15
28234,Parcé-sur-Sarthe,72228,72,224,636,132,660,440,1232,860
28235,Parennes,72229,72,45,145,65,160,95,320,190
28236,Parigné-le-Pôlin,72230,72,64,288,96,348,244,688,352
28237,Parigné-l'Évêque,72231,72,486,1222,350,1693,830,2873,1708
28238,Notre-Dame-du-Pé,72232,72,10,240,40,180,175,395,250
28239,Peray,72233,72,5,15,0,20,20,40,20
28240,Pezé-le-Robert,72234,72,20,86,34,118,63,215,106
28241,Piacé,72235,72,29,77,55,105,61,221,106
28242,Pincé,72236,72,15,50,0,55,75,130,65
28243,Pirmil,72237,72,36,156,64,112,136,312,192
28244,Pizieux,72238,72,3,6,12,22,12,46,9
28245,Poillé-sur-Vègre,72239,72,20,195,50,205,135,390,215
28246,Poncé-sur-le-Loir,72240,72,85,63,26,104,72,202,148
28247,Montfort-le-Gesnois,72241,72,304,702,321,938,619,1878,1006
28248,Pontvallain,72243,72,170,492,100,561,308,969,662
28249,Précigné,72244,72,379,757,223,877,555,1655,1136
28250,Préval,72245,72,32,184,72,228,148,448,216
28251,Prévelles,72246,72,10,75,10,100,40,150,85
28252,Pruillé-le-Chétif,72247,72,80,347,161,456,181,798,427
28253,Pruillé-l'Éguillé,72248,72,84,208,56,264,184,504,292
28254,La Quinte,72249,72,68,248,92,188,212,492,316
28255,Rahay,72250,72,44,60,20,56,28,104,104
28256,René,72251,72,40,88,48,108,84,240,128
28257,Requeil,72252,72,95,335,90,405,255,750,430
28258,Roézé-sur-Sarthe,72253,72,200,767,150,854,537,1541,967
28259,Rouessé-Fontaine,72254,72,30,65,55,80,60,195,95
28260,Rouessé-Vassé,72255,72,110,235,60,240,184,484,345
28261,Rouez,72256,72,100,220,75,200,180,455,320
28262,Rouillon,72257,72,215,541,208,941,291,1440,756
28263,Rouperroux-le-Coquet,72259,72,17,76,23,108,42,173,93
28264,Ruaudin,72260,72,405,760,195,1305,520,2020,1165
28265,Ruillé-en-Champagne,72261,72,9,98,9,110,76,195,107
28266,Ruillé-sur-Loir,72262,72,225,180,60,430,120,610,405
28267,Sablé-sur-Sarthe,72264,72,1911,2788,1252,3772,1915,6939,4699
28268,Saint-Aignan,72265,72,24,76,24,84,64,172,100
28269,Saint-Aubin-de-Locquenay,72266,72,95,150,60,274,94,428,245
28270,Saint-Aubin-des-Coudrais,72267,72,90,227,85,384,135,604,317
28271,Saint-Biez-en-Belin,72268,72,41,203,44,200,149,393,244
28272,Saint-Calais,72269,72,621,526,245,1065,450,1760,1147
28273,Saint-Calez-en-Saosnois,72270,72,3,31,30,50,20,100,34
28274,Saint-Célerin,72271,72,72,266,95,137,211,443,338
28275,Sainte-Cérotte,72272,72,56,60,48,112,40,200,116
28276,Saint-Christophe-du-Jambet,72273,72,17,68,16,44,62,122,85
28277,Saint-Christophe-en-Champagne,72274,72,17,56,6,48,42,96,73
28278,Saint-Corneille,72275,72,79,432,159,320,305,784,511
28279,Saint-Cosme-en-Vairais,72276,72,354,440,140,698,345,1183,794
28280,Saint-Denis-des-Coudrais,72277,72,4,24,16,60,12,88,28
28281,Saint-Denis-d'Orques,72278,72,105,207,55,238,169,462,312
28282,Saint-Georges-de-la-Couée,72279,72,17,21,9,62,19,90,38
28283,Saint-Georges-du-Bois,72280,72,176,503,200,806,302,1308,679
28284,Saint-Georges-du-Rosay,72281,72,13,99,38,141,105,284,112
28285,Saint-Georges-le-Gaultier,72282,72,76,140,41,156,68,265,216
28286,Saint-Germain-d'Arcé,72283,72,50,105,20,125,60,205,155
28287,Saint-Germain-sur-Sarthe,72284,72,40,180,45,195,130,370,220
28288,Saint-Gervais-de-Vic,72286,72,80,85,55,115,55,225,165
28289,Saint-Gervais-en-Belin,72287,72,180,609,200,698,428,1326,789
28290,Sainte-Jamme-sur-Sarthe,72289,72,385,515,150,570,370,1090,900
28291,Saint-Jean-d'Assé,72290,72,144,518,225,352,412,989,662
28292,Saint-Jean-de-la-Motte,72291,72,98,234,76,268,189,533,332
28293,Saint-Jean-des-Échelles,72292,72,25,60,0,95,70,165,85
28294,Saint-Jean-du-Bois,72293,72,80,168,68,136,120,324,248
28295,Saint-Léonard-des-Bois,72294,72,80,115,45,155,90,290,195
28296,Saint-Longis,72295,72,90,90,35,250,55,340,180
28297,Saint-Maixent,72296,72,57,201,49,215,157,421,258
28298,Saint-Marceau,72297,72,73,148,47,128,100,275,221
28299,Saint-Mars-de-Locquenay,72298,72,44,157,51,140,113,304,201
28300,Saint-Mars-d'Outillé,72299,72,202,679,172,666,502,1340,881
28301,Saint-Mars-la-Brière,72300,72,265,675,275,860,555,1690,940
28302,Saint-Martin-des-Monts,72302,72,8,40,12,88,28,128,48
28303,Saint-Michel-de-Chavaignes,72303,72,115,209,50,200,180,430,324
28304,Sainte-Osmane,72304,72,16,37,9,64,28,101,53
28305,Saint-Ouen-de-Mimbré,72305,72,90,271,89,332,150,571,361
28306,Saint-Ouen-en-Belin,72306,72,60,405,120,450,270,840,465
28307,Saint-Ouen-en-Champagne,72307,72,16,66,33,46,48,127,82
28308,Saint-Paterne,72308,72,285,340,110,535,255,900,625
28309,Saint-Paul-le-Gaultier,72309,72,25,75,35,75,85,195,100
28310,Saint-Pavace,72310,72,165,471,130,799,285,1214,636
28311,Saint-Pierre-de-Chevillé,72311,72,70,75,25,130,50,205,145
28312,Saint-Pierre-des-Bois,72312,72,24,84,32,28,64,124,108
28313,Saint-Pierre-des-Ormes,72313,72,36,62,3,45,49,97,98
28314,Saint-Pierre-du-Lorouër,72314,72,38,63,13,107,66,186,101
28315,Saint-Rémy-de-Sillé,72315,72,116,212,88,300,132,520,328
28316,Saint-Rémy-des-Monts,72316,72,98,186,30,219,109,358,284
28317,Saint-Rémy-du-Val,72317,72,92,97,60,203,81,344,189
28318,Sainte-Sabine-sur-Longève,72319,72,30,230,85,240,164,489,260
28319,Saint-Saturnin,72320,72,172,604,289,844,360,1493,776
28320,Saint-Symphorien,72321,72,65,160,65,144,155,364,225
28321,Saint-Ulphace,72322,72,55,40,25,65,35,125,95
28322,Saint-Victeur,72323,72,20,135,70,120,95,285,155
28323,Saint-Vincent-des-Prés,72324,72,61,133,25,129,93,247,194
28324,Saint-Vincent-du-Lorouër,72325,72,194,195,70,280,105,455,389
28325,Saosnes,72326,72,20,55,15,55,60,130,75
28326,Sarcé,72327,72,36,74,36,93,50,179,110
28327,Sargé-lès-le-Mans,72328,72,570,793,215,1597,425,2237,1363
28328,Savigné-l'Évêque,72329,72,472,988,319,1510,698,2527,1460
28329,Savigné-sous-le-Lude,72330,72,26,91,29,148,73,250,117
28330,Sceaux-sur-Huisne,72331,72,44,172,52,148,148,348,216
28331,Ségrie,72332,72,63,111,72,199,77,348,174
28332,Semur-en-Vallon,72333,72,65,110,30,175,80,285,175
28333,Sillé-le-Guillaume,72334,72,385,465,105,755,390,1250,850
28334,Sillé-le-Philippe,72335,72,64,294,73,334,244,651,358
28335,Solesmes,72336,72,285,170,115,408,120,643,455
28336,Sougé-le-Ganelon,72337,72,191,171,62,261,117,440,362
28337,Souillé,72338,72,15,225,45,180,185,410,240
28338,Souligné-Flacé,72339,72,25,195,55,275,135,465,220
28339,Souligné-sous-Ballon,72340,72,97,320,90,317,279,686,417
28340,Soulitré,72341,72,52,199,62,156,137,355,251
28341,Souvigné-sur-Même,72342,72,9,37,3,65,40,108,46
28342,Souvigné-sur-Sarthe,72343,72,25,174,46,227,107,380,199
28343,Spay,72344,72,180,770,190,1126,635,1951,950
28344,Surfonds,72345,72,24,96,28,96,96,220,120
28345,La Suze-sur-Sarthe,72346,72,658,1149,387,1322,873,2582,1807
28346,Tassé,72347,72,28,100,16,76,76,168,128
28347,Tassillé,72348,72,20,44,12,48,24,84,64
28348,Teillé,72349,72,51,123,17,148,101,266,174
28349,Teloché,72350,72,280,825,215,1205,510,1930,1105
28350,Tennie,72351,72,165,309,92,289,185,566,474
28351,Terrehault,72352,72,15,45,14,30,40,84,60
28352,Théligny,72353,72,40,68,4,48,64,116,108
28353,Thoigné,72354,72,12,35,9,66,22,97,47
28354,Thoiré-sous-Contensor,72355,72,15,30,15,10,20,45,45
28355,Thoiré-sur-Dinan,72356,72,48,128,32,132,80,244,176
28356,Thorée-les-Pins,72357,72,68,188,48,199,153,400,256
28357,Thorigné-sur-Dué,72358,72,175,400,130,449,330,909,575
28358,Torcé-en-Vallée,72359,72,104,408,196,352,304,852,512
28359,Trangé,72360,72,63,396,97,514,216,827,459
28360,Tresson,72361,72,80,103,10,194,69,273,183
28361,Le Tronchet,72362,72,6,24,22,38,19,79,30
28362,Tuffé Val de la Chéronne,72363,72,337,361,180,496,254,930,698
28363,Vaas,72364,72,270,365,100,555,245,900,635
28364,Valennes,72366,72,47,48,24,132,34,190,95
28365,Vallon-sur-Gée,72367,72,54,215,93,193,113,399,269
28366,Vancé,72368,72,45,55,25,135,50,210,100
28367,Verneil-le-Chétif,72369,72,42,152,47,201,105,353,194
28368,Vernie,72370,72,48,83,36,81,54,171,131
28369,Vezot,72372,72,4,8,12,24,8,44,12
28370,Vibraye,72373,72,522,501,232,792,415,1439,1023
28371,Villaines-la-Carelle,72374,72,20,34,6,50,26,82,54
28372,Villaines-la-Gonais,72375,72,43,127,28,215,97,340,170
28373,Villaines-sous-Lucé,72376,72,74,182,50,197,129,376,256
28374,Villaines-sous-Malicorne,72377,72,140,275,90,320,190,600,415
28375,Vion,72378,72,125,390,160,495,265,920,515
28376,Viré-en-Champagne,72379,72,10,62,25,55,56,136,72
28377,Vivoin,72380,72,110,232,88,340,101,529,342
28378,Voivres-lès-le-Mans,72381,72,85,413,127,320,357,804,498
28379,Volnay,72382,72,77,264,75,227,190,492,341
28380,Vouvray-sur-Huisne,72383,72,0,47,3,24,32,59,47
28381,Vouvray-sur-Loir,72384,72,180,185,80,210,120,410,365
28382,Yvré-le-Pôlin,72385,72,184,472,116,570,366,1052,656
28383,Yvré-l'Évêque,72386,72,476,987,282,1732,590,2604,1463
28384,Aiguebelette-le-Lac,73001,73,24,56,16,100,52,168,80
28385,Aiguebelle,73002,73,92,292,104,284,257,645,384
28386,Aigueblanche,73003,73,389,648,269,1097,556,1922,1037
28387,Aillon-le-Jeune,73004,73,33,102,49,140,67,256,135
28388,Aillon-le-Vieux,73005,73,4,24,17,59,33,109,28
28389,Aime-la-Plagne,73006,73,578,1053,312,1445,933,2690,1631
28390,Aiton,73007,73,58,398,107,250,336,693,456
28391,Aix-les-Bains,73008,73,5360,6182,3345,9452,5180,17977,11542
28392,Entrelacs,73010,73,467,1538,559,1939,1248,3746,2005
28393,Albertville,73011,73,2695,4251,2250,5674,3377,11301,6946
28394,Albiez-le-Jeune,73012,73,16,60,4,48,32,84,76
28395,Albiez-Montrond,73013,73,65,90,25,150,75,250,155
28396,Allondaz,73014,73,32,53,17,63,52,132,85
28397,Les Allues,73015,73,135,403,170,657,462,1289,538
28398,Apremont,73017,73,150,215,75,370,185,630,365
28399,Arbin,73018,73,152,192,80,260,124,464,344
28400,Argentine,73019,73,124,178,60,395,173,628,302
28401,Arith,73020,73,50,85,55,178,50,283,135
28402,Arvillard,73021,73,88,208,40,292,180,512,296
28403,Attignat-Oncin,73022,73,70,105,35,234,75,344,175
28404,Aussois,73023,73,57,140,34,230,139,403,197
28405,Les Avanchers-Valmorel,73024,73,100,160,92,236,152,480,260
28406,Avressieux,73025,73,20,165,35,195,115,345,185
28407,Avrieux,73026,73,50,80,44,175,70,289,130
28408,Ayn,73027,73,36,104,24,124,80,228,140
28409,La Balme,73028,73,30,61,38,79,47,164,91
28410,Barberaz,73029,73,693,1066,371,1460,864,2695,1759
28411,Barby,73030,73,458,582,299,899,478,1676,1040
28412,Bassens,73031,73,445,833,464,1204,820,2488,1278
28413,La Bâthie,73032,73,256,477,162,757,363,1282,733
28414,La Bauche,73033,73,35,170,35,165,90,290,205
28415,Beaufort,73034,73,303,415,205,690,421,1316,718
28416,Bellecombe-en-Bauges,73036,73,76,168,32,268,100,400,244
28417,Belmont-Tramonet,73039,73,75,145,30,180,95,305,220
28418,Bessans,73040,73,56,56,44,136,36,216,112
28419,Betton-Bettonet,73041,73,36,98,12,66,67,145,134
28420,Billième,73042,73,32,60,32,104,32,168,92
28421,La Biolle,73043,73,160,666,206,738,456,1400,826
28422,Le Bois,73045,73,40,129,40,126,76,242,169
28423,Bonneval,73046,73,25,12,0,24,16,40,37
28424,Bonneval-sur-Arc,73047,73,4,56,16,75,61,152,60
28425,Bonvillard,73048,73,35,96,25,96,64,185,131
28426,Bonvillaret,73049,73,10,45,10,54,30,94,55
28427,Bourdeau,73050,73,104,100,40,172,115,327,204
28428,Le Bourget-du-Lac,73051,73,399,1026,819,1246,723,2788,1425
28429,Bourget-en-Huile,73052,73,20,25,8,37,29,74,45
28430,Bourgneuf,73053,73,56,201,33,166,152,351,257
28431,Bourg-Saint-Maurice,73054,73,657,1731,897,2282,1435,4614,2388
28432,Bozel,73055,73,181,449,121,744,386,1251,630
28433,Bramans,73056,73,84,88,40,132,76,248,172
28434,Brides-les-Bains,73057,73,44,109,30,179,113,322,153
28435,La Bridoire,73058,73,165,289,117,362,224,703,454
28436,Brison-Saint-Innocent,73059,73,375,380,140,870,255,1265,755
28437,Césarches,73061,73,20,112,32,160,80,272,132
28438,Cevins,73063,73,108,156,74,162,136,372,264
28439,Challes-les-Eaux,73064,73,658,1129,609,1774,831,3214,1787
28440,Chambéry,73065,73,7262,14468,9110,15449,11380,35939,21730
28441,La Chambre,73067,73,203,199,61,390,138,589,402
28442,Chamousset,73068,73,38,131,29,220,91,340,169
28443,Chamoux-sur-Gelon,73069,73,108,240,60,252,228,540,348
28444,Champagneux,73070,73,53,171,42,218,131,391,224
28445,Champagny-en-Vanoise,73071,73,61,138,67,174,83,324,199
28446,Champ-Laurent,73072,73,24,16,0,8,4,12,40
28447,Chanaz,73073,73,58,108,25,151,104,280,166
28448,La Chapelle,73074,73,50,70,20,120,90,230,120
28449,La Chapelle-Blanche,73075,73,52,124,39,216,77,332,176
28450,La Chapelle-du-Mont-du-Chat,73076,73,4,76,36,60,76,172,80
28451,Les Chapelles,73077,73,56,128,52,200,104,356,184
28452,La Chapelle-Saint-Martin,73078,73,9,41,3,31,46,80,50
28453,Châteauneuf,73079,73,92,234,44,228,218,490,326
28454,Le Châtel,73080,73,25,35,25,45,45,115,60
28455,Le Châtelard,73081,73,108,168,50,165,134,349,276
28456,La Chavanne,73082,73,25,214,60,216,136,412,239
28457,Les Chavannes-en-Maurienne,73083,73,30,75,5,120,45,170,105
28458,Chignin,73084,73,115,200,75,250,220,545,315
28459,Chindrieux,73085,73,197,303,88,419,289,796,500
28460,Cléry,73086,73,36,152,20,140,104,264,188
28461,Cognin,73087,73,1010,1277,586,1929,1072,3587,2287
28462,Cohennoz,73088,73,39,8,12,46,21,79,47
28463,Coise-Saint-Jean-Pied-Gauthier,73089,73,86,330,91,382,231,704,416
28464,La Compôte,73090,73,55,40,5,90,50,145,95
28465,Conjux,73091,73,20,34,16,76,31,123,54
28466,Corbel,73092,73,5,35,25,60,35,120,40
28467,Crest-Voland,73094,73,32,68,41,111,83,235,100
28468,La Croix-de-la-Rochette,73095,73,24,98,12,96,98,206,122
28469,Cruet,73096,73,130,250,64,352,220,636,380
28470,Curienne,73097,73,23,176,33,219,151,403,199
28471,Les Déserts,73098,73,72,192,64,256,184,504,264
28472,Détrier,73099,73,40,112,48,128,100,276,152
28473,Domessin,73100,73,227,449,51,692,324,1067,676
28474,Doucy-en-Bauges,73101,73,15,10,0,65,0,65,25
28475,Drumettaz-Clarafond,73103,73,238,672,216,850,548,1614,910
28476,Dullin,73104,73,32,100,32,140,92,264,132
28477,Les Échelles,73105,73,136,326,128,329,273,730,462
28478,École,73106,73,29,58,3,92,45,140,87
28479,Entremont-le-Vieux,73107,73,60,164,64,208,136,408,224
28480,Épierre,73109,73,117,201,72,204,168,444,318
28481,Esserts-Blay,73110,73,110,166,68,211,162,441,276
28482,Étable,73111,73,30,90,30,120,110,260,120
28483,Feissons-sur-Isère,73112,73,40,190,35,210,115,360,230
28484,Feissons-sur-Salins,73113,73,8,64,16,52,40,108,72
28485,Flumet,73114,73,79,172,72,231,139,442,251
28486,Fontcouverte-la-Toussuire,73116,73,30,105,80,185,145,410,135
28487,Fourneaux,73117,73,146,118,24,232,98,354,264
28488,Francin,73118,73,89,275,35,330,165,530,364
28489,Freney,73119,73,4,20,20,36,28,84,24
28490,Fréterive,73120,73,38,127,63,149,113,325,165
28491,Frontenex,73121,73,196,430,168,590,303,1061,626
28492,Gerbaix,73122,73,44,80,22,120,65,207,124
28493,La Giettaz,73123,73,60,85,21,140,58,219,145
28494,Gilly-sur-Isère,73124,73,344,606,222,1238,441,1901,950
28495,Gresin,73127,73,12,108,68,112,72,252,120
28496,Grésy-sur-Aix,73128,73,364,1203,442,1402,988,2832,1567
28497,Grésy-sur-Isère,73129,73,100,310,135,440,250,825,410
28498,Grignon,73130,73,200,520,164,777,350,1291,720
28499,Hautecour,73131,73,40,65,15,135,45,195,105
28500,Hauteluce,73132,73,85,180,70,280,125,475,265
28501,Hauteville,73133,73,32,104,20,84,100,204,136
28502,Hermillon,73135,73,56,117,32,210,118,360,173
28503,Jacob-Bellecombette,73137,73,293,701,920,922,553,2395,994
28504,Jarrier,73138,73,72,108,32,200,72,304,180
28505,Jarsy,73139,73,16,50,8,107,39,154,66
28506,Jongieux,73140,73,12,86,30,88,61,179,98
28507,Laissaud,73141,73,48,157,68,204,119,391,205
28508,Landry,73142,73,64,224,92,220,260,572,288
28509,Lanslebourg-Mont-Cenis,73143,73,85,135,105,185,135,425,220
28510,Lanslevillard,73144,73,36,104,52,172,104,328,140
28511,Lépin-le-Lac,73145,73,62,133,12,100,92,204,195
28512,Lescheraines,73146,73,102,184,56,186,177,419,286
28513,Loisieux,73147,73,16,29,26,50,34,110,45
28514,Lucey,73149,73,27,68,0,106,74,180,95
28515,La Plagne Tarentaise,73150,73,297,922,299,1384,814,2497,1219
28516,Les Marches,73151,73,200,599,251,882,419,1552,799
28517,Marcieux,73152,73,6,39,9,72,27,108,45
28518,Marthod,73153,73,164,304,140,556,244,940,468
28519,Mercury,73154,73,306,743,198,1025,682,1905,1049
28520,Méry,73155,73,99,392,163,588,269,1020,491
28521,Meyrieux-Trouet,73156,73,40,64,24,120,52,196,104
28522,Modane,73157,73,535,710,236,1095,593,1924,1245
28523,Les Mollettes,73159,73,50,228,38,220,182,440,278
28524,Montagnole,73160,73,80,200,98,315,155,568,280
28525,Montagny,73161,73,60,135,70,300,100,470,195
28526,Montailleur,73162,73,39,160,70,259,125,454,199
28527,Montaimont,73163,73,9,13,16,56,21,93,22
28528,Montcel,73164,73,77,245,75,322,205,602,322
28529,Montendry,73166,73,0,20,5,20,24,49,20
28530,Montgellafrey,73167,73,10,3,3,21,6,30,13
28531,Montgilbert,73168,73,16,13,15,28,15,58,29
28532,Monthion,73170,73,55,150,20,175,115,310,205
28533,Montmélian,73171,73,376,979,570,1170,803,2543,1355
28534,Montricher-Albanne,73173,73,60,85,50,175,105,330,145
28535,Montsapey,73175,73,0,15,0,26,30,56,15
28536,Montvalezan,73176,73,52,147,72,199,137,408,199
28537,Montvernier,73177,73,17,56,22,62,45,129,73
28538,La Motte-en-Bauges,73178,73,50,115,45,180,103,328,165
28539,La Motte-Servolex,73179,73,1329,2539,1211,4143,2148,7502,3868
28540,Motz,73180,73,68,88,28,148,80,256,156
28541,Moûtiers,73181,73,384,878,432,1065,700,2197,1262
28542,Mouxy,73182,73,208,575,148,775,513,1436,783
28543,Myans,73183,73,152,295,45,435,205,685,447
28544,Nances,73184,73,37,97,22,146,80,248,134
28545,Notre-Dame-de-Bellecombe,73186,73,54,107,43,126,92,261,161
28546,La Léchère,73187,73,201,376,169,675,311,1155,577
28547,Notre-Dame-des-Millières,73188,73,105,226,80,334,205,619,331
28548,Notre-Dame-du-Cruet,73189,73,20,52,8,100,44,152,72
28549,Notre-Dame-du-Pré,73190,73,45,50,15,110,50,175,95
28550,Novalaise,73191,73,241,522,86,693,384,1163,763
28551,Le Noyer,73192,73,22,36,9,65,41,115,58
28552,Ontex,73193,73,8,24,4,40,20,64,32
28553,Orelle,73194,73,60,80,20,135,60,215,140
28554,Pallud,73196,73,92,176,56,272,140,468,268
28555,Peisey-Nancroix,73197,73,65,128,91,191,114,396,193
28556,La Perrière,73198,73,56,112,40,140,108,288,168
28557,Planaise,73200,73,24,128,64,136,140,340,152
28558,Planay,73201,73,35,73,37,148,77,262,108
28559,Plancherine,73202,73,40,127,45,143,85,273,167
28560,Pontamafrey-Montpascal,73203,73,35,57,12,123,32,167,92
28561,Le Pont-de-Beauvoisin,73204,73,276,511,172,579,373,1124,787
28562,Le Pontet,73205,73,45,25,10,45,0,55,70
28563,Pralognan-la-Vanoise,73206,73,106,157,64,233,108,405,263
28564,Presle,73207,73,55,90,20,182,70,272,145
28565,Pugny-Chatenod,73208,73,95,220,40,360,190,590,315
28566,Puygros,73210,73,20,100,20,145,95,260,120
28567,Queige,73211,73,105,185,70,341,130,541,290
28568,Randens,73212,73,110,183,38,271,144,453,293
28569,La Ravoire,73213,73,991,1848,785,2564,1632,4981,2839
28570,Rochefort,73214,73,24,60,8,60,48,116,84
28571,La Rochette,73215,73,509,909,271,1145,666,2082,1418
28572,Rognaix,73216,73,44,112,48,136,92,276,156
28573,Rotherens,73217,73,20,138,8,90,99,197,158
28574,Ruffieux,73218,73,75,200,80,313,190,583,275
28575,Saint-Alban-de-Montbel,73219,73,68,172,48,208,132,388,240
28576,Saint-Alban-d'Hurtières,73220,73,64,68,12,140,52,204,132
28577,Saint-Alban-des-Villards,73221,73,23,15,20,45,0,65,38
28578,Saint-Alban-Leysse,73222,73,704,1246,735,1861,1002,3598,1950
28579,Saint-André,73223,73,54,119,28,150,80,258,173
28580,Saint-Avre,73224,73,76,226,82,276,166,524,302
28581,Saint-Baldoph,73225,73,292,650,188,1036,492,1716,942
28582,Saint-Béron,73226,73,174,410,130,530,375,1035,584
28583,Saint-Bon-Tarentaise,73227,73,180,445,170,670,425,1265,625
28584,Saint-Cassin,73228,73,68,162,56,328,124,508,230
28585,Saint-Christophe,73229,73,32,104,40,152,136,328,136
28586,Saint-Colomban-des-Villards,73230,73,40,56,12,55,39,106,96
28587,Saint-Étienne-de-Cuines,73231,73,168,265,68,392,202,662,433
28588,Sainte-Foy-Tarentaise,73232,73,40,186,70,260,187,517,226
28589,Saint-Franc,73233,73,18,30,8,47,38,93,48
28590,Saint-François-de-Sales,73234,73,16,32,0,80,24,104,48
28591,Saint-François-Longchamp,73235,73,0,60,52,76,64,192,60
28592,Saint-Genix-sur-Guiers,73236,73,340,621,220,676,464,1360,961
28593,Saint-Georges-d'Hurtières,73237,73,35,70,16,96,68,180,105
28594,Sainte-Hélène-du-Lac,73240,73,48,182,41,267,122,430,230
28595,Sainte-Hélène-sur-Isère,73241,73,104,296,152,332,265,749,400
28596,Saint-Jean-d'Arves,73242,73,20,80,35,60,90,185,100
28597,Saint-Jean-d'Arvey,73243,73,140,440,179,619,310,1108,580
28598,Saint-Jean-de-Belleville,73244,73,75,130,45,170,115,330,205
28599,Saint-Jean-de-Chevelu,73245,73,56,204,100,272,156,528,260
28600,Saint-Jean-de-Couz,73246,73,22,62,34,74,45,153,84
28601,Saint-Jean-de-la-Porte,73247,73,85,236,67,239,181,487,321
28602,Saint-Jean-de-Maurienne,73248,73,1386,1588,750,2621,1249,4620,2974
28603,Saint-Jeoire-Prieuré,73249,73,120,349,111,378,298,787,469
28604,Saint-Julien-Mont-Denis,73250,73,225,335,110,640,345,1095,560
28605,Saint-Léger,73252,73,30,35,20,105,45,170,65
28606,Saint-Marcel,73253,73,70,135,100,175,140,415,205
28607,Sainte-Marie-d'Alvey,73254,73,12,27,3,57,22,82,39
28608,Sainte-Marie-de-Cuines,73255,73,68,216,64,288,152,504,284
28609,Saint-Martin-d'Arc,73256,73,42,64,48,116,20,184,106
28610,Les Belleville,73257,73,217,681,344,967,800,2111,898
28611,Saint-Martin-de-la-Porte,73258,73,130,130,45,265,100,410,260
28612,Saint-Martin-sur-la-Chambre,73259,73,88,108,12,164,124,300,196
28613,Saint-Maurice-de-Rotherens,73260,73,12,43,4,81,43,128,55
28614,Saint-Michel-de-Maurienne,73261,73,431,507,192,795,353,1340,938
28615,Saint-Nicolas-la-Chapelle,73262,73,50,105,50,164,65,279,155
28616,Saint-Offenge,73263,73,70,285,97,281,227,605,355
28617,Saint-Ours,73265,73,50,175,30,223,135,388,225
28618,Saint-Oyen,73266,73,25,50,25,95,35,155,75
28619,Saint-Pancrace,73267,73,8,68,4,102,87,193,76
28620,Saint-Paul-sur-Isère,73268,73,37,95,57,183,77,317,132
28621,Saint-Paul,73269,73,103,170,35,208,130,373,273
28622,Saint-Pierre-d'Albigny,73270,73,495,924,285,1169,786,2240,1419
28623,Saint-Pierre-d'Alvey,73271,73,22,69,15,69,50,134,91
28624,Saint-Pierre-de-Belleville,73272,73,60,40,0,20,45,65,100
28625,Saint-Pierre-de-Curtille,73273,73,35,115,20,125,85,230,150
28626,Saint-Pierre-d'Entremont,73274,73,25,103,39,116,88,243,128
28627,Saint-Pierre-de-Genebroz,73275,73,30,105,5,115,95,215,135
28628,Saint-Pierre-de-Soucy,73276,73,75,105,25,140,65,230,180
28629,Sainte-Reine,73277,73,40,40,10,45,25,80,80
28630,Saint-Rémy-de-Maurienne,73278,73,166,308,116,340,251,707,474
28631,Saint-Sorlin-d'Arves,73280,73,25,70,45,110,95,250,95
28632,Saint-Sulpice,73281,73,70,187,50,322,115,487,257
28633,Saint-Thibaud-de-Couz,73282,73,118,317,56,288,215,559,435
28634,Saint-Vital,73283,73,56,135,38,227,117,382,191
28635,Salins-Fontaine,73284,73,200,193,91,340,134,565,393
28636,Séez,73285,73,278,515,310,796,483,1589,793
28637,Serrières-en-Chautagne,73286,73,194,372,80,319,261,660,566
28638,Sollières-Sardières,73287,73,20,26,16,61,26,103,46
28639,Sonnaz,73288,73,193,456,132,532,393,1057,649
28640,La Table,73289,73,60,100,44,136,92,272,160
28641,Termignon,73290,73,35,76,33,127,80,240,111
28642,Thénésol,73292,73,22,65,8,118,47,173,87
28643,Thoiry,73293,73,46,145,16,119,109,244,191
28644,La Thuile,73294,73,32,104,20,68,84,172,136
28645,Tignes,73296,73,65,499,530,616,776,1922,564
28646,Tournon,73297,73,54,142,66,203,82,351,196
28647,Tours-en-Savoie,73298,73,100,235,70,285,235,590,335
28648,Traize,73299,73,30,75,25,120,60,205,105
28649,Tresserve,73300,73,375,606,319,1122,451,1892,981
28650,Trévignin,73301,73,52,165,53,344,92,489,217
28651,La Trinité,73302,73,24,54,49,141,26,216,78
28652,Ugine,73303,73,1101,1553,679,2258,1230,4167,2654
28653,Val-d'Isère,73304,73,80,380,205,470,425,1100,460
28654,Valloire,73306,73,106,205,139,331,236,706,311
28655,Valmeinier,73307,73,25,110,130,100,150,380,135
28656,Venthon,73308,73,115,160,35,205,110,350,275
28657,Verel-de-Montbel,73309,73,12,54,25,107,57,189,66
28658,Verel-Pragondran,73310,73,24,104,72,176,72,320,128
28659,Le Verneil,73311,73,30,17,0,16,16,32,47
28660,Verrens-Arvey,73312,73,43,251,56,248,215,519,294
28661,Verthemex,73313,73,32,41,8,36,40,84,73
28662,Villard-d'Héry,73314,73,0,73,0,105,56,161,73
28663,Villard-Léger,73315,73,70,120,50,135,96,281,190
28664,Villard-Sallet,73316,73,35,65,40,103,60,203,100
28665,Villard-sur-Doron,73317,73,74,160,55,269,125,449,234
28666,Villarembert,73318,73,15,60,25,108,54,187,75
28667,Villargondran,73320,73,78,198,87,331,119,537,276
28668,Villarodin-Bourget,73322,73,72,104,40,160,116,316,176
28669,Villaroger,73323,73,32,76,20,184,68,272,108
28670,Villaroux,73324,73,15,61,12,62,47,121,76
28671,Vimines,73326,73,250,468,156,636,393,1185,718
28672,Vions,73327,73,65,95,35,135,75,245,160
28673,Viviers-du-Lac,73328,73,171,538,251,723,418,1392,709
28674,Voglans,73329,73,103,436,259,564,363,1186,539
28675,Yenne,73330,73,412,701,295,894,534,1723,1113
28676,Abondance,74001,74,124,333,116,415,239,770,457
28677,Alby-sur-Chéran,74002,74,155,780,245,670,634,1549,935
28678,Alex,74003,74,64,286,40,412,208,660,350
28679,Allèves,74004,74,21,117,50,99,76,225,138
28680,Allinges,74005,74,430,1061,267,1462,911,2640,1491
28681,Allonzier-la-Caille,74006,74,87,478,212,558,480,1250,565
28682,Amancy,74007,74,184,604,251,695,592,1538,788
28683,Ambilly,74008,74,555,1251,911,1662,1544,4117,1806
28684,Andilly,74009,74,67,225,62,207,214,483,292
28685,Annecy,74010,74,7899,11038,7692,14197,10597,32486,18937
28686,Annecy-le-Vieux,74011,74,3217,4223,2302,6518,3646,12466,7440
28687,Annemasse,74012,74,3063,8996,5831,8085,8751,22667,12059
28688,Anthy-sur-Léman,74013,74,210,520,140,885,348,1373,730
28689,Arâches-la-Frasse,74014,74,96,443,198,644,410,1252,539
28690,Arbusigny,74015,74,55,340,124,285,312,721,395
28691,Archamps,74016,74,152,681,307,708,710,1725,833
28692,Arenthon,74018,74,148,408,164,508,324,996,556
28693,Argonay,74019,74,192,587,297,734,470,1501,779
28694,Armoy,74020,74,76,380,80,480,264,824,456
28695,Arthaz-Pont-Notre-Dame,74021,74,132,327,146,472,279,897,459
28696,Aviernoz,74022,74,45,295,63,279,210,552,340
28697,Ayse,74024,74,205,506,168,706,470,1344,711
28698,Ballaison,74025,74,100,389,139,508,317,964,489
28699,La Balme-de-Sillingy,74026,74,300,1364,545,1771,1001,3317,1664
28700,La Balme-de-Thuy,74027,74,38,118,21,118,100,239,156
28701,Bassy,74029,74,40,141,30,135,98,263,181
28702,La Baume,74030,74,4,44,47,81,69,197,48
28703,Beaumont,74031,74,199,676,311,719,645,1675,875
28704,Bellevaux,74032,74,125,307,135,383,238,756,432
28705,Bernex,74033,74,116,291,90,399,256,745,407
28706,Le Biot,74034,74,8,143,29,197,127,353,151
28707,Bloye,74035,74,50,195,30,203,140,373,245
28708,Bluffy,74036,74,5,95,30,183,65,278,100
28709,Boëge,74037,74,142,416,168,513,305,986,558
28710,Bogève,74038,74,61,257,108,275,235,618,318
28711,Bonne,74040,74,281,921,297,954,756,2007,1202
28712,Bonnevaux,74041,74,38,77,40,53,44,137,115
28713,Bonneville,74042,74,948,3406,1683,3173,2823,7679,4354
28714,Bons-en-Chablais,74043,74,367,1418,543,1663,1218,3424,1785
28715,Bossey,74044,74,50,241,42,266,264,572,291
28716,Le Bouchet-Mont-Charvin,74045,74,41,40,12,68,40,120,81
28717,Boussy,74046,74,29,153,20,131,116,267,182
28718,Brenthonne,74048,74,65,222,134,284,217,635,287
28719,Brizon,74049,74,12,116,68,160,100,328,128
28720,Burdignin,74050,74,40,125,70,270,115,455,165
28721,Cercier,74051,74,40,181,44,204,172,420,221
28722,Cernex,74052,74,84,278,64,320,225,609,362
28723,Cervens,74053,74,85,349,69,243,271,583,434
28724,Chainaz-les-Frasses,74054,74,48,179,80,198,114,392,227
28725,Challonges,74055,74,32,108,51,141,101,293,140
28726,Chamonix-Mont-Blanc,74056,74,1081,1989,819,3112,1913,5844,3070
28727,Champanges,74057,74,120,226,80,316,138,534,346
28728,La Chapelle-d'Abondance,74058,74,56,216,104,225,230,559,272
28729,La Chapelle-Rambaud,74059,74,21,66,4,71,42,117,87
28730,La Chapelle-Saint-Maurice,74060,74,20,20,24,56,12,92,40
28731,Chapeiry,74061,74,65,175,50,365,120,535,240
28732,Charvonnex,74062,74,155,365,119,300,275,694,520
28733,Châtel,74063,74,122,255,159,375,217,751,377
28734,Châtillon-sur-Cluses,74064,74,142,323,100,484,233,817,465
28735,Chaumont,74065,74,35,109,24,168,72,264,144
28736,Chavannaz,74066,74,12,55,16,61,37,114,67
28737,Chavanod,74067,74,221,555,232,931,371,1534,776
28738,Chêne-en-Semine,74068,74,28,120,48,116,96,260,148
28739,Chênex,74069,74,43,226,57,151,230,438,269
28740,Chens-sur-Léman,74070,74,161,705,258,697,538,1493,866
28741,Chessenaz,74071,74,12,54,4,66,59,129,66
28742,Chevaline,74072,74,20,40,10,45,25,80,60
28743,Chevenoz,74073,74,45,161,40,222,118,380,206
28744,Chevrier,74074,74,20,135,52,120,105,277,155
28745,Chilly,74075,74,79,358,64,354,307,725,437
28746,Choisy,74076,74,136,358,153,562,274,989,494
28747,Clarafond-Arcine,74077,74,85,252,86,317,179,582,337
28748,Clermont,74078,74,34,91,53,104,69,226,125
28749,Les Clefs,74079,74,32,180,72,188,124,384,212
28750,La Clusaz,74080,74,260,362,208,598,323,1129,622
28751,Cluses,74081,74,1952,4352,2124,5270,3444,10838,6304
28752,Collonges-sous-Salève,74082,74,336,864,452,1060,1004,2516,1200
28753,Combloux,74083,74,114,555,162,740,390,1292,669
28754,Les Contamines-Montjoie,74085,74,129,280,118,455,200,773,409
28755,Contamine-Sarzin,74086,74,21,224,12,137,256,405,245
28756,Contamine-sur-Arve,74087,74,131,491,157,495,438,1090,622
28757,Copponex,74088,74,45,290,155,295,240,690,335
28758,Cordon,74089,74,124,215,135,310,180,625,339
28759,Cornier,74090,74,93,331,137,379,285,801,424
28760,La Côte-d'Arbroz,74091,74,40,60,49,79,90,218,100
28761,Cran-Gevrier,74093,74,1754,4093,2221,4760,3655,10636,5847
28762,Cranves-Sales,74094,74,500,1654,657,2102,1380,4139,2154
28763,Crempigny-Bonneguête,74095,74,4,92,16,63,87,166,96
28764,Cruseilles,74096,74,278,1040,581,1160,1093,2834,1318
28765,Cusy,74097,74,140,513,137,656,328,1121,653
28766,Cuvat,74098,74,48,331,102,390,220,712,379
28767,Demi-Quartier,74099,74,135,165,120,340,145,605,300
28768,Desingy,74100,74,90,245,30,220,230,480,335
28769,Dingy-en-Vuache,74101,74,32,180,28,212,196,436,212
28770,Dingy-Saint-Clair,74102,74,85,385,97,514,243,854,470
28771,Domancy,74103,74,200,480,148,740,384,1272,680
28772,Doussard,74104,74,432,915,299,1156,758,2213,1347
28773,Douvaine,74105,74,472,1515,586,1386,1452,3424,1987
28774,Draillant,74106,74,61,211,52,238,136,426,272
28775,Droisy,74107,74,0,56,12,28,52,92,56
28776,Duingt,74108,74,101,208,87,317,144,548,309
28777,Éloise,74109,74,105,185,70,365,120,555,290
28778,Entremont,74110,74,54,170,60,198,165,423,224
28779,Entrevernes,74111,74,12,60,36,80,24,140,72
28780,Epagny Metz-Tessy,74112,74,372,1952,883,2220,1658,4761,2324
28781,Essert-Romand,74114,74,65,127,20,173,114,307,192
28782,Etaux,74116,74,100,573,124,604,452,1180,673
28783,Étercy,74117,74,29,182,57,329,123,509,211
28784,Étrembières,74118,74,200,558,369,514,545,1428,758
28785,Évian-les-Bains,74119,74,905,1809,1157,2618,1878,5653,2714
28786,Évires,74120,74,125,398,119,415,348,882,523
28787,Excenevex,74121,74,90,285,60,380,265,705,375
28788,Faucigny,74122,74,30,145,21,216,109,346,175
28789,Faverges-Seythenex,74123,74,1016,1849,617,2580,1424,4621,2865
28790,Feigères,74124,74,132,407,152,449,343,944,539
28791,Fessy,74126,74,58,244,71,230,187,488,302
28792,Féternes,74127,74,104,364,140,492,268,900,468
28793,Fillinges,74128,74,367,802,225,1165,614,2004,1169
28794,La Forclaz,74129,74,39,43,18,56,39,113,82
28795,Franclens,74130,74,10,150,35,189,110,334,160
28796,Frangy,74131,74,150,555,285,575,435,1295,705
28797,Gaillard,74133,74,978,2326,1880,3353,2870,8103,3304
28798,Les Gets,74134,74,194,210,160,418,259,837,404
28799,Giez,74135,74,75,135,70,190,100,360,210
28800,Le Grand-Bornand,74136,74,275,540,175,737,417,1329,815
28801,Groisy,74137,74,211,790,399,1059,817,2275,1001
28802,Gruffy,74138,74,175,435,175,420,310,905,610
28803,Habère-Lullin,74139,74,76,325,28,256,240,524,401
28804,Habère-Poche,74140,74,120,346,152,374,321,847,466
28805,Hauteville-sur-Fier,74141,74,45,260,60,400,120,580,305
28806,Héry-sur-Alby,74142,74,70,245,60,289,195,544,315
28807,Les Houches,74143,74,215,770,220,1015,610,1845,985
28808,Jonzier-Épagny,74144,74,24,228,48,272,160,480,252
28809,Juvigny,74145,74,76,160,32,232,124,388,236
28810,Larringes,74146,74,68,419,113,305,363,781,487
28811,Lathuile,74147,74,112,244,68,344,220,632,356
28812,Leschaux,74148,74,24,84,8,116,48,172,108
28813,Loisin,74150,74,116,367,96,534,326,956,483
28814,Lornay,74151,74,35,180,38,78,164,280,215
28815,Lovagny,74152,74,115,325,89,412,255,756,440
28816,Lucinges,74153,74,112,420,160,616,360,1136,532
28817,Lugrin,74154,74,218,662,244,750,526,1520,880
28818,Lullin,74155,74,70,235,95,215,190,500,305
28819,Lully,74156,74,94,166,65,228,134,427,260
28820,Lyaud,74157,74,107,501,80,509,403,992,608
28821,Machilly,74158,74,76,244,88,354,178,620,320
28822,Magland,74159,74,280,894,368,940,718,2026,1174
28823,Manigod,74160,74,95,265,80,350,220,650,360
28824,Marcellaz-Albanais,74161,74,127,489,105,640,400,1145,616
28825,Marcellaz,74162,74,60,265,84,276,248,608,325
28826,Margencel,74163,74,170,541,215,598,481,1294,711
28827,Marignier,74164,74,590,1570,780,2105,1178,4063,2160
28828,Marigny-Saint-Marcel,74165,74,43,189,47,239,117,403,232
28829,Marin,74166,74,168,456,156,520,391,1067,624
28830,Val de Chaise,74167,74,136,298,107,501,251,859,434
28831,Marlioz,74168,74,28,251,97,231,213,541,279
28832,Marnaz,74169,74,420,1425,547,1447,1154,3148,1845
28833,Massingy,74170,74,77,257,51,211,168,430,334
28834,Massongy,74171,74,116,434,132,523,367,1022,550
28835,Maxilly-sur-Léman,74172,74,126,306,145,454,223,822,432
28836,Megève,74173,74,541,571,247,1247,550,2044,1112
28837,Mégevette,74174,74,16,204,20,156,192,368,220
28838,Meillerie,74175,74,12,88,80,96,68,244,100
28839,Menthon-Saint-Bernard,74176,74,262,433,76,634,378,1088,695
28840,Menthonnex-en-Bornes,74177,74,76,357,64,271,270,605,433
28841,Menthonnex-sous-Clermont,74178,74,24,196,20,232,176,428,220
28842,Mésigny,74179,74,48,171,34,225,142,401,219
28843,Messery,74180,74,243,612,132,717,484,1333,855
28844,Meythet,74182,74,909,1876,1134,2423,1794,5351,2785
28845,Mieussy,74183,74,212,586,194,785,458,1437,798
28846,Minzier,74184,74,28,284,60,230,283,573,312
28847,Monnetier-Mornex,74185,74,265,555,165,675,480,1320,820
28848,Montagny-les-Lanches,74186,74,56,220,52,199,150,401,276
28849,Montriond,74188,74,70,194,87,310,131,528,264
28850,Mont-Saxonnex,74189,74,77,391,178,479,415,1072,468
28851,Morillon,74190,74,65,123,54,214,129,397,188
28852,Morzine,74191,74,313,679,266,958,633,1857,992
28853,Moye,74192,74,55,280,70,365,260,695,335
28854,La Muraz,74193,74,60,320,130,320,255,705,380
28855,Mûres,74194,74,42,160,37,271,106,414,202
28856,Musièges,74195,74,42,116,13,62,100,175,158
28857,Nancy-sur-Cluses,74196,74,20,123,27,95,100,222,143
28858,Nangy,74197,74,112,399,294,414,418,1126,511
28859,Nâves-Parmelan,74198,74,75,271,47,347,163,557,346
28860,Nernier,74199,74,53,103,10,155,81,246,156
28861,Neuvecelle,74200,74,325,738,285,952,581,1818,1063
28862,Neydens,74201,74,66,393,260,586,354,1200,459
28863,Nonglard,74202,74,4,132,95,164,135,394,136
28864,Novel,74203,74,5,5,0,25,15,40,10
28865,Les Ollières,74204,74,72,200,84,332,152,568,272
28866,Onnion,74205,74,60,376,148,328,320,796,436
28867,Orcier,74206,74,52,253,68,322,182,572,305
28868,Passy,74208,74,1281,2451,934,3605,1938,6477,3732
28869,Peillonnex,74209,74,64,395,123,443,326,892,459
28870,Perrignier,74210,74,202,443,126,608,324,1058,645
28871,Pers-Jussy,74211,74,214,800,205,972,630,1807,1014
28872,Le Petit-Bornand-les-Glières,74212,74,63,282,103,316,264,683,345
28873,Poisy,74213,74,622,1798,889,2218,1571,4678,2420
28874,Praz-sur-Arly,74215,74,94,298,136,421,258,815,392
28875,Présilly,74216,74,68,204,60,232,180,472,272
28876,Pringy,74217,74,341,1017,410,1211,1027,2648,1358
28877,Publier,74218,74,693,1695,697,2166,1424,4287,2388
28878,Quintal,74219,74,82,297,61,430,183,674,379
28879,Reignier-Ésery,74220,74,632,1801,751,2222,1681,4654,2433
28880,Le Reposoir,74221,74,19,143,60,108,111,279,162
28881,Reyvroz,74222,74,67,102,49,156,70,275,169
28882,La Rivière-Enverse,74223,74,39,97,33,153,82,268,136
28883,La Roche-sur-Foron,74224,74,823,3157,1259,2794,2848,6901,3980
28884,Rumilly,74225,74,1536,3856,2015,4021,3008,9044,5392
28885,Saint-André-de-Boëge,74226,74,50,146,45,206,110,361,196
28886,Saint-Blaise,74228,74,25,110,25,110,80,215,135
28887,Saint-Cergues,74229,74,323,891,366,1032,819,2217,1214
28888,Saint-Eusèbe,74231,74,20,115,55,215,95,365,135
28889,Saint-Eustache,74232,74,47,104,56,147,87,290,151
28890,Saint-Félix,74233,74,160,735,270,695,530,1495,895
28891,Saint-Ferréol,74234,74,85,184,60,256,147,463,269
28892,Saint-Germain-sur-Rhône,74235,74,34,116,49,156,93,298,150
28893,Saint-Gervais-les-Bains,74236,74,649,1201,611,1845,1047,3503,1850
28894,Saint-Gingolph,74237,74,40,180,120,246,238,604,220
28895,Saint-Jean-d'Aulps,74238,74,168,278,108,339,257,704,446
28896,Saint-Jean-de-Sixt,74239,74,133,288,98,519,319,936,421
28897,Saint-Jean-de-Tholome,74240,74,85,283,43,236,236,515,368
28898,Saint-Jeoire,74241,74,241,879,337,891,776,2004,1120
28899,Saint-Jorioz,74242,74,883,1197,435,2075,894,3404,2080
28900,Saint-Julien-en-Genevois,74243,74,1016,3203,1984,3774,3016,8774,4219
28901,Saint-Laurent,74244,74,42,245,25,239,195,459,287
28902,Saint-Martin-Bellevue,74245,74,176,700,172,899,617,1688,876
28903,Saint-Paul-en-Chablais,74249,74,236,585,158,773,459,1390,821
28904,Saint-Pierre-en-Faucigny,74250,74,584,1688,549,1768,1381,3698,2272
28905,Saint-Sigismond,74252,74,55,150,40,270,70,380,205
28906,Saint-Sixt,74253,74,46,297,68,283,234,585,343
28907,Saint-Sylvestre,74254,74,25,160,26,244,91,361,185
28908,Sales,74255,74,201,474,129,584,399,1112,675
28909,Sallanches,74256,74,1856,3641,1744,5044,3171,9959,5497
28910,Sallenôves,74257,74,33,172,87,150,139,376,205
28911,Samoëns,74258,74,407,522,166,780,405,1351,929
28912,Le Sappey,74259,74,45,94,44,110,52,206,139
28913,Savigny,74260,74,20,210,124,238,200,562,230
28914,Saxel,74261,74,12,140,28,116,132,276,152
28915,Scientrier,74262,74,88,297,133,338,244,715,385
28916,Sciez,74263,74,585,1397,505,1854,1235,3594,1982
28917,Scionzier,74264,74,526,2490,1050,2044,1964,5058,3016
28918,Serraval,74265,74,28,192,52,180,188,420,220
28919,Servoz,74266,74,96,235,56,324,226,606,331
28920,Sévrier,74267,74,679,1054,379,1262,793,2434,1733
28921,Seynod,74268,74,1773,5520,2247,6530,4350,13127,7293
28922,Seyssel,74269,74,232,584,252,684,456,1392,816
28923,Seytroux,74271,74,60,114,48,105,125,278,174
28924,Sillingy,74272,74,305,1395,548,1361,1242,3151,1700
28925,Sixt-Fer-à-Cheval,74273,74,95,205,60,214,200,474,300
28926,Val-de-Fier,74274,74,55,220,45,145,209,399,275
28927,Talloires-Montmin,74275,74,292,440,205,716,429,1350,732
28928,Taninges,74276,74,390,845,350,1035,690,2075,1235
28929,Thyez,74278,74,590,1332,668,1906,1323,3897,1922
28930,Thollon-les-Mémises,74279,74,65,195,50,240,180,470,260
28931,Thônes,74280,74,714,1487,728,2001,1217,3946,2201
28932,Thonon-les-Bains,74281,74,4605,7818,4740,9877,6889,21506,12423
28933,Thorens-Glières,74282,74,290,775,360,1030,565,1955,1065
28934,Thusy,74283,74,64,285,75,345,270,690,349
28935,La Tour,74284,74,25,290,90,342,245,677,315
28936,Usinens,74285,74,30,100,35,175,55,265,130
28937,Vacheresse,74286,74,98,176,84,255,124,463,274
28938,Vailly,74287,74,60,254,85,239,189,513,314
28939,Valleiry,74288,74,273,1085,490,979,1104,2573,1358
28940,Vallières,74289,74,197,473,184,470,353,1007,670
28941,Vallorcine,74290,74,57,76,23,113,76,212,133
28942,Vanzy,74291,74,71,59,16,76,60,152,130
28943,Vaulx,74292,74,67,252,88,278,197,563,319
28944,Veigy-Foncenex,74293,74,274,836,290,1216,726,2232,1110
28945,Verchaix,74294,74,70,177,52,250,136,438,247
28946,La Vernaz,74295,74,21,117,37,54,69,160,138
28947,Vers,74296,74,33,224,69,213,188,470,257
28948,Versonnex,74297,74,28,192,64,164,136,364,220
28949,Vétraz-Monthoux,74298,74,568,1915,1122,2421,1832,5375,2483
28950,Veyrier-du-Lac,74299,74,362,502,160,768,436,1364,864
28951,Villard,74301,74,109,190,73,155,145,373,299
28952,Les Villards-sur-Thônes,74302,74,117,223,112,327,189,628,340
28953,Villaz,74303,74,214,990,345,913,766,2024,1204
28954,Ville-en-Sallaz,74304,74,36,240,112,236,201,549,276
28955,Ville-la-Grand,74305,74,755,2032,1120,2681,1826,5627,2787
28956,Villy-le-Bouveret,74306,74,25,220,70,160,160,390,245
28957,Villy-le-Pelloux,74307,74,74,275,119,214,230,563,349
28958,Vinzier,74308,74,63,207,55,290,104,449,270
28959,Viry,74309,74,268,1152,770,1244,1071,3085,1420
28960,Viuz-la-Chiésaz,74310,74,135,301,144,483,270,897,436
28961,Viuz-en-Sallaz,74311,74,361,1085,466,1242,931,2639,1446
28962,Vougy,74312,74,88,496,136,420,372,928,584
28963,Vovray-en-Bornes,74313,74,47,133,21,75,123,219,180
28964,Vulbens,74314,74,99,420,126,290,404,820,519
28965,Yvoire,74315,74,78,254,52,260,226,538,332
28966,Paris,75056,75,232993,423648,392269,624676,499693,1516638,656641
28967,Allouville-Bellefosse,76001,76,120,310,85,390,260,735,430
28968,Alvimare,76002,76,44,193,69,173,131,373,237
28969,Ambrumesnil,76004,76,38,131,45,142,101,288,169
28970,Amfreville-la-Mi-Voie,76005,76,311,773,524,886,644,2054,1084
28971,Amfreville-les-Champs,76006,76,15,50,15,40,45,100,65
28972,Anceaumeville,76007,76,70,175,20,280,120,420,245
28973,Ancourt,76008,76,70,165,75,285,105,465,235
28974,Ancourteville-sur-Héricourt,76009,76,21,107,45,55,76,176,128
28975,Ancretiéville-Saint-Victor,76010,76,20,124,32,88,116,236,144
28976,Ancretteville-sur-Mer,76011,76,20,55,35,40,45,120,75
28977,Angerville-Bailleul,76012,76,0,60,20,65,55,140,60
28978,Angerville-la-Martel,76013,76,64,269,76,287,223,586,333
28979,Angerville-l'Orcher,76014,76,189,370,105,485,290,880,559
28980,Angiens,76015,76,45,115,40,245,65,350,160
28981,Anglesqueville-la-Bras-Long,76016,76,0,30,15,55,15,85,30
28982,Anglesqueville-l'Esneval,76017,76,20,165,35,170,150,355,185
28983,Val-de-Saâne,76018,76,124,388,91,464,294,849,512
28984,Anneville-sur-Scie,76019,76,40,108,6,176,65,247,148
28985,Anneville-Ambourville,76020,76,112,316,94,384,228,706,428
28986,Annouville-Vilmesnil,76021,76,41,175,35,92,180,307,216
28987,Anquetierville,76022,76,16,112,32,120,84,236,128
28988,Anvéville,76023,76,12,76,28,108,60,196,88
28989,Ardouval,76024,76,30,50,0,55,30,85,80
28990,Argueil,76025,76,28,84,40,108,68,216,112
28991,Arques-la-Bataille,76026,76,343,613,286,804,471,1561,956
28992,Aubéguimont,76028,76,30,50,30,35,45,110,80
28993,Aubermesnil-aux-Érables,76029,76,30,45,30,85,25,140,75
28994,Aubermesnil-Beaumais,76030,76,30,105,30,213,75,318,135
28995,Auberville-la-Manuel,76032,76,24,37,8,24,24,56,61
28996,Auberville-la-Renault,76033,76,60,120,12,141,104,257,180
28997,Auffay,76034,76,285,340,190,730,325,1245,625
28998,Aumale,76035,76,416,400,292,706,281,1279,816
28999,Auppegard,76036,76,65,205,55,220,185,460,270
29000,Authieux-Ratiéville,76038,76,12,91,49,134,81,264,103
29001,Les Authieux-sur-le-Port-Saint-Ouen,76039,76,44,340,72,508,244,824,384
29002,Autigny,76040,76,16,84,16,60,72,148,100
29003,Autretot,76041,76,28,188,84,264,136,484,216
29004,Auvilliers,76042,76,10,16,11,42,15,68,26
29005,Auzebosc,76043,76,46,253,88,268,206,562,299
29006,Auzouville-Auberbosc,76044,76,15,80,45,100,70,215,95
29007,Auzouville-l'Esneval,76045,76,28,81,50,99,58,207,109
29008,Auzouville-sur-Ry,76046,76,49,193,57,234,136,427,242
29009,Auzouville-sur-Saâne,76047,76,28,28,4,72,24,100,56
29010,Avesnes-en-Bray,76048,76,26,72,13,101,53,167,98
29011,Avesnes-en-Val,76049,76,25,64,38,71,42,151,89
29012,Avremesnil,76050,76,75,255,105,360,230,695,330
29013,Bacqueville-en-Caux,76051,76,269,495,155,484,440,1079,764
29014,Bailleul-Neuville,76052,76,0,49,28,72,21,121,49
29015,Baillolet,76053,76,8,12,8,44,8,60,20
29016,Bailly-en-Rivière,76054,76,50,124,32,172,94,298,174
29017,Baons-le-Comte,76055,76,44,92,48,104,64,216,136
29018,Bardouville,76056,76,120,191,55,151,155,361,311
29019,Barentin,76057,76,1200,2938,1416,3810,2319,7545,4138
29020,Baromesnil,76058,76,44,45,20,75,45,140,89
29021,Bazinval,76059,76,28,100,24,140,88,252,128
29022,Beaubec-la-Rosière,76060,76,45,177,20,145,76,241,222
29023,Beaumont-le-Hareng,76062,76,35,70,10,100,35,145,105
29024,Beauval-en-Caux,76063,76,26,133,30,178,75,283,159
29025,Beaurepaire,76064,76,20,140,30,180,110,320,160
29026,Beaussault,76065,76,52,112,44,100,96,240,164
29027,Beautot,76066,76,0,40,8,44,28,80,40
29028,Beauvoir-en-Lyons,76067,76,60,180,76,176,148,400,240
29029,Bec-de-Mortagne,76068,76,56,172,56,224,156,436,228
29030,Belbeuf,76069,76,271,405,185,824,264,1273,676
29031,Bellencombre,76070,76,90,180,60,210,145,415,270
29032,Bellengreville,76071,76,37,93,26,159,100,285,130
29033,Belleville-en-Caux,76072,76,30,231,46,147,175,368,261
29034,La Bellière,76074,76,0,17,8,16,8,32,17
29035,Belmesnil,76075,76,26,107,36,145,86,267,133
29036,Bénarville,76076,76,8,80,8,48,96,152,88
29037,Bénesville,76077,76,8,55,8,57,39,104,63
29038,Bennetot,76078,76,15,50,6,40,38,84,65
29039,Bénouville,76079,76,12,44,8,51,36,95,56
29040,Bermonville,76080,76,24,158,34,101,122,257,182
29041,Bernières,76082,76,16,189,56,239,123,418,205
29042,Bertheauville,76083,76,0,36,20,32,20,72,36
29043,Bertreville,76084,76,20,21,4,32,16,52,41
29044,Bertreville-Saint-Ouen,76085,76,32,116,4,96,104,204,148
29045,Bertrimont,76086,76,30,55,15,70,40,125,85
29046,Berville,76087,76,40,185,35,200,145,380,225
29047,Berville-sur-Seine,76088,76,40,167,30,198,130,358,207
29048,Beuzeville-la-Grenier,76090,76,84,281,124,372,244,740,365
29049,Beuzeville-la-Guérard,76091,76,26,57,20,52,45,117,83
29050,Beuzevillette,76092,76,48,165,60,208,139,407,213
29051,Bézancourt,76093,76,34,43,30,135,38,203,77
29052,Bierville,76094,76,28,76,20,100,64,184,104
29053,Bihorel,76095,76,1575,1895,755,2745,1200,4700,3470
29054,Biville-la-Baignarde,76096,76,97,150,62,158,132,352,247
29055,Biville-la-Rivière,76097,76,12,18,12,28,17,57,30
29056,Blacqueville,76099,76,45,200,57,196,136,389,245
29057,Blainville-Crevon,76100,76,108,316,116,412,248,776,424
29058,Blangy-sur-Bresle,76101,76,481,610,227,991,416,1634,1091
29059,Bonsecours,76103,76,1190,1350,610,2100,1105,3815,2540
29060,Blosseville,76104,76,45,52,25,85,35,145,97
29061,Le Bocasse,76105,76,25,172,55,267,121,443,197
29062,Bois-d'Ennebourg,76106,76,55,135,15,190,135,340,190
29063,Bois-Guilbert,76107,76,15,90,50,85,75,210,105
29064,Bois-Guillaume,76108,76,2174,2864,954,4306,2047,7307,5038
29065,Bois-Héroult,76109,76,12,71,0,32,51,83,83
29066,Bois-Himont,76110,76,36,100,48,108,76,232,136
29067,Bois-l'Évêque,76111,76,85,153,50,85,128,263,238
29068,Le Bois-Robert,76112,76,52,77,8,98,61,167,129
29069,Boissay,76113,76,20,120,35,100,115,250,140
29070,Bolbec,76114,76,1311,2984,1552,3241,2106,6899,4295
29071,Bolleville,76115,76,36,184,52,176,144,372,220
29072,Boos,76116,76,240,975,363,1225,592,2180,1215
29073,Bordeaux-Saint-Clair,76117,76,51,159,58,234,110,402,210
29074,Bornambusc,76118,76,30,90,0,80,55,135,120
29075,Bosc-Bérenger,76119,76,6,61,6,31,55,92,67
29076,Bosc-Bordel,76120,76,34,112,26,154,82,262,146
29077,Bosc-Édeline,76121,76,20,100,45,110,80,235,120
29078,Callengeville,76122,76,48,128,56,184,96,336,176
29079,Bosc-Guérard-Saint-Adrien,76123,76,88,244,58,253,197,508,332
29080,Bosc-Hyons,76124,76,48,118,36,116,98,250,166
29081,Bosc-le-Hard,76125,76,275,345,125,405,280,810,620
29082,Bosc-Mesnil,76126,76,20,90,35,70,80,185,110
29083,Bosc-Roger-sur-Buchy,76127,76,60,175,90,260,150,500,235
29084,Bosville,76128,76,36,152,44,208,116,368,188
29085,Boudeville,76129,76,20,55,15,60,40,115,75
29086,Bouelles,76130,76,40,75,40,65,55,160,115
29087,La Bouille,76131,76,75,175,95,235,175,505,250
29088,Bourdainville,76132,76,45,120,35,130,125,290,165
29089,Le Bourg-Dun,76133,76,88,76,35,99,64,198,164
29090,Bourville,76134,76,45,90,20,90,65,175,135
29091,Bouville,76135,76,98,194,139,313,166,618,292
29092,Brachy,76136,76,71,182,52,271,144,467,253
29093,Bracquetuit,76138,76,30,95,15,115,65,195,125
29094,Bradiancourt,76139,76,35,85,15,55,45,115,120
29095,Brametot,76140,76,21,50,26,41,41,108,71
29096,Bréauté,76141,76,158,333,134,418,273,825,491
29097,Brémontier-Merval,76142,76,20,136,28,144,120,292,156
29098,Bretteville-du-Grand-Caux,76143,76,110,365,164,444,270,878,475
29099,Bretteville-Saint-Laurent,76144,76,15,35,10,70,20,100,50
29100,Buchy,76146,76,349,244,120,394,209,723,593
29101,Bully,76147,76,87,202,94,323,131,548,289
29102,Bures-en-Bray,76148,76,27,92,30,59,75,164,119
29103,Butot,76149,76,45,65,10,75,70,155,110
29104,Cailleville,76151,76,15,80,10,90,80,180,95
29105,Cailly,76152,76,64,189,107,213,137,457,253
29106,Calleville-les-Deux-Églises,76153,76,10,85,15,140,75,230,95
29107,Campneuseville,76154,76,59,106,31,162,60,253,165
29108,Canehan,76155,76,56,98,32,88,64,184,154
29109,Canouville,76156,76,27,80,24,78,61,163,107
29110,Canteleu,76157,76,1579,4197,1931,4267,2803,9001,5776
29111,Canville-les-Deux-Églises,76158,76,20,125,20,95,80,195,145
29112,Cany-Barville,76159,76,438,713,298,979,525,1802,1151
29113,Carville-la-Folletière,76160,76,4,144,68,124,88,280,148
29114,Carville-Pot-de-Fer,76161,76,4,40,4,52,24,80,44
29115,Le Catelier,76162,76,44,60,0,76,44,120,104
29116,Catenay,76163,76,45,190,35,240,165,440,235
29117,Rives-en-Seine,76164,76,545,899,481,1333,648,2462,1444
29118,Caudebec-lès-Elbeuf,76165,76,1061,2539,1417,3017,1782,6216,3600
29119,Le Caule-Sainte-Beuve,76166,76,90,115,45,135,100,280,205
29120,Cauville-sur-Mer,76167,76,50,400,105,560,303,968,450
29121,Les Cent-Acres,76168,76,0,12,8,24,8,40,12
29122,La Cerlangue,76169,76,139,400,95,405,260,760,539
29123,La Chapelle-du-Bourgay,76170,76,15,35,5,25,45,75,50
29124,La Chapelle-Saint-Ouen,76171,76,12,44,0,0,53,53,56
29125,La Chapelle-sur-Dun,76172,76,5,41,5,111,15,131,46
29126,La Chaussée,76173,76,24,198,49,117,160,326,222
29127,Cideville,76174,76,16,76,24,116,56,196,92
29128,Clais,76175,76,30,90,35,60,60,155,120
29129,Clasville,76176,76,44,88,28,72,68,168,132
29130,Claville-Motteville,76177,76,35,60,20,95,60,175,95
29131,Cléon,76178,76,391,1475,575,1552,896,3023,1866
29132,Clères,76179,76,122,296,88,511,276,875,418
29133,Cleuville,76180,76,12,84,12,36,60,108,96
29134,Cléville,76181,76,25,35,10,60,30,100,60
29135,Cliponville,76182,76,30,95,15,95,40,150,125
29136,Colleville,76183,76,85,210,80,307,105,492,295
29137,Colmesnil-Manneville,76184,76,5,5,20,55,15,90,10
29138,Compainville,76185,76,30,35,15,40,35,90,65
29139,Conteville,76186,76,45,130,25,165,125,315,175
29140,Contremoulins,76187,76,15,25,10,110,20,140,40
29141,Cottévrard,76188,76,20,120,55,170,95,320,140
29142,Crasville-la-Mallet,76189,76,35,35,0,40,25,65,70
29143,Crasville-la-Rocquefort,76190,76,16,60,24,116,12,152,76
29144,Cressy,76191,76,30,80,25,80,70,175,110
29145,Criel-sur-Mer,76192,76,332,615,179,1091,489,1759,947
29146,La Crique,76193,76,36,108,16,112,88,216,144
29147,Criquebeuf-en-Caux,76194,76,16,64,40,200,28,268,80
29148,Criquetot-le-Mauconduit,76195,76,10,55,25,80,10,115,65
29149,Criquetot-l'Esneval,76196,76,223,633,276,740,406,1422,856
29150,Criquetot-sur-Longueville,76197,76,12,66,4,43,69,116,78
29151,Criquetot-sur-Ouville,76198,76,68,265,48,224,188,460,333
29152,Criquiers,76199,76,65,155,45,235,125,405,220
29153,Critot,76200,76,15,121,55,201,81,337,136
29154,Croisy-sur-Andelle,76201,76,55,155,70,155,130,355,210
29155,Croixdalle,76202,76,16,63,16,85,48,149,79
29156,Croix-Mare,76203,76,64,228,67,169,172,408,292
29157,Cropus,76204,76,28,44,16,88,64,168,72
29158,Crosville-sur-Scie,76205,76,37,59,9,62,50,121,96
29159,Cuverville,76206,76,15,100,35,140,50,225,115
29160,Cuverville-sur-Yères,76207,76,40,35,20,75,25,120,75
29161,Cuy-Saint-Fiacre,76208,76,48,159,63,215,117,395,207
29162,Dampierre-en-Bray,76209,76,32,128,48,168,92,308,160
29163,Dampierre-Saint-Nicolas,76210,76,56,116,40,188,128,356,172
29164,Dancourt,76211,76,60,30,20,85,25,130,90
29165,Darnétal,76212,76,1045,2352,1353,2508,1832,5693,3397
29166,Daubeuf-Serville,76213,76,48,96,24,124,72,220,144
29167,Dénestanville,76214,76,29,54,34,67,44,145,83
29168,Déville-lès-Rouen,76216,76,1127,2301,1875,2950,1905,6730,3428
29169,Dieppe,76217,76,4833,6437,3307,10024,4560,17891,11270
29170,Doudeauville,76218,76,10,15,15,10,30,55,25
29171,Doudeville,76219,76,390,573,285,835,381,1501,963
29172,Douvrend,76220,76,44,148,48,140,116,304,192
29173,Drosay,76221,76,38,40,12,48,31,91,78
29174,Duclair,76222,76,438,923,365,1469,724,2558,1361
29175,Écalles-Alix,76223,76,36,132,52,200,76,328,168
29176,Écrainville,76224,76,95,305,60,369,225,654,400
29177,Écretteville-lès-Baons,76225,76,40,75,40,160,70,270,115
29178,Écretteville-sur-Mer,76226,76,12,52,12,56,32,100,64
29179,Ectot-l'Auber,76227,76,12,232,44,159,178,381,244
29180,Ectot-lès-Baons,76228,76,18,125,20,138,55,213,143
29181,Elbeuf-en-Bray,76229,76,32,112,28,140,96,264,144
29182,Elbeuf-sur-Andelle,76230,76,20,161,8,184,86,278,181
29183,Elbeuf,76231,76,1588,4622,2682,4287,3104,10073,6210
29184,Életot,76232,76,69,177,38,197,102,337,246
29185,Ellecourt,76233,76,20,24,16,50,16,82,44
29186,Émanville,76234,76,35,210,55,220,165,440,245
29187,Envermeu,76235,76,235,565,215,670,330,1215,800
29188,Envronville,76236,76,28,84,24,120,76,220,112
29189,Épinay-sur-Duclair,76237,76,35,155,30,173,140,343,190
29190,Épouville,76238,76,355,626,250,1051,410,1711,981
29191,Épretot,76239,76,29,229,40,184,173,397,258
29192,Épreville,76240,76,96,300,88,348,220,656,396
29193,Ermenouville,76241,76,15,30,13,28,20,61,45
29194,Ernemont-la-Villette,76242,76,20,35,5,65,45,115,55
29195,Ernemont-sur-Buchy,76243,76,8,83,25,63,69,157,91
29196,Esclavelles,76244,76,60,100,12,100,100,212,160
29197,Eslettes,76245,76,116,408,85,573,301,959,524
29198,Esteville,76247,76,28,136,36,160,132,328,164
29199,Estouteville-Écalles,76248,76,50,158,58,130,90,278,208
29200,Étaimpuis,76249,76,68,208,64,230,163,457,276
29201,Étainhus,76250,76,49,303,93,396,190,679,352
29202,Étalleville,76251,76,20,145,25,160,110,295,165
29203,Étalondes,76252,76,175,241,95,420,155,670,416
29204,Étoutteville,76253,76,52,239,112,156,224,492,291
29205,Étretat,76254,76,243,266,109,436,209,754,509
29206,Eu,76255,76,1157,1384,680,2586,1064,4330,2541
29207,Fallencourt,76257,76,36,52,20,36,44,100,88
29208,Fauville-en-Caux,76258,76,411,481,209,616,349,1174,892
29209,Fécamp,76259,76,2834,4388,2177,6319,2991,11487,7222
29210,Ferrières-en-Bray,76260,76,250,380,175,629,265,1069,630
29211,La Ferté-Saint-Samson,76261,76,44,144,16,164,88,268,188
29212,Fesques,76262,76,20,35,0,50,30,80,55
29213,La Feuillie,76263,76,180,322,72,414,255,741,502
29214,Flamanville,76264,76,28,140,39,128,116,283,168
29215,Flamets-Frétils,76265,76,0,55,15,60,45,120,55
29216,Flocques,76266,76,78,162,37,221,150,408,240
29217,Fongueusemare,76268,76,5,70,40,55,35,130,75
29218,Fontaine-en-Bray,76269,76,20,60,0,60,40,100,80
29219,Fontaine-la-Mallet,76270,76,475,605,135,1130,325,1590,1080
29220,Fontaine-le-Bourg,76271,76,160,450,160,512,378,1050,610
29221,Fontaine-le-Dun,76272,76,48,173,114,356,132,602,221
29222,Fontaine-sous-Préaux,76273,76,38,101,27,223,66,316,139
29223,La Fontelaye,76274,76,0,5,0,20,5,25,5
29224,Fontenay,76275,76,115,270,70,415,174,659,385
29225,Forges-les-Eaux,76276,76,849,732,274,1283,518,2075,1581
29226,Foucarmont,76278,76,139,150,86,282,113,481,289
29227,Foucart,76279,76,8,92,52,92,80,224,100
29228,Fréauville,76280,76,21,13,26,24,16,66,34
29229,La Frénaye,76281,76,264,620,170,620,415,1205,884
29230,Freneuse,76282,76,84,191,57,392,121,570,275
29231,Fresles,76283,76,8,80,8,80,72,160,88
29232,Fresnay-le-Long,76284,76,20,100,25,95,80,200,120
29233,Fresne-le-Plan,76285,76,40,209,59,163,165,387,249
29234,Fresnoy-Folny,76286,76,80,225,50,195,165,410,305
29235,Fresquiennes,76287,76,110,224,86,397,178,661,334
29236,Freulleville,76288,76,32,108,68,100,80,248,140
29237,Saint Martin de l'If,76289,76,115,481,155,532,363,1050,596
29238,Frichemesnil,76290,76,65,135,5,130,100,235,200
29239,Froberville,76291,76,79,351,83,410,213,706,430
29240,Fry,76292,76,20,52,12,44,40,96,72
29241,Fultot,76293,76,8,52,24,64,52,140,60
29242,La Gaillarde,76294,76,56,100,24,148,64,236,156
29243,Gaillefontaine,76295,76,190,270,135,415,180,730,460
29244,Gainneville,76296,76,191,727,229,847,497,1573,918
29245,Gancourt-Saint-Étienne,76297,76,20,35,15,85,45,145,55
29246,Ganzeville,76298,76,56,96,48,201,88,337,152
29247,Gerponville,76299,76,10,130,25,155,95,275,140
29248,Gerville,76300,76,12,108,24,136,104,264,120
29249,Goderville,76302,76,491,664,299,796,518,1613,1155
29250,Gommerville,76303,76,33,167,63,253,140,456,200
29251,Gonfreville-Caillot,76304,76,32,67,15,114,68,197,99
29252,Gonfreville-l'Orcher,76305,76,912,2579,1026,2660,1752,5438,3491
29253,Gonnetot,76306,76,10,70,5,40,60,105,80
29254,Gonneville-la-Mallet,76307,76,225,294,131,366,213,710,519
29255,Gonneville-sur-Scie,76308,76,37,131,16,124,89,229,168
29256,Gonzeville,76309,76,19,10,3,33,9,45,29
29257,Goupillières,76311,76,26,108,13,163,68,244,134
29258,Gournay-en-Bray,76312,76,1061,1417,767,1663,1152,3582,2478
29259,Gouy,76313,76,64,217,77,286,116,479,281
29260,Graimbouville,76314,76,32,208,64,156,164,384,240
29261,Grainville-la-Teinturière,76315,76,59,266,93,302,159,554,325
29262,Grainville-sur-Ry,76316,76,39,93,36,191,63,290,132
29263,Grainville-Ymauville,76317,76,24,110,30,160,118,308,134
29264,Grand-Camp,76318,76,10,170,50,310,105,465,180
29265,Grand-Couronne,76319,76,1016,2816,1065,2949,1850,5864,3832
29266,Grandcourt,76320,76,50,70,30,130,55,215,120
29267,Les Grandes-Ventes,76321,76,238,433,130,582,297,1009,671
29268,Le Grand-Quevilly,76322,76,4254,5314,2973,8254,4142,15369,9568
29269,Graval,76323,76,0,46,0,45,50,95,46
29270,Grèges,76324,76,55,185,105,345,105,555,240
29271,Grémonville,76325,76,24,96,52,136,92,280,120
29272,Greuville,76327,76,35,105,15,140,75,230,140
29273,Grigneuseville,76328,76,16,116,44,108,64,216,132
29274,Gruchet-le-Valasse,76329,76,370,833,311,911,564,1786,1203
29275,Gruchet-Saint-Siméon,76330,76,50,185,65,300,100,465,235
29276,Grugny,76331,76,42,100,89,178,48,315,142
29277,Grumesnil,76332,76,40,135,60,145,75,280,175
29278,Guerville,76333,76,75,120,20,135,115,270,195
29279,Gueures,76334,76,36,148,68,192,108,368,184
29280,Gueutteville,76335,76,0,28,0,32,24,56,28
29281,Gueutteville-les-Grès,76336,76,61,97,29,82,72,183,158
29282,La Hallotière,76338,76,10,90,10,50,70,130,100
29283,Le Hanouard,76339,76,38,76,17,74,20,111,114
29284,Harcanville,76340,76,60,120,40,176,88,304,180
29285,Harfleur,76341,76,890,2125,995,2510,1550,5055,3015
29286,Hattenville,76342,76,36,232,96,156,176,428,268
29287,Haucourt,76343,76,12,57,14,87,47,148,69
29288,Haudricourt,76344,76,97,92,30,142,51,223,189
29289,Haussez,76345,76,52,72,16,104,36,156,124
29290,Hautot-l'Auvray,76346,76,36,104,52,116,52,220,140
29291,Hautot-le-Vatois,76347,76,24,64,36,125,52,213,88
29292,Hautot-Saint-Sulpice,76348,76,16,151,101,206,139,446,167
29293,Hautot-sur-Mer,76349,76,297,442,131,755,285,1171,739
29294,Hautot-sur-Seine,76350,76,40,110,35,148,90,273,150
29295,Le Havre,76351,76,21056,42634,24296,50184,30737,105217,63690
29296,La Haye,76352,76,16,98,50,124,47,221,114
29297,Héberville,76353,76,4,33,12,38,16,66,37
29298,Hénouville,76354,76,108,291,61,510,212,783,399
29299,Héricourt-en-Caux,76355,76,100,196,104,276,120,500,296
29300,Hermanville,76356,76,15,30,5,25,30,60,45
29301,Hermeville,76357,76,45,90,25,150,45,220,135
29302,Le Héron,76358,76,10,60,35,65,80,180,70
29303,Héronchelles,76359,76,15,45,14,50,30,94,60
29304,Heugleville-sur-Scie,76360,76,94,165,30,215,130,375,259
29305,Heuqueville,76361,76,45,230,39,177,175,391,275
29306,Heurteauville,76362,76,25,85,10,100,100,210,110
29307,Hodeng-au-Bosc,76363,76,40,145,60,135,125,320,185
29308,Hodeng-Hodenger,76364,76,20,72,12,88,68,168,92
29309,Houdetot,76365,76,20,32,16,76,12,104,52
29310,Le Houlme,76366,76,500,850,569,1342,647,2558,1350
29311,Houppeville,76367,76,213,697,148,1094,472,1714,910
29312,Houquetot,76368,76,30,115,25,90,95,210,145
29313,La Houssaye-Béranger,76369,76,72,144,40,164,96,300,216
29314,Hugleville-en-Caux,76370,76,40,156,32,88,124,244,196
29315,Les Ifs,76371,76,10,15,10,15,15,40,25
29316,Illois,76372,76,36,130,68,80,72,220,166
29317,Imbleville,76373,76,40,80,8,80,65,153,120
29318,Incheville,76374,76,155,265,135,495,210,840,420
29319,Ingouville,76375,76,16,30,12,134,25,171,46
29320,Isneauville,76377,76,299,681,138,966,486,1590,980
29321,Jumièges,76378,76,204,464,132,628,336,1096,668
29322,Lamberville,76379,76,44,48,4,40,44,88,92
29323,Lammerville,76380,76,15,85,30,135,95,260,100
29324,Landes-Vieilles-et-Neuves,76381,76,15,20,10,60,25,95,35
29325,Lanquetot,76382,76,56,294,97,353,249,699,350
29326,Lestanville,76383,76,5,30,0,25,25,50,35
29327,Lillebonne,76384,76,1088,2339,1250,2658,1630,5538,3427
29328,Limésy,76385,76,99,372,154,474,282,910,471
29329,Limpiville,76386,76,32,100,12,124,72,208,132
29330,Lindebeuf,76387,76,28,119,44,96,85,225,147
29331,Lintot,76388,76,40,95,35,180,80,295,135
29332,Lintot-les-Bois,76389,76,15,40,15,65,35,115,55
29333,Les Loges,76390,76,154,300,125,365,225,715,454
29334,La Londe,76391,76,252,571,167,843,444,1454,823
29335,Londinières,76392,76,242,308,145,370,191,706,550
29336,Longmesnil,76393,76,8,16,4,12,16,32,24
29337,Longroy,76394,76,78,160,45,210,135,390,238
29338,Longueil,76395,76,80,155,35,210,100,345,235
29339,Longuerue,76396,76,12,67,28,98,80,206,79
29340,Longueville-sur-Scie,76397,76,114,250,85,262,154,501,364
29341,Louvetot,76398,76,56,153,61,210,111,382,209
29342,Lucy,76399,76,8,37,13,51,40,104,45
29343,Luneray,76400,76,461,410,175,748,285,1208,871
29344,Arelaune-en-Seine,76401,76,354,662,161,833,493,1487,1016
29345,Malaunay,76402,76,664,1680,465,1885,1157,3507,2344
29346,Malleville-les-Grès,76403,76,4,25,4,78,25,107,29
29347,Manéglise,76404,76,85,400,85,390,305,780,485
29348,Manéhouville,76405,76,35,65,10,50,40,100,100
29349,Maniquerville,76406,76,24,119,25,82,99,206,143
29350,Manneville-ès-Plains,76407,76,29,55,15,143,35,193,84
29351,Manneville-la-Goupil,76408,76,94,340,60,307,245,612,434
29352,Mannevillette,76409,76,48,234,60,230,160,450,282
29353,Maromme,76410,76,1584,2680,1434,3232,1933,6599,4264
29354,Marques,76411,76,4,39,18,98,20,136,43
29355,Martainville-Épreville,76412,76,56,200,56,224,176,456,256
29356,Martigny,76413,76,60,105,60,155,70,285,165
29357,Martin-Église,76414,76,176,356,88,584,252,924,532
29358,Massy,76415,76,40,93,20,109,77,206,133
29359,Mathonville,76416,76,20,108,48,48,80,176,128
29360,Maucomble,76417,76,56,126,20,79,88,187,182
29361,Maulévrier-Sainte-Gertrude,76418,76,90,235,100,350,190,640,325
29362,Mauny,76419,76,10,60,10,60,35,105,70
29363,Mauquenchy,76420,76,24,92,24,116,68,208,116
29364,Mélamare,76421,76,59,225,80,304,175,559,284
29365,Melleville,76422,76,35,35,20,115,45,180,70
29366,Ménerval,76423,76,13,32,15,58,34,107,45
29367,Ménonval,76424,76,9,48,21,87,30,138,57
29368,Mentheville,76425,76,8,89,35,52,75,162,97
29369,Mésangueville,76426,76,10,30,20,90,20,130,40
29370,Mesnières-en-Bray,76427,76,108,276,76,248,212,536,384
29371,Le Mesnil-Durdent,76428,76,0,6,0,3,3,6,6
29372,Le Mesnil-Esnard,76429,76,1107,1884,827,2677,1301,4805,2991
29373,Mesnil-Follemprise,76430,76,20,45,10,40,30,80,65
29374,Le Mesnil-Lieubray,76431,76,0,29,9,15,18,42,29
29375,Mesnil-Mauger,76432,76,0,70,20,95,50,165,70
29376,Mesnil-Panneville,76433,76,56,184,96,172,152,420,240
29377,Mesnil-Raoul,76434,76,96,260,88,288,179,555,356
29378,Le Mesnil-Réaume,76435,76,40,253,40,188,210,438,293
29379,Le Mesnil-sous-Jumièges,76436,76,50,160,25,235,164,424,210
29380,Meulers,76437,76,50,139,80,212,91,383,189
29381,Millebosc,76438,76,38,61,15,60,56,131,99
29382,Mirville,76439,76,24,85,25,100,80,205,109
29383,Molagnies,76440,76,20,55,5,85,10,100,75
29384,Monchaux-Soreng,76441,76,57,159,38,206,127,371,216
29385,Monchy-sur-Eu,76442,76,65,170,30,235,110,375,235
29386,Mont-Cauvaire,76443,76,85,155,70,190,120,380,240
29387,Montérolier,76445,76,44,148,56,212,108,376,192
29388,Montigny,76446,76,159,225,64,394,199,657,384
29389,Montivilliers,76447,76,1730,4194,1695,5509,2743,9947,5924
29390,Montmain,76448,76,95,301,107,656,206,969,396
29391,Montreuil-en-Caux,76449,76,20,171,65,165,100,330,191
29392,Montroty,76450,76,4,95,4,93,49,146,99
29393,Mont-Saint-Aignan,76451,76,2558,4239,3338,5225,2611,11174,6797
29394,Montville,76452,76,618,1237,399,1627,913,2939,1855
29395,Morgny-la-Pommeraye,76453,76,63,263,71,361,184,616,326
29396,Mortemer,76454,76,9,13,3,37,9,49,22
29397,Morville-sur-Andelle,76455,76,25,100,20,54,89,163,125
29398,Motteville,76456,76,55,255,70,235,160,465,310
29399,Moulineaux,76457,76,100,256,128,228,216,572,356
29400,Muchedent,76458,76,5,40,0,45,40,85,45
29401,Nesle-Hodeng,76459,76,40,84,44,124,48,216,124
29402,Nesle-Normandeuse,76460,76,56,107,58,215,86,359,163
29403,Neufbosc,76461,76,15,125,45,130,90,265,140
29404,Neufchâtel-en-Bray,76462,76,1018,970,520,1280,645,2445,1988
29405,Neuf-Marché,76463,76,113,183,37,181,114,332,296
29406,La Neuville-Chant-d'Oisel,76464,76,200,665,170,735,440,1345,865
29407,Neuville-Ferrières,76465,76,65,145,70,175,135,380,210
29408,Néville,76467,76,110,305,110,425,240,775,415
29409,Nointot,76468,76,135,375,110,425,270,805,510
29410,Nolléval,76469,76,67,125,24,79,92,195,192
29411,Normanville,76470,76,52,216,64,192,156,412,268
29412,Norville,76471,76,100,232,72,312,188,572,332
29413,Notre-Dame-d'Aliermont,76472,76,69,235,66,128,211,405,304
29414,Notre-Dame-de-Bliquetuit,76473,76,52,191,47,184,165,396,243
29415,Notre-Dame-de-Bondeville,76474,76,697,1684,734,2187,1412,4333,2381
29416,Franqueville-Saint-Pierre,76475,76,636,1629,526,2112,1130,3768,2265
29417,Port-Jérôme-sur-Seine,76476,76,998,2395,1008,3308,1804,6120,3393
29418,Notre-Dame-du-Bec,76477,76,45,132,44,145,104,293,177
29419,Notre-Dame-du-Parc,76478,76,16,24,4,56,40,100,40
29420,Nullemont,76479,76,20,35,10,40,25,75,55
29421,Ocqueville,76480,76,40,135,25,138,125,288,175
29422,Octeville-sur-Mer,76481,76,559,1537,428,2236,1020,3684,2096
29423,Offranville,76482,76,469,622,211,1323,413,1947,1091
29424,Oherville,76483,76,10,40,20,110,30,160,50
29425,Oissel,76484,76,1119,2827,1333,3349,2055,6737,3946
29426,Omonville,76485,76,25,50,10,85,40,135,75
29427,Orival,76486,76,76,284,112,240,236,588,360
29428,Osmoy-Saint-Valery,76487,76,41,89,20,113,65,198,130
29429,Ouainville,76488,76,69,131,38,145,88,271,200
29430,Oudalle,76489,76,40,105,60,145,90,295,145
29431,Ourville-en-Caux,76490,76,104,258,121,394,191,706,362
29432,Ouville-l'Abbaye,76491,76,59,173,50,197,119,366,232
29433,Ouville-la-Rivière,76492,76,80,130,20,215,70,305,210
29434,Paluel,76493,76,35,125,45,160,108,313,160
29435,Parc-d'Anxtot,76494,76,60,145,35,210,120,365,205
29436,Pavilly,76495,76,738,1577,668,2043,1116,3827,2315
29437,Petit-Couronne,76497,76,930,2299,1236,2785,1567,5588,3229
29438,Le Petit-Quevilly,76498,76,2017,6032,3210,6462,4618,14290,8049
29439,Petiville,76499,76,72,302,138,374,192,704,374
29440,Pierrecourt,76500,76,45,125,35,175,85,295,170
29441,Pierrefiques,76501,76,9,29,15,21,27,63,38
29442,Pierreval,76502,76,16,125,38,144,153,335,141
29443,Pissy-Pôville,76503,76,112,281,87,460,204,751,393
29444,Pleine-Sève,76504,76,8,32,20,60,32,112,40
29445,Pommereux,76505,76,10,25,5,35,30,70,35
29446,Pommeréval,76506,76,30,140,60,110,85,255,170
29447,Ponts-et-Marais,76507,76,104,177,83,249,119,451,281
29448,La Poterie-Cap-d'Antifer,76508,76,53,112,8,126,92,226,165
29449,Préaux,76509,76,169,475,109,629,378,1116,644
29450,Prétot-Vicquemare,76510,76,20,47,8,50,48,106,67
29451,Preuseville,76511,76,40,10,10,25,20,55,50
29452,Puisenval,76512,76,4,0,4,16,0,20,4
29453,Quevillon,76513,76,55,180,25,210,125,360,235
29454,Quévreville-la-Poterie,76514,76,75,240,70,394,175,639,315
29455,Quiberville,76515,76,80,110,55,205,100,360,190
29456,Quièvrecourt,76516,76,40,100,25,225,75,325,140
29457,Quincampoix,76517,76,395,730,205,1240,405,1850,1125
29458,Raffetot,76518,76,34,140,50,195,95,340,174
29459,Rainfreville,76519,76,10,20,10,46,5,61,30
29460,Réalcamp,76520,76,96,172,48,212,140,400,268
29461,Rebets,76521,76,12,48,16,44,20,80,60
29462,La Remuée,76522,76,125,375,145,390,255,790,500
29463,Rétonval,76523,76,25,40,35,50,40,125,65
29464,Reuville,76524,76,20,40,20,35,20,75,60
29465,Ricarville,76525,76,20,80,60,95,55,210,100
29466,Ricarville-du-Val,76526,76,48,44,8,12,30,50,92
29467,Richemont,76527,76,52,118,35,148,79,262,170
29468,Rieux,76528,76,68,160,48,228,152,428,228
29469,Riville,76529,76,46,86,15,96,55,166,132
29470,Robertot,76530,76,36,64,12,72,32,116,100
29471,Rocquefort,76531,76,16,96,8,124,72,204,112
29472,Rocquemont,76532,76,60,264,68,228,184,480,324
29473,Rogerville,76533,76,91,261,84,451,172,707,352
29474,Rolleville,76534,76,67,304,38,350,276,664,371
29475,Roncherolles-en-Bray,76535,76,72,120,40,170,80,290,192
29476,Roncherolles-sur-le-Vivier,76536,76,170,265,88,393,180,661,435
29477,Ronchois,76537,76,23,27,15,36,29,80,50
29478,Rosay,76538,76,55,85,15,98,40,153,140
29479,Rouen,76540,76,10604,24274,25874,26449,20517,72840,34878
29480,Roumare,76541,76,120,375,70,515,270,855,495
29481,Routes,76542,76,13,67,55,58,39,152,80
29482,Rouville,76543,76,60,172,72,196,120,388,232
29483,Rouvray-Catillon,76544,76,20,55,15,60,75,150,75
29484,Rouxmesnil-Bouteilles,76545,76,142,399,266,672,345,1283,541
29485,Royville,76546,76,25,75,40,70,60,170,100
29486,La Rue-Saint-Pierre,76547,76,48,245,80,172,238,490,293
29487,Ry,76548,76,95,161,40,311,110,461,256
29488,Saâne-Saint-Just,76549,76,20,35,30,40,25,95,55
29489,Sahurs,76550,76,165,293,91,439,227,757,458
29490,Sainneville,76551,76,65,205,55,320,185,560,270
29491,Sainte-Adresse,76552,76,1184,1464,619,2823,1012,4454,2648
29492,Sainte-Agathe-d'Aliermont,76553,76,36,80,28,63,60,151,116
29493,Saint-Aignan-sur-Ry,76554,76,32,92,33,91,62,186,124
29494,Saint-André-sur-Cailly,76555,76,55,255,85,330,155,570,310
29495,Saint-Antoine-la-Forêt,76556,76,32,263,89,358,207,654,295
29496,Saint-Arnoult,76557,76,115,345,119,443,270,832,460
29497,Saint-Aubin-Celloville,76558,76,50,215,135,345,185,665,265
29498,Saint-Aubin-de-Crétot,76559,76,16,168,44,216,124,384,184
29499,Saint-Aubin-Épinay,76560,76,93,250,85,425,155,665,343
29500,Saint-Aubin-lès-Elbeuf,76561,76,1092,2050,851,2421,1502,4774,3142
29501,Saint-Aubin-le-Cauf,76562,76,95,219,65,350,137,552,314
29502,Saint-Aubin-Routot,76563,76,118,357,80,450,217,747,475
29503,Saint-Aubin-sur-Mer,76564,76,22,29,24,94,19,137,51
29504,Saint-Aubin-sur-Scie,76565,76,130,225,70,460,200,730,355
29505,Sainte-Austreberthe,76566,76,28,164,84,220,100,404,192
29506,Sainte-Beuve-en-Rivière,76567,76,9,52,12,70,16,98,61
29507,Saint-Clair-sur-les-Monts,76568,76,50,165,40,240,120,400,215
29508,Sainte-Colombe,76569,76,24,44,16,60,26,102,68
29509,Saint-Crespin,76570,76,25,60,5,85,45,135,85
29510,Sainte-Croix-sur-Buchy,76571,76,40,212,52,236,148,436,252
29511,Saint-Denis-d'Aclon,76572,76,20,22,15,41,22,78,42
29512,Saint-Denis-le-Thiboult,76573,76,52,136,28,180,108,316,188
29513,Saint-Denis-sur-Scie,76574,76,38,220,59,209,131,399,258
29514,Saint-Étienne-du-Rouvray,76575,76,3215,7915,3889,8019,5018,16926,11130
29515,Saint-Eustache-la-Forêt,76576,76,59,220,82,414,175,671,279
29516,Sainte-Foy,76577,76,55,155,20,185,150,355,210
29517,Sainte-Geneviève,76578,76,40,70,10,120,50,180,110
29518,Saint-Georges-sur-Fontaine,76580,76,90,230,80,310,155,545,320
29519,Saint-Germain-des-Essourts,76581,76,16,112,16,135,57,208,128
29520,Saint-Germain-d'Étables,76582,76,35,55,20,125,30,175,90
29521,Saint-Germain-sous-Cailly,76583,76,10,115,20,95,100,215,125
29522,Saint-Germain-sur-Eaulne,76584,76,9,41,9,61,31,101,50
29523,Saint-Gilles-de-Crétot,76585,76,15,145,65,95,110,270,160
29524,Saint-Gilles-de-la-Neuville,76586,76,48,196,56,200,148,404,244
29525,Sainte-Hélène-Bondeville,76587,76,57,170,68,226,125,419,227
29526,Saint-Hellier,76588,76,74,81,42,150,57,249,155
29527,Saint-Honoré,76589,76,21,59,4,37,63,104,80
29528,Saint-Jacques-d'Aliermont,76590,76,25,90,40,89,87,216,115
29529,Saint-Jacques-sur-Darnétal,76591,76,290,597,137,979,430,1546,887
29530,Saint-Jean-de-Folleville,76592,76,80,195,70,320,160,550,275
29531,Saint-Jean-de-la-Neuville,76593,76,49,154,19,152,123,294,203
29532,Saint-Jean-du-Cardonnay,76594,76,115,308,98,546,222,866,423
29533,Saint-Jouin-Bruneval,76595,76,140,510,180,795,260,1235,650
29534,Saint-Laurent-de-Brèvedent,76596,76,124,356,124,600,212,936,480
29535,Saint-Laurent-en-Caux,76597,76,65,144,139,251,89,479,209
29536,Saint-Léger-aux-Bois,76598,76,70,110,40,175,90,305,180
29537,Saint-Léger-du-Bourg-Denis,76599,76,360,843,340,1097,661,2098,1203
29538,Saint-Léonard,76600,76,220,355,140,736,250,1126,575
29539,Saint-Maclou-de-Folleville,76602,76,36,178,80,191,148,419,214
29540,Saint-Maclou-la-Brière,76603,76,40,165,60,130,110,300,205
29541,Saint-Mards,76604,76,15,50,20,70,50,140,65
29542,Sainte-Marguerite-sur-Mer,76605,76,81,104,13,194,56,263,185
29543,Morienne,76606,76,20,40,10,75,30,115,60
29544,Sainte-Marguerite-sur-Fauville,76607,76,15,90,15,64,61,140,105
29545,Sainte-Marguerite-sur-Duclair,76608,76,170,500,160,730,405,1295,670
29546,Sainte-Marie-au-Bosc,76609,76,25,115,25,88,115,228,140
29547,Sainte-Marie-des-Champs,76610,76,225,305,130,569,265,964,530
29548,Saint-Martin-aux-Arbres,76611,76,12,92,18,86,67,171,104
29549,Saint-Martin-au-Bosc,76612,76,35,50,40,50,40,130,85
29550,Saint-Martin-aux-Buneaux,76613,76,90,170,45,230,130,405,260
29551,Saint-Martin-de-Boscherville,76614,76,244,352,108,560,208,876,596
29552,Saint-Martin-du-Bec,76615,76,30,150,47,249,83,379,180
29553,Saint-Martin-du-Manoir,76616,76,120,450,90,510,370,970,570
29554,Saint-Martin-du-Vivier,76617,76,255,355,105,735,200,1040,610
29555,Petit-Caux,76618,76,729,2544,774,3038,2049,5861,3273
29556,Saint-Martin-le-Gaillard,76619,76,25,55,35,130,60,225,80
29557,Saint-Martin-l'Hortier,76620,76,28,72,20,84,68,172,100
29558,Saint-Martin-Osmonville,76621,76,82,388,54,294,322,670,470
29559,Saint-Maurice-d'Ételan,76622,76,25,85,20,105,55,180,110
29560,Saint-Michel-d'Halescourt,76623,76,4,23,4,37,17,58,27
29561,Saint-Nicolas-d'Aliermont,76624,76,680,688,299,1279,619,2197,1368
29562,Saint-Nicolas-de-la-Haie,76626,76,17,114,31,93,99,223,131
29563,Saint-Nicolas-de-la-Taille,76627,76,64,434,116,437,356,909,498
29564,Saint-Ouen-du-Breuil,76628,76,67,191,73,254,112,439,258
29565,Saint-Ouen-le-Mauger,76629,76,20,105,50,80,45,175,125
29566,Saint-Ouen-sous-Bailly,76630,76,35,49,6,38,51,95,84
29567,Saint-Paër,76631,76,164,325,154,465,255,874,489
29568,Saint-Pierre-Bénouville,76632,76,34,95,36,84,87,207,129
29569,Saint-Pierre-de-Manneville,76634,76,88,189,80,287,145,512,277
29570,Saint-Pierre-des-Jonquières,76635,76,15,5,5,30,0,35,20
29571,Saint-Pierre-de-Varengeville,76636,76,314,506,180,877,351,1408,820
29572,Saint-Pierre-en-Port,76637,76,120,170,50,367,140,557,290
29573,Saint-Pierre-en-Val,76638,76,87,265,67,442,177,686,352
29574,Saint-Pierre-Lavis,76639,76,16,83,39,48,60,147,99
29575,Saint-Pierre-lès-Elbeuf,76640,76,1138,2105,747,2528,1640,4915,3243
29576,Saint-Pierre-le-Vieux,76641,76,21,45,0,48,48,96,66
29577,Saint-Pierre-le-Viger,76642,76,36,44,32,108,28,168,80
29578,Saint-Rémy-Boscrocourt,76644,76,61,188,90,276,136,502,249
29579,Saint-Riquier-en-Rivière,76645,76,28,40,24,44,12,80,68
29580,Saint-Riquier-ès-Plains,76646,76,55,156,52,199,77,328,211
29581,Saint-Romain-de-Colbosc,76647,76,761,868,462,1034,650,2146,1629
29582,Saint-Saëns,76648,76,393,608,246,766,443,1455,1001
29583,Saint-Saire,76649,76,44,180,96,176,112,384,224
29584,Saint-Sauveur-d'Émalleville,76650,76,62,368,104,306,272,682,430
29585,Saint-Sylvain,76651,76,5,45,30,75,40,145,50
29586,Saint-Vaast-d'Équiqueville,76652,76,80,222,64,172,163,399,302
29587,Saint-Vaast-Dieppedalle,76653,76,47,81,18,99,51,168,128
29588,Saint-Vaast-du-Val,76654,76,26,142,16,149,92,257,168
29589,Saint-Valery-en-Caux,76655,76,710,842,498,1311,628,2437,1552
29590,Saint-Victor-l'Abbaye,76656,76,56,225,73,174,166,413,281
29591,Saint-Vigor-d'Ymonville,76657,76,45,318,57,367,225,649,363
29592,Saint-Vincent-Cramesnil,76658,76,48,180,20,228,148,396,228
29593,Sandouville,76660,76,35,230,90,285,155,530,265
29594,Sassetot-le-Malgardé,76662,76,5,25,20,48,20,88,30
29595,Sassetot-le-Mauconduit,76663,76,166,196,74,311,152,537,362
29596,Sasseville,76664,76,13,71,26,79,49,154,84
29597,Sauchay,76665,76,64,76,25,125,68,218,140
29598,Saumont-la-Poterie,76666,76,45,90,21,98,76,195,135
29599,Sauqueville,76667,76,36,100,32,112,80,224,136
29600,Saussay,76668,76,0,105,35,135,90,260,105
29601,Sausseuzemare-en-Caux,76669,76,45,135,20,130,115,265,180
29602,Senneville-sur-Fécamp,76670,76,112,208,68,272,156,496,320
29603,Sept-Meules,76671,76,40,37,12,38,21,71,77
29604,Serqueux,76672,76,165,225,75,325,160,560,390
29605,Servaville-Salmonville,76673,76,56,360,76,357,234,667,416
29606,Sévis,76674,76,36,123,45,118,73,236,159
29607,Sierville,76675,76,76,284,56,324,236,616,360
29608,Sigy-en-Bray,76676,76,109,230,50,223,140,413,339
29609,Smermesnil,76677,76,66,132,20,73,78,171,198
29610,Sommery,76678,76,87,230,75,250,190,515,317
29611,Sommesnil,76679,76,9,37,6,6,38,50,46
29612,Sorquainville,76680,76,16,48,32,36,56,124,64
29613,Sotteville-lès-Rouen,76681,76,3907,6634,3283,8902,5402,17587,10541
29614,Sotteville-sous-le-Val,76682,76,45,184,80,259,147,486,229
29615,Sotteville-sur-Mer,76683,76,84,92,16,104,44,164,176
29616,Tancarville,76684,76,45,381,120,440,301,861,426
29617,Thérouldeville,76685,76,55,185,60,175,175,410,240
29618,Theuville-aux-Maillots,76686,76,66,159,43,105,112,260,225
29619,Thiergeville,76688,76,26,121,34,112,86,232,147
29620,Thiétreville,76689,76,24,96,76,116,76,268,120
29621,Thil-Manneville,76690,76,39,156,44,175,122,341,195
29622,Le Thil-Riberpré,76691,76,20,50,20,100,30,150,70
29623,Thiouville,76692,76,37,99,12,62,68,142,136
29624,Le Tilleul,76693,76,64,176,44,248,152,444,240
29625,Tocqueville-en-Caux,76694,76,10,25,10,55,25,90,35
29626,Tocqueville-les-Murs,76695,76,15,70,40,90,65,195,85
29627,Torcy-le-Grand,76697,76,65,185,20,279,185,484,250
29628,Torcy-le-Petit,76698,76,50,85,60,185,80,325,135
29629,Le Torp-Mesnil,76699,76,20,113,52,112,80,244,133
29630,Tôtes,76700,76,152,425,156,414,303,873,577
29631,Touffreville-la-Corbeline,76702,76,48,183,59,266,170,495,231
29632,Touffreville-sur-Eu,76703,76,16,34,12,71,28,111,50
29633,Tourville-la-Rivière,76705,76,237,623,255,709,437,1401,860
29634,Tourville-les-Ifs,76706,76,40,131,18,181,105,304,171
29635,Tourville-sur-Arques,76707,76,168,320,112,404,212,728,488
29636,Toussaint,76708,76,120,146,60,272,125,457,266
29637,Le Trait,76709,76,822,1237,614,1521,864,2999,2059
29638,Trémauville,76710,76,0,25,0,45,35,80,25
29639,Le Tréport,76711,76,809,1025,468,1838,770,3076,1834
29640,La Trinité-du-Mont,76712,76,40,218,56,238,234,528,258
29641,Les Trois-Pierres,76714,76,57,154,73,358,80,511,211
29642,Trouville,76715,76,60,180,36,232,128,396,240
29643,Turretot,76716,76,125,440,130,476,338,944,565
29644,Val-de-la-Haye,76717,76,68,163,56,249,118,423,231
29645,Valliquerville,76718,76,99,315,118,467,284,869,414
29646,Valmont,76719,76,138,215,84,325,135,544,353
29647,Varengeville-sur-Mer,76720,76,182,143,47,436,116,599,325
29648,Varneville-Bretteville,76721,76,19,95,26,101,48,175,114
29649,Vassonville,76723,76,16,122,28,137,91,256,138
29650,Vatierville,76724,76,6,38,6,39,17,62,44
29651,Vattetot-sous-Beaumont,76725,76,20,196,32,172,156,360,216
29652,Vattetot-sur-Mer,76726,76,32,92,24,108,80,212,124
29653,Vatteville-la-Rue,76727,76,96,305,116,364,216,696,401
29654,La Vaupalière,76728,76,114,190,97,355,112,564,304
29655,Veauville-lès-Baons,76729,76,50,214,75,279,149,503,264
29656,Veauville-lès-Quelles,76730,76,4,29,16,50,12,78,33
29657,Vénestanville,76731,76,0,68,24,48,40,112,68
29658,Butot-Vénesville,76732,76,10,45,30,110,40,180,55
29659,Ventes-Saint-Rémy,76733,76,4,56,8,92,48,148,60
29660,Vergetot,76734,76,40,128,25,135,103,263,168
29661,Veules-les-Roses,76735,76,153,77,24,175,88,287,230
29662,Veulettes-sur-Mer,76736,76,15,60,40,130,59,229,75
29663,Vibeuf,76737,76,50,197,25,253,122,400,247
29664,Vieux-Manoir,76738,76,39,193,61,245,150,456,232
29665,Vieux-Rouen-sur-Bresle,76739,76,87,123,71,214,96,381,210
29666,La Vieux-Rue,76740,76,20,177,56,168,124,348,197
29667,Villainville,76741,76,12,116,28,108,68,204,128
29668,Villers-Écalles,76743,76,170,380,167,652,327,1146,550
29669,Villers-sous-Foucarmont,76744,76,15,45,15,105,25,145,60
29670,Villy-sur-Yères,76745,76,25,30,10,85,35,130,55
29671,Vinnemerville,76746,76,56,44,16,40,48,104,100
29672,Virville,76747,76,16,143,8,83,86,177,159
29673,Vittefleur,76748,76,60,145,45,264,105,414,205
29674,Wanchy-Capval,76749,76,41,52,48,127,48,223,93
29675,Yainville,76750,76,115,310,100,349,204,653,425
29676,Yébleron,76751,76,122,354,170,483,209,862,476
29677,Yerville,76752,76,379,522,226,764,435,1425,901
29678,Ymare,76753,76,68,336,96,400,268,764,404
29679,Yport,76754,76,173,189,60,300,118,478,362
29680,Ypreville-Biville,76755,76,44,146,58,189,100,347,190
29681,Yquebeuf,76756,76,15,60,15,100,45,160,75
29682,Yvecrique,76757,76,55,165,95,185,155,435,220
29683,Yvetot,76758,76,1782,2510,1492,3591,2018,7101,4292
29684,Yville-sur-Seine,76759,76,50,130,20,135,126,281,180
29685,Achères-la-Forêt,77001,77,120,270,100,441,200,741,390
29686,Amillis,77002,77,59,183,64,246,132,442,242
29687,Amponville,77003,77,51,77,46,136,50,232,128
29688,Andrezel,77004,77,5,55,15,175,40,230,60
29689,Annet-sur-Marne,77005,77,74,955,266,958,794,2018,1029
29690,Arbonne-la-Forêt,77006,77,104,216,80,372,152,604,320
29691,Argentières,77007,77,50,105,25,100,110,235,155
29692,Armentières-en-Brie,77008,77,75,505,125,300,245,670,580
29693,Arville,77009,77,25,12,29,21,12,62,37
29694,Aubepierre-Ozouer-le-Repos,77010,77,68,220,80,340,160,580,288
29695,Aufferville,77011,77,30,150,70,185,85,340,180
29696,Augers-en-Brie,77012,77,12,100,20,108,68,196,112
29697,Aulnoy,77013,77,55,80,40,135,65,240,135
29698,Avon,77014,77,1913,3159,1868,3972,2649,8489,5072
29699,Baby,77015,77,10,15,0,40,15,55,25
29700,Bagneaux-sur-Loing,77016,77,204,420,210,530,289,1029,624
29701,Bailly-Romainvilliers,77018,77,183,2481,1045,1760,1839,4644,2664
29702,Balloy,77019,77,36,84,32,124,60,216,120
29703,Bannost-Villegagnon,77020,77,28,172,92,208,160,460,200
29704,Barbey,77021,77,15,35,30,40,25,95,50
29705,Barbizon,77022,77,213,189,86,581,112,779,402
29706,Barcy,77023,77,16,96,24,88,48,160,112
29707,Bassevelle,77024,77,24,89,35,102,69,206,113
29708,Bazoches-lès-Bray,77025,77,154,160,50,305,155,510,314
29709,Beauchery-Saint-Martin,77026,77,44,128,28,116,88,232,172
29710,Beaumont-du-Gâtinais,77027,77,130,330,45,355,215,615,460
29711,Beautheil,77028,77,44,212,56,248,168,472,256
29712,Beauvoir,77029,77,9,44,16,73,33,122,53
29713,Bellot,77030,77,68,160,124,268,176,568,228
29714,Bernay-Vilbert,77031,77,55,195,67,332,108,507,250
29715,Beton-Bazoches,77032,77,116,248,88,208,212,508,364
29716,Bezalles,77033,77,12,64,32,92,48,172,76
29717,Blandy,77034,77,60,142,67,251,95,413,202
29718,Blennes,77035,77,26,125,60,228,81,369,151
29719,Boisdon,77036,77,20,30,20,30,30,80,50
29720,Bois-le-Roi,77037,77,604,1324,522,2057,917,3496,1928
29721,Boissettes,77038,77,70,60,20,167,35,222,130
29722,Boissise-la-Bertrand,77039,77,80,286,64,382,201,647,366
29723,Boissise-le-Roi,77040,77,378,871,347,1371,618,2336,1249
29724,Boissy-aux-Cailles,77041,77,10,70,0,155,50,205,80
29725,Boissy-le-Châtel,77042,77,302,859,276,1044,554,1874,1161
29726,Boitron,77043,77,35,95,40,150,60,250,130
29727,Bombon,77044,77,58,203,47,298,165,510,261
29728,Bougligny,77045,77,56,184,32,264,156,452,240
29729,Boulancourt,77046,77,36,69,34,108,70,212,105
29730,Bouleurs,77047,77,45,387,203,482,293,978,432
29731,Bourron-Marlotte,77048,77,339,677,147,945,395,1487,1016
29732,Boutigny,77049,77,53,216,78,327,119,524,269
29733,Bransles,77050,77,70,137,18,167,80,265,207
29734,Bray-sur-Seine,77051,77,334,518,232,578,427,1237,852
29735,Bréau,77052,77,5,95,20,145,50,215,100
29736,Brie-Comte-Robert,77053,77,1485,4233,2173,4463,3601,10237,5718
29737,La Brosse-Montceaux,77054,77,64,219,65,249,175,489,283
29738,Brou-sur-Chantereine,77055,77,303,1295,658,1176,905,2739,1598
29739,Burcy,77056,77,20,32,16,68,24,108,52
29740,Bussières,77057,77,49,163,69,130,94,293,212
29741,Bussy-Saint-Georges,77058,77,590,7608,4406,6398,6729,17533,8198
29742,Bussy-Saint-Martin,77059,77,55,155,70,255,165,490,210
29743,Buthiers,77060,77,77,142,47,286,122,455,219
29744,Cannes-Écluse,77061,77,381,555,203,660,405,1268,936
29745,Carnetin,77062,77,64,104,39,158,89,286,168
29746,La Celle-sur-Morin,77063,77,95,340,95,381,295,771,435
29747,Cély,77065,77,158,295,92,427,178,697,453
29748,Cerneux,77066,77,30,102,16,83,67,166,132
29749,Cesson,77067,77,885,2903,1030,2775,2147,5952,3788
29750,Cessoy-en-Montois,77068,77,39,46,3,46,43,92,85
29751,Chailly-en-Bière,77069,77,244,425,243,633,368,1244,669
29752,Chailly-en-Brie,77070,77,92,293,112,491,244,847,385
29753,Chaintreaux,77071,77,101,211,66,280,174,520,312
29754,Chalautre-la-Grande,77072,77,72,224,64,180,164,408,296
29755,Chalautre-la-Petite,77073,77,48,172,44,236,100,380,220
29756,Chalifert,77075,77,105,355,100,445,250,795,460
29757,Chalmaison,77076,77,59,152,82,297,108,487,211
29758,Chambry,77077,77,88,256,84,268,224,576,344
29759,Chamigny,77078,77,128,332,140,380,268,788,460
29760,Champagne-sur-Seine,77079,77,677,1666,805,1792,1168,3765,2343
29761,Champcenest,77080,77,20,45,45,70,20,135,65
29762,Champdeuil,77081,77,40,200,108,196,172,476,240
29763,Champeaux,77082,77,68,183,90,294,111,495,251
29764,Champs-sur-Marne,77083,77,1239,6942,4290,7035,5129,16454,8181
29765,Changis-sur-Marne,77084,77,100,313,108,321,259,688,413
29766,Chanteloup-en-Brie,77085,77,183,1154,356,663,888,1907,1337
29767,La Chapelle-Gauthier,77086,77,75,475,165,455,289,909,550
29768,La Chapelle-Iger,77087,77,8,34,4,60,28,92,42
29769,La Chapelle-la-Reine,77088,77,186,650,296,793,438,1527,836
29770,La Chapelle-Rablais,77089,77,25,315,56,296,234,586,340
29771,La Chapelle-Saint-Sulpice,77090,77,4,84,20,52,80,152,88
29772,Les Chapelles-Bourbon,77091,77,9,129,29,111,95,235,138
29773,La Chapelle-Moutils,77093,77,34,102,40,184,47,271,136
29774,Charmentray,77094,77,0,56,22,83,58,163,56
29775,Charny,77095,77,94,324,112,366,279,757,418
29776,Chartrettes,77096,77,270,574,198,921,446,1565,844
29777,Chartronges,77097,77,28,72,24,116,48,188,100
29778,Châteaubleau,77098,77,28,109,21,109,66,196,137
29779,Château-Landon,77099,77,532,663,251,960,442,1653,1195
29780,Le Châtelet-en-Brie,77100,77,460,1149,427,1442,787,2656,1609
29781,Châtenay-sur-Seine,77101,77,86,252,54,306,244,604,338
29782,Châtenoy,77102,77,0,44,16,64,40,120,44
29783,Châtillon-la-Borde,77103,77,16,72,20,68,60,148,88
29784,Châtres,77104,77,12,184,76,224,144,444,196
29785,Chauffry,77106,77,110,260,120,310,195,625,370
29786,Chaumes-en-Brie,77107,77,193,752,325,970,728,2023,945
29787,Chelles,77108,77,4752,15217,6750,14690,11960,33400,19969
29788,Chenoise,77109,77,110,340,140,491,200,831,450
29789,Chenou,77110,77,55,85,25,80,60,165,140
29790,Chessy,77111,77,187,1434,783,1064,1358,3205,1621
29791,Chevrainvilliers,77112,77,36,60,16,88,44,148,96
29792,Chevru,77113,77,26,340,112,275,272,659,366
29793,Chevry-Cossigny,77114,77,282,1228,361,1157,972,2490,1510
29794,Chevry-en-Sereine,77115,77,55,140,50,200,85,335,195
29795,Choisy-en-Brie,77116,77,144,360,120,484,236,840,504
29796,Citry,77117,77,29,254,95,241,168,504,283
29797,Claye-Souilly,77118,77,934,2979,1422,3834,2353,7609,3913
29798,Clos-Fontaine,77119,77,5,80,30,109,65,204,85
29799,Cocherel,77120,77,60,220,30,170,175,375,280
29800,Collégien,77121,77,152,864,414,1014,805,2233,1016
29801,Combs-la-Ville,77122,77,1761,6140,2748,6436,4650,13834,7901
29802,Compans,77123,77,19,189,153,260,109,522,208
29803,Conches-sur-Gondoire,77124,77,184,400,128,644,304,1076,584
29804,Condé-Sainte-Libiaire,77125,77,95,350,93,495,274,862,445
29805,Congis-sur-Thérouanne,77126,77,165,481,180,456,358,994,646
29806,Coubert,77127,77,37,482,273,444,394,1111,519
29807,Couilly-Pont-aux-Dames,77128,77,183,525,285,698,404,1387,708
29808,Coulombs-en-Valois,77129,77,30,153,61,213,102,376,183
29809,Coulommes,77130,77,17,119,21,134,90,245,136
29810,Coulommiers,77131,77,1895,3618,1950,4348,2678,8976,5513
29811,Coupvray,77132,77,200,684,283,1093,448,1824,884
29812,Courcelles-en-Bassée,77133,77,20,60,8,112,36,156,80
29813,Courchamp,77134,77,24,40,12,40,28,80,64
29814,Courpalay,77135,77,76,489,136,422,331,889,565
29815,Courquetaine,77136,77,9,56,6,76,19,101,65
29816,Courtacon,77137,77,24,76,24,52,60,136,100
29817,Courtomer,77138,77,23,111,48,189,89,326,134
29818,Courtry,77139,77,388,1811,774,2133,1375,4282,2199
29819,Coutençon,77140,77,12,85,21,100,57,178,97
29820,Coutevroult,77141,77,49,351,120,296,222,638,400
29821,Crécy-la-Chapelle,77142,77,348,1036,529,1221,988,2738,1384
29822,Crégy-lès-Meaux,77143,77,191,1537,502,1302,1074,2878,1728
29823,Crèvecoeur-en-Brie,77144,77,30,125,15,123,100,238,155
29824,Crisenoy,77145,77,25,205,40,263,150,453,230
29825,Croissy-Beaubourg,77146,77,160,400,214,807,349,1370,560
29826,La Croix-en-Brie,77147,77,79,139,72,174,110,356,218
29827,Crouy-sur-Ourcq,77148,77,163,546,225,544,361,1130,709
29828,Cucharmoy,77149,77,19,29,32,61,32,125,48
29829,Cuisy,77150,77,16,125,30,133,95,258,141
29830,Dagny,77151,77,23,81,32,73,57,162,104
29831,Dammarie-les-Lys,77152,77,2140,5971,2900,5828,4375,13103,8111
29832,Dammartin-en-Goële,77153,77,521,2294,1206,2824,1910,5940,2815
29833,Dammartin-sur-Tigeaux,77154,77,75,279,91,259,218,568,354
29834,Dampmart,77155,77,251,879,290,949,707,1946,1130
29835,Darvault,77156,77,152,184,88,288,124,500,336
29836,Dhuisy,77157,77,21,100,8,68,71,147,121
29837,Diant,77158,77,22,21,25,48,29,102,43
29838,Donnemarie-Dontilly,77159,77,344,820,236,851,540,1627,1164
29839,Dormelles,77161,77,45,182,35,317,123,475,227
29840,Doue,77162,77,90,240,125,382,180,687,330
29841,Douy-la-Ramée,77163,77,16,100,40,68,80,188,116
29842,Échouboulains,77164,77,65,145,75,175,90,340,210
29843,Les Écrennes,77165,77,12,132,68,255,79,402,144
29844,Égligny,77167,77,8,106,25,95,76,196,114
29845,Égreville,77168,77,248,596,192,628,452,1272,844
29846,Émerainville,77169,77,339,2120,996,2151,1781,4928,2459
29847,Esbly,77171,77,522,1523,726,1570,1576,3872,2045
29848,Esmans,77172,77,123,242,79,306,164,549,365
29849,Étrépilly,77173,77,25,240,79,270,181,530,265
29850,Everly,77174,77,25,180,55,205,165,425,205
29851,Évry-Grégy-sur-Yerre,77175,77,138,727,216,930,522,1668,865
29852,Faremoutiers,77176,77,228,722,321,685,565,1571,950
29853,Favières,77177,77,103,277,88,360,214,662,380
29854,Faÿ-lès-Nemours,77178,77,30,135,30,205,90,325,165
29855,Féricy,77179,77,50,165,35,200,145,380,215
29856,Férolles-Attilly,77180,77,100,320,120,408,224,752,420
29857,Ferrières-en-Brie,77181,77,119,753,298,890,654,1842,872
29858,La Ferté-Gaucher,77182,77,650,1303,502,1252,828,2582,1953
29859,La Ferté-sous-Jouarre,77183,77,983,2460,1326,2768,1879,5973,3443
29860,Flagy,77184,77,53,180,59,194,91,344,233
29861,Fleury-en-Bière,77185,77,65,145,60,245,120,425,210
29862,Fontainebleau,77186,77,2119,3144,1845,4216,2704,8765,5263
29863,Fontaine-Fourches,77187,77,40,164,40,180,100,320,204
29864,Fontaine-le-Port,77188,77,112,208,108,360,148,616,320
29865,Fontains,77190,77,19,33,28,89,15,132,52
29866,Fontenailles,77191,77,76,320,92,348,240,680,396
29867,Fontenay-Trésigny,77192,77,496,1430,653,1603,1066,3322,1926
29868,Forfry,77193,77,0,72,20,67,66,153,72
29869,Forges,77194,77,24,124,56,108,84,248,148
29870,Fouju,77195,77,32,152,60,156,164,380,184
29871,Fresnes-sur-Marne,77196,77,32,263,64,140,235,439,295
29872,Frétoy,77197,77,8,52,18,38,49,105,60
29873,Fromont,77198,77,21,74,12,69,34,115,95
29874,Fublaines,77199,77,35,275,76,392,220,688,310
29875,Garentreville,77200,77,16,28,8,36,24,68,44
29876,Gastins,77201,77,44,180,100,200,184,484,224
29877,La Genevraye,77202,77,62,155,84,219,143,446,217
29878,Germigny-l'Évêque,77203,77,140,295,120,545,220,885,435
29879,Germigny-sous-Coulombs,77204,77,9,45,9,66,33,108,54
29880,Gesvres-le-Chapitre,77205,77,6,40,24,26,38,88,46
29881,Giremoutiers,77206,77,16,40,8,44,28,80,56
29882,Gironville,77207,77,26,36,3,31,30,64,62
29883,Gouaix,77208,77,93,414,162,485,256,903,507
29884,Gouvernes,77209,77,104,252,91,369,238,698,356
29885,La Grande-Paroisse,77210,77,344,708,223,939,473,1635,1052
29886,Grandpuits-Bailly-Carrois,77211,77,72,251,106,308,173,587,323
29887,Gravon,77212,77,34,26,0,44,20,64,60
29888,Gressy,77214,77,92,216,100,344,136,580,308
29889,Gretz-Armainvilliers,77215,77,803,2324,1044,2525,1878,5447,3127
29890,Grez-sur-Loing,77216,77,190,360,115,481,255,851,550
29891,Grisy-Suisnes,77217,77,172,638,212,689,541,1442,810
29892,Grisy-sur-Seine,77218,77,4,36,0,36,20,56,40
29893,Guérard,77219,77,164,639,174,813,541,1528,803
29894,Guercheville,77220,77,15,55,45,105,65,215,70
29895,Guermantes,77221,77,19,283,133,481,178,792,302
29896,Guignes,77222,77,224,1010,438,894,780,2112,1234
29897,Gurcy-le-Châtel,77223,77,24,154,62,184,100,346,178
29898,Hautefeuille,77224,77,16,40,4,38,35,77,56
29899,La Haute-Maison,77225,77,34,76,16,55,78,149,110
29900,Héricy,77226,77,252,598,179,1038,330,1547,850
29901,Hermé,77227,77,68,184,72,224,96,392,252
29902,Hondevilliers,77228,77,16,49,17,74,66,157,65
29903,La Houssaye-en-Brie,77229,77,136,472,160,468,372,1000,608
29904,Ichy,77230,77,4,56,12,72,40,124,60
29905,Isles-les-Meldeuses,77231,77,76,224,120,220,128,468,300
29906,Isles-lès-Villenoy,77232,77,75,300,74,279,183,536,375
29907,Iverny,77233,77,38,166,34,178,115,327,204
29908,Jablines,77234,77,28,210,100,182,148,430,238
29909,Jaignes,77235,77,30,54,9,93,32,134,84
29910,Jaulnes,77236,77,30,85,35,173,50,258,115
29911,Jossigny,77237,77,41,205,39,213,140,392,246
29912,Jouarre,77238,77,325,1128,464,1025,769,2258,1453
29913,Jouy-le-Châtel,77239,77,88,449,216,456,316,988,537
29914,Jouy-sur-Morin,77240,77,230,561,225,650,430,1305,791
29915,Juilly,77241,77,100,620,176,584,417,1177,720
29916,Jutigny,77242,77,46,128,28,140,127,295,174
29917,Lagny-sur-Marne,77243,77,2034,5425,2729,6388,4390,13507,7459
29918,Larchant,77244,77,122,158,40,258,121,419,280
29919,Laval-en-Brie,77245,77,25,123,45,198,75,318,148
29920,Léchelle,77246,77,46,175,30,157,140,327,221
29921,Lescherolles,77247,77,54,122,40,176,48,264,176
29922,Lesches,77248,77,52,168,72,224,136,432,220
29923,Lésigny,77249,77,700,1953,602,2608,1434,4644,2653
29924,Leudon-en-Brie,77250,77,15,45,10,60,35,105,60
29925,Lieusaint,77251,77,177,3912,2336,2580,2915,7831,4089
29926,Limoges-Fourches,77252,77,36,144,48,140,88,276,180
29927,Lissy,77253,77,10,55,35,75,40,150,65
29928,Liverdy-en-Brie,77254,77,74,363,130,473,284,887,437
29929,Livry-sur-Seine,77255,77,307,411,121,651,358,1130,718
29930,Lizines,77256,77,16,40,12,84,24,120,56
29931,Lizy-sur-Ourcq,77257,77,303,1035,486,909,744,2139,1338
29932,Lognes,77258,77,505,3702,2383,3966,3130,9479,4207
29933,Longperrier,77259,77,66,707,312,622,631,1565,773
29934,Longueville,77260,77,207,479,258,503,257,1018,686
29935,Lorrez-le-Bocage-Préaux,77261,77,119,331,132,393,184,709,450
29936,Louan-Villegruis-Fontaine,77262,77,60,145,25,130,135,290,205
29937,Luisetaines,77263,77,12,96,17,61,44,122,108
29938,Lumigny-Nesles-Ormeaux,77264,77,95,410,150,570,290,1010,505
29939,Luzancy,77265,77,53,305,112,394,160,666,358
29940,Machault,77266,77,40,238,70,235,178,483,278
29941,La Madeleine-sur-Loing,77267,77,45,70,25,130,70,225,115
29942,Magny-le-Hongre,77268,77,170,2928,1147,1539,2489,5175,3098
29943,Maincy,77269,77,175,315,240,665,260,1165,490
29944,Maisoncelles-en-Brie,77270,77,76,216,80,260,160,500,292
29945,Maisoncelles-en-Gâtinais,77271,77,19,15,9,34,12,55,34
29946,Maison-Rouge,77272,77,35,269,100,240,223,563,304
29947,Marchémoret,77273,77,21,156,47,175,114,336,177
29948,Marcilly,77274,77,55,140,50,110,130,290,195
29949,Les Marêts,77275,77,15,55,10,50,30,90,70
29950,Mareuil-lès-Meaux,77276,77,85,792,320,828,485,1633,877
29951,Marles-en-Brie,77277,77,115,383,165,462,309,936,498
29952,Marolles-en-Brie,77278,77,12,106,38,135,64,237,118
29953,Marolles-sur-Seine,77279,77,176,515,112,530,284,926,691
29954,Mary-sur-Marne,77280,77,86,283,100,404,163,667,369
29955,Mauperthuis,77281,77,27,110,69,157,79,305,137
29956,Mauregard,77282,77,12,94,37,63,79,179,106
29957,May-en-Multien,77283,77,40,300,75,285,205,565,340
29958,Meaux,77284,77,3826,15687,7719,13527,11273,32519,19513
29959,Le Mée-sur-Seine,77285,77,1467,6698,2596,5544,4135,12275,8165
29960,Meigneux,77286,77,16,88,12,72,52,136,104
29961,Meilleray,77287,77,35,150,30,180,120,330,185
29962,Melun,77288,77,3114,11270,6718,8992,8657,24367,14384
29963,Melz-sur-Seine,77289,77,20,88,32,136,76,244,108
29964,Méry-sur-Marne,77290,77,64,176,32,248,124,404,240
29965,Le Mesnil-Amelot,77291,77,41,229,86,113,285,484,270
29966,Messy,77292,77,43,309,126,258,275,659,352
29967,Misy-sur-Yonne,77293,77,165,285,85,260,200,545,450
29968,Mitry-Mory,77294,77,1508,6000,2350,5587,3989,11926,7508
29969,Moisenay,77295,77,66,390,84,474,282,840,456
29970,Moissy-Cramayel,77296,77,697,5694,2751,4589,3777,11117,6391
29971,Mondreville,77297,77,9,80,23,113,104,240,89
29972,Mons-en-Montois,77298,77,45,130,35,170,105,310,175
29973,Montceaux-lès-Meaux,77300,77,36,172,28,224,140,392,208
29974,Montceaux-lès-Provins,77301,77,40,60,36,140,56,232,100
29975,Montcourt-Fromonville,77302,77,148,505,145,790,394,1329,653
29976,Montdauphin,77303,77,54,56,0,42,49,91,110
29977,Montenils,77304,77,6,3,6,6,0,12,9
29978,Montereau-Fault-Yonne,77305,77,1840,5302,2669,4479,3568,10716,7142
29979,Montereau-sur-le-Jard,77306,77,60,140,75,155,110,340,200
29980,Montévrain,77307,77,268,2412,2456,1799,2717,6972,2680
29981,Montgé-en-Goële,77308,77,38,164,103,202,142,447,202
29982,Monthyon,77309,77,94,532,157,474,354,985,626
29983,Montigny-le-Guesdier,77310,77,35,65,25,115,45,185,100
29984,Montigny-Lencoup,77311,77,158,376,88,428,214,730,534
29985,Montigny-sur-Loing,77312,77,331,596,253,1063,469,1785,927
29986,Montmachoux,77313,77,24,38,15,87,36,138,62
29987,Montolivet,77314,77,16,60,32,104,28,164,76
29988,Montry,77315,77,292,909,319,1055,860,2234,1201
29989,Moret Loing et Orvanne,77316,77,845,1831,674,2473,1437,4584,2676
29990,Mormant,77317,77,385,1385,473,1336,968,2777,1770
29991,Mortcerf,77318,77,84,342,165,398,264,827,426
29992,Mortery,77319,77,3,32,9,55,22,86,35
29993,Mouroux,77320,77,448,1511,556,1599,1059,3214,1959
29994,Mousseaux-lès-Bray,77321,77,88,224,60,248,128,436,312
29995,Moussy-le-Neuf,77322,77,178,908,335,836,685,1856,1086
29996,Moussy-le-Vieux,77323,77,32,321,168,315,287,770,353
29997,Mouy-sur-Seine,77325,77,61,58,24,109,51,184,119
29998,Nandy,77326,77,150,1844,738,1801,1218,3757,1994
29999,Nangis,77327,77,762,2499,1036,2232,1749,5017,3261
30000,Nanteau-sur-Essonne,77328,77,46,89,23,163,61,247,135
30001,Nanteau-sur-Lunain,77329,77,45,113,55,170,128,353,158
30002,Nanteuil-lès-Meaux,77330,77,540,1558,698,1670,1223,3591,2098
30003,Nanteuil-sur-Marne,77331,77,15,110,60,155,95,310,125
30004,Nantouillet,77332,77,15,80,35,90,35,160,95
30005,Nemours,77333,77,1440,3587,1624,3623,2345,7592,5027
30006,Chauconin-Neufmontiers,77335,77,180,704,154,558,563,1275,884
30007,Neufmoutiers-en-Brie,77336,77,18,249,103,278,183,564,267
30008,Noisiel,77337,77,873,4401,2152,4678,2980,9810,5274
30009,Noisy-Rudignon,77338,77,70,190,39,184,130,353,260
30010,Noisy-sur-École,77339,77,195,440,149,799,283,1231,635
30011,Nonville,77340,77,42,128,61,172,124,357,170
30012,Noyen-sur-Seine,77341,77,34,60,32,134,38,204,94
30013,Obsonville,77342,77,8,12,28,48,4,80,20
30014,Ocquerre,77343,77,10,150,45,105,120,270,160
30015,Oissery,77344,77,49,715,225,562,580,1367,764
30016,Orly-sur-Morin,77345,77,85,164,51,164,139,354,249
30017,Les Ormes-sur-Voulzie,77347,77,120,232,45,248,157,450,352
30018,Ormesson,77348,77,42,81,15,87,42,144,123
30019,Othis,77349,77,485,1984,580,2068,1331,3979,2469
30020,Ozoir-la-Ferrière,77350,77,1703,5244,2377,6850,3756,12983,6947
30021,Ozouer-le-Voulgis,77352,77,108,589,171,523,466,1160,697
30022,Paley,77353,77,45,86,15,226,45,286,131
30023,Pamfou,77354,77,35,300,100,283,198,581,335
30024,Paroy,77355,77,15,30,30,85,15,130,45
30025,Passy-sur-Seine,77356,77,8,16,4,4,28,36,24
30026,Pécy,77357,77,24,199,62,286,192,540,223
30027,Penchard,77358,77,80,257,109,394,170,673,337
30028,Perthes,77359,77,255,487,131,837,333,1301,742
30029,Pézarches,77360,77,20,141,16,128,101,245,161
30030,Pierre-Levée,77361,77,12,152,56,152,104,312,164
30031,Le Pin,77363,77,75,398,135,418,353,906,473
30032,Le Plessis-aux-Bois,77364,77,15,90,10,65,80,155,105
30033,Le Plessis-Feu-Aussoux,77365,77,16,145,30,137,140,307,161
30034,Le Plessis-l'Évêque,77366,77,21,58,57,82,25,164,79
30035,Le Plessis-Placy,77367,77,12,72,28,112,48,188,84
30036,Poigny,77368,77,37,119,31,195,84,310,156
30037,Poincy,77369,77,30,190,55,265,150,470,220
30038,Poligny,77370,77,131,140,99,267,118,484,271
30039,Pommeuse,77371,77,179,845,231,890,616,1737,1024
30040,Pomponne,77372,77,298,920,508,1228,733,2469,1218
30041,Pontault-Combault,77373,77,2339,10737,5566,10950,8108,24624,13076
30042,Pontcarré,77374,77,133,611,220,609,485,1314,744
30043,Précy-sur-Marne,77376,77,25,260,100,175,220,495,285
30044,Presles-en-Brie,77377,77,110,630,200,770,500,1470,740
30045,Pringy,77378,77,326,642,331,935,479,1745,968
30046,Provins,77379,77,1530,2773,1672,3341,1912,6925,4303
30047,Puisieux,77380,77,30,95,25,75,95,195,125
30048,Quiers,77381,77,15,225,50,170,215,435,240
30049,Quincy-Voisins,77382,77,333,1425,536,1599,1159,3294,1758
30050,Rampillon,77383,77,46,198,95,263,170,528,244
30051,Réau,77384,77,53,287,99,302,223,624,340
30052,Rebais,77385,77,250,656,179,611,451,1241,906
30053,Recloses,77386,77,40,180,84,284,100,468,220
30054,Remauville,77387,77,65,115,40,125,110,275,180
30055,Reuil-en-Brie,77388,77,50,255,95,260,155,510,305
30056,La Rochette,77389,77,371,721,482,950,607,2039,1092
30057,Roissy-en-Brie,77390,77,1397,6954,2869,6606,4715,14190,8351
30058,Rouilly,77391,77,80,100,55,175,65,295,180
30059,Rouvres,77392,77,35,267,63,195,200,458,302
30060,Rozay-en-Brie,77393,77,259,713,339,804,573,1716,972
30061,Rubelles,77394,77,241,519,168,677,358,1203,760
30062,Rumont,77395,77,12,21,8,29,26,63,33
30063,Rupéreux,77396,77,30,35,10,5,30,45,65
30064,Saâcy-sur-Marne,77397,77,187,406,154,566,365,1085,593
30065,Sablonnières,77398,77,52,192,76,266,120,462,244
30066,Saint-Ange-le-Viel,77399,77,20,64,12,80,48,140,84
30067,Saint-Augustin,77400,77,160,390,180,680,315,1175,550
30068,Sainte-Aulde,77401,77,48,196,60,260,144,464,244
30069,Saint-Barthélemy,77402,77,20,95,20,125,65,210,115
30070,Saint-Brice,77403,77,83,149,68,229,123,420,232
30071,Sainte-Colombe,77404,77,220,400,210,740,245,1195,620
30072,Saint-Cyr-sur-Morin,77405,77,203,563,191,499,477,1167,766
30073,Saint-Denis-lès-Rebais,77406,77,68,247,48,294,198,540,315
30074,Saint-Fargeau-Ponthierry,77407,77,1296,3791,1556,4090,2913,8559,5087
30075,Saint-Fiacre,77408,77,56,84,20,136,96,252,140
30076,Saint-Germain-Laval,77409,77,255,811,235,915,545,1695,1066
30077,Saint-Germain-Laxis,77410,77,39,234,75,184,193,452,273
30078,Saint-Germain-sous-Doue,77411,77,44,166,36,148,92,276,210
30079,Saint-Germain-sur-École,77412,77,40,72,56,124,68,248,112
30080,Saint-Germain-sur-Morin,77413,77,268,1017,277,1010,846,2133,1285
30081,Saint-Hilliers,77414,77,44,92,64,192,68,324,136
30082,Saint-Jean-les-Deux-Jumeaux,77415,77,79,287,134,343,274,751,366
30083,Saint-Just-en-Brie,77416,77,17,53,17,94,21,132,70
30084,Saint-Léger,77417,77,15,80,15,85,60,160,95
30085,Saint-Loup-de-Naud,77418,77,100,236,80,336,152,568,336
30086,Saint-Mammès,77419,77,423,710,285,1019,612,1916,1133
30087,Saint-Mard,77420,77,275,1120,365,1290,755,2410,1395
30088,Saint-Mars-Vieux-Maisons,77421,77,35,60,34,77,38,149,95
30089,Saint-Martin-des-Champs,77423,77,55,175,55,245,140,440,230
30090,Saint-Martin-du-Boschet,77424,77,32,104,20,68,64,152,136
30091,Saint-Martin-en-Bière,77425,77,100,190,75,300,115,490,290
30092,Saint-Méry,77426,77,44,112,28,116,72,216,156
30093,Saint-Mesmes,77427,77,16,204,32,212,144,388,220
30094,Saint-Ouen-en-Brie,77428,77,45,205,60,335,180,575,250
30095,Saint-Ouen-sur-Morin,77429,77,60,150,35,200,105,340,210
30096,Saint-Pathus,77430,77,263,1811,690,1835,1259,3784,2074
30097,Saint-Pierre-lès-Nemours,77431,77,825,1230,415,1874,939,3228,2055
30098,Saint-Rémy-la-Vanne,77432,77,110,293,107,329,175,611,403
30099,Saints,77433,77,108,352,160,452,288,900,460
30100,Saint-Sauveur-lès-Bray,77434,77,64,64,20,120,76,216,128
30101,Saint-Sauveur-sur-École,77435,77,146,241,58,403,165,626,387
30102,Saint-Siméon,77436,77,72,256,76,316,172,564,328
30103,Saint-Soupplets,77437,77,148,939,300,1055,709,2064,1087
30104,Saint-Thibault-des-Vignes,77438,77,292,1649,954,2011,1233,4198,1941
30105,Salins,77439,77,83,314,56,279,185,520,397
30106,Sammeron,77440,77,68,308,100,408,188,696,376
30107,Samois-sur-Seine,77441,77,251,490,120,864,289,1273,741
30108,Samoreau,77442,77,274,549,220,775,383,1378,823
30109,Sancy,77443,77,34,130,35,115,80,230,164
30110,Sancy-lès-Provins,77444,77,60,95,5,100,65,170,155
30111,Savigny-le-Temple,77445,77,1045,10463,3988,7480,6763,18231,11508
30112,Savins,77446,77,68,180,24,180,144,348,248
30113,Seine-Port,77447,77,240,355,175,700,310,1185,595
30114,Sept-Sorts,77448,77,33,148,24,142,86,252,181
30115,Serris,77449,77,176,2231,1896,1610,2398,5904,2407
30116,Servon,77450,77,245,875,335,1028,634,1997,1120
30117,Signy-Signets,77451,77,49,139,55,219,93,367,188
30118,Sigy,77452,77,5,15,0,20,10,30,20
30119,Sivry-Courtry,77453,77,54,380,105,441,250,796,434
30120,Sognolles-en-Montois,77454,77,44,168,28,68,112,208,212
30121,Soignolles-en-Brie,77455,77,115,539,225,695,428,1348,654
30122,Soisy-Bouy,77456,77,84,228,70,295,168,533,312
30123,Solers,77457,77,28,364,160,432,308,900,392
30124,Souppes-sur-Loing,77458,77,565,1540,520,1743,932,3195,2105
30125,Sourdun,77459,77,114,475,115,404,310,829,589
30126,Tancrou,77460,77,35,104,30,95,74,199,139
30127,Thénisy,77461,77,20,90,5,110,70,185,110
30128,Thieux,77462,77,30,225,145,248,164,557,255
30129,Thomery,77463,77,404,943,321,1245,587,2153,1347
30130,Thorigny-sur-Marne,77464,77,781,2444,1130,2852,1982,5964,3225
30131,Thoury-Férottes,77465,77,50,180,85,240,115,440,230
30132,Tigeaux,77466,77,32,76,48,152,56,256,108
30133,La Tombe,77467,77,5,45,25,105,45,175,50
30134,Torcy,77468,77,869,7170,3584,6302,5221,15107,8039
30135,Touquin,77469,77,74,325,80,410,245,735,399
30136,Tournan-en-Brie,77470,77,566,2279,1093,2478,1685,5256,2845
30137,Tousson,77471,77,30,60,38,130,76,244,90
30138,La Trétoire,77472,77,33,154,39,135,77,251,187
30139,Treuzy-Levelay,77473,77,44,100,52,152,96,300,144
30140,Trilbardou,77474,77,12,196,108,168,216,492,208
30141,Trilport,77475,77,389,1345,536,1721,917,3174,1734
30142,Trocy-en-Multien,77476,77,0,60,52,92,32,176,60
30143,Ury,77477,77,110,190,20,350,150,520,300
30144,Ussy-sur-Marne,77478,77,115,298,117,253,169,539,413
30145,Vaires-sur-Marne,77479,77,1514,3745,1474,3977,2595,8046,5259
30146,Valence-en-Brie,77480,77,56,245,48,228,176,452,301
30147,Vanvillé,77481,77,8,29,12,71,24,107,37
30148,Varennes-sur-Seine,77482,77,530,817,368,990,544,1902,1347
30149,Varreddes,77483,77,236,460,183,559,349,1091,696
30150,Vaucourtois,77484,77,4,68,40,72,40,152,72
30151,Le Vaudoué,77485,77,53,170,58,311,98,467,223
30152,Vaudoy-en-Brie,77486,77,34,290,50,278,165,493,324
30153,Vaux-le-Pénil,77487,77,1011,2857,1097,3953,1852,6902,3868
30154,Vaux-sur-Lunain,77489,77,9,22,9,38,18,65,31
30155,Vendrest,77490,77,60,225,83,180,200,463,285
30156,Veneux-les-Sablons,77491,77,659,1131,410,1607,836,2853,1790
30157,Verdelot,77492,77,115,135,80,250,110,440,250
30158,Verneuil-l'Étang,77493,77,202,975,355,980,662,1997,1177
30159,Vernou-la-Celle-sur-Seine,77494,77,156,736,291,885,493,1669,892
30160,Vert-Saint-Denis,77495,77,748,1881,748,2348,1339,4435,2629
30161,Vieux-Champagne,77496,77,8,54,4,54,54,112,62
30162,Vignely,77498,77,4,91,25,67,78,170,95
30163,Villebéon,77500,77,70,135,20,163,90,273,205
30164,Villecerf,77501,77,75,183,63,225,125,413,258
30165,Villemaréchal,77504,77,81,214,38,331,147,516,295
30166,Villemareuil,77505,77,20,125,35,120,115,270,145
30167,Villemer,77506,77,53,197,52,240,114,406,250
30168,Villenauxe-la-Petite,77507,77,64,135,36,179,56,271,199
30169,Villeneuve-le-Comte,77508,77,170,470,220,665,285,1170,640
30170,Villeneuve-les-Bordes,77509,77,45,150,105,215,105,425,195
30171,Villeneuve-Saint-Denis,77510,77,54,150,83,279,138,500,204
30172,Villeneuve-sous-Dammartin,77511,77,12,204,88,164,177,429,216
30173,Villeneuve-sur-Bellot,77512,77,148,284,96,404,192,692,432
30174,Villenoy,77513,77,319,1077,587,1188,945,2720,1396
30175,Villeparisis,77514,77,1762,7385,3672,6504,6191,16367,9147
30176,Villeroy,77515,77,29,210,35,245,180,460,239
30177,Ville-Saint-Jacques,77516,77,53,179,74,307,97,478,232
30178,Villevaudé,77517,77,120,519,164,532,397,1093,639
30179,Villiers-en-Bière,77518,77,5,56,5,85,50,140,61
30180,Villiers-Saint-Georges,77519,77,133,349,59,275,259,593,482
30181,Villiers-sous-Grez,77520,77,102,137,68,270,107,445,239
30182,Villiers-sur-Morin,77521,77,142,551,130,474,491,1095,693
30183,Villiers-sur-Seine,77522,77,15,80,10,145,70,225,95
30184,Villuis,77523,77,48,72,16,96,28,140,120
30185,Vimpelles,77524,77,40,125,29,184,86,299,165
30186,Vinantes,77525,77,16,105,43,99,69,211,121
30187,Vincy-Manoeuvre,77526,77,0,90,25,90,65,180,90
30188,Voinsles,77527,77,70,185,35,188,125,348,255
30189,Voisenon,77528,77,113,229,97,445,169,711,342
30190,Voulangis,77529,77,156,393,129,554,311,994,549
30191,Voulton,77530,77,47,34,39,118,20,177,81
30192,Voulx,77531,77,223,455,172,588,295,1055,678
30193,Vulaines-lès-Provins,77532,77,12,12,4,28,16,48,24
30194,Vulaines-sur-Seine,77533,77,254,694,130,1021,395,1546,948
30195,Yèbles,77534,77,37,254,63,192,212,467,291
30196,Ablis,78003,78,221,1076,279,957,765,2001,1297
30197,Achères,78005,78,1533,5692,2673,6079,4834,13586,7225
30198,Adainville,78006,78,60,214,40,323,144,507,274
30199,Aigremont,78007,78,150,339,90,465,90,645,489
30200,Allainville,78009,78,8,74,22,121,47,190,82
30201,Les Alluets-le-Roi,78010,78,120,332,84,476,196,756,452
30202,Andelu,78013,78,12,165,17,119,120,256,177
30203,Andrésy,78015,78,1355,2998,1275,3736,2557,7568,4353
30204,Arnouville-lès-Mantes,78020,78,61,259,65,281,194,540,320
30205,Aubergenville,78029,78,990,3050,1404,3407,2364,7175,4040
30206,Auffargis,78030,78,223,458,118,715,304,1137,681
30207,Auffreville-Brasseuil,78031,78,45,130,75,255,125,455,175
30208,Aulnay-sur-Mauldre,78033,78,72,262,137,424,175,736,334
30209,Auteuil,78034,78,96,242,60,334,141,535,338
30210,Autouillet,78036,78,45,88,45,218,55,318,133
30211,Bailly,78043,78,473,1110,220,1239,746,2205,1583
30212,Bazainville,78048,78,103,436,126,513,283,922,539
30213,Bazemont,78049,78,216,382,104,491,283,878,598
30214,Bazoches-sur-Guyonne,78050,78,56,140,32,196,128,356,196
30215,Béhoust,78053,78,60,110,35,160,85,280,170
30216,Bennecourt,78057,78,183,496,138,515,387,1040,679
30217,Beynes,78062,78,760,1885,767,2539,1385,4691,2645
30218,Blaru,78068,78,45,255,85,325,165,575,300
30219,Boinville-en-Mantois,78070,78,57,83,15,76,73,164,140
30220,Boinville-le-Gaillard,78071,78,48,184,36,168,164,368,232
30221,Boinvilliers,78072,78,39,58,30,100,41,171,97
30222,Bois-d'Arcy,78073,78,1063,3598,1689,3706,3150,8545,4661
30223,Boissets,78076,78,31,48,18,106,17,141,79
30224,La Boissière-École,78077,78,55,235,60,205,184,449,290
30225,Boissy-Mauvoisin,78082,78,45,170,80,155,184,419,215
30226,Boissy-sans-Avoir,78084,78,48,137,64,219,94,377,185
30227,Bonnelles,78087,78,155,495,180,727,350,1257,650
30228,Bonnières-sur-Seine,78089,78,451,1315,526,1214,929,2669,1766
30229,Bouafle,78090,78,228,529,200,645,437,1282,757
30230,Bougival,78092,78,929,2412,951,2321,2082,5354,3341
30231,Bourdonné,78096,78,80,85,60,210,70,340,165
30232,Breuil-Bois-Robert,78104,78,52,156,120,244,104,468,208
30233,Bréval,78107,78,190,475,152,640,323,1115,665
30234,Les Bréviaires,78108,78,79,255,145,509,249,903,334
30235,Brueil-en-Vexin,78113,78,24,200,72,204,181,457,224
30236,Buc,78117,78,642,1460,611,1679,1155,3445,2102
30237,Buchelay,78118,78,244,855,340,734,670,1744,1099
30238,Bullion,78120,78,110,437,159,674,308,1141,547
30239,Carrières-sous-Poissy,78123,78,743,4245,2083,3935,3803,9821,4988
30240,Carrières-sur-Seine,78124,78,1068,4340,1674,4251,3583,9508,5408
30241,La Celle-les-Bordes,78125,78,54,201,46,336,151,533,255
30242,La Celle-Saint-Cloud,78126,78,2645,5961,1798,6465,4225,12488,8606
30243,Cernay-la-Ville,78128,78,134,462,69,562,335,966,596
30244,Chambourcy,78133,78,761,1577,474,1912,867,3253,2338
30245,Chanteloup-les-Vignes,78138,78,637,3372,1336,2619,2036,5991,4009
30246,Chapet,78140,78,96,341,76,440,261,777,437
30247,Châteaufort,78143,78,65,405,97,485,302,884,470
30248,Chatou,78146,78,3431,8229,2855,9412,6602,18869,11660
30249,Chaufour-lès-Bonnières,78147,78,32,132,48,112,112,272,164
30250,Chavenay,78152,78,200,560,140,655,280,1075,760
30251,Le Chesnay,78158,78,4182,6593,3046,9196,5299,17541,10775
30252,Chevreuse,78160,78,755,1271,570,1881,960,3411,2026
30253,Choisel,78162,78,90,125,50,210,60,320,215
30254,Civry-la-Forêt,78163,78,55,101,20,110,66,196,156
30255,Clairefontaine-en-Yvelines,78164,78,60,149,74,287,97,458,209
30256,Les Clayes-sous-Bois,78165,78,1842,4677,2042,5471,3512,11025,6519
30257,Coignières,78168,78,320,1200,497,1016,909,2422,1520
30258,Condé-sur-Vesgre,78171,78,75,305,85,485,195,765,380
30259,Conflans-Sainte-Honorine,78172,78,3289,9138,4109,10087,7206,21402,12427
30260,Courgent,78185,78,23,65,30,182,42,254,88
30261,Cravent,78188,78,20,155,48,165,70,283,175
30262,Crespières,78189,78,181,370,108,596,227,931,551
30263,Croissy-sur-Seine,78190,78,1083,2592,951,3368,1725,6044,3675
30264,Dammartin-en-Serve,78192,78,88,336,100,356,232,688,424
30265,Dampierre-en-Yvelines,78193,78,115,241,107,420,152,679,356
30266,Dannemarie,78194,78,30,30,15,95,30,140,60
30267,Davron,78196,78,35,80,40,130,30,200,115
30268,Drocourt,78202,78,60,165,35,190,110,335,225
30269,Ecquevilly,78206,78,404,1047,553,1162,866,2581,1451
30270,Élancourt,78208,78,1871,7302,3499,7134,5663,16296,9173
30271,Émancé,78209,78,60,236,60,356,160,576,296
30272,Épône,78217,78,718,1647,700,2075,1221,3996,2365
30273,Les Essarts-le-Roi,78220,78,663,1807,697,2245,1304,4246,2470
30274,L'Étang-la-Ville,78224,78,732,1243,290,1677,740,2707,1975
30275,Évecquemont,78227,78,80,170,90,250,170,510,250
30276,La Falaise,78230,78,25,128,56,222,93,371,153
30277,Favrieux,78231,78,20,25,10,60,25,95,45
30278,Feucherolles,78233,78,351,781,166,1021,430,1617,1132
30279,Flacourt,78234,78,6,32,6,46,25,77,38
30280,Flexanville,78236,78,25,140,46,238,96,380,165
30281,Flins-Neuve-Église,78237,78,22,28,10,48,21,79,50
30282,Flins-sur-Seine,78238,78,235,461,360,735,470,1565,696
30283,Follainville-Dennemont,78239,78,200,432,204,608,276,1088,632
30284,Fontenay-le-Fleury,78242,78,1421,3261,1795,3597,2983,8375,4682
30285,Fontenay-Mauvoisin,78245,78,46,82,46,179,36,261,128
30286,Fontenay-Saint-Père,78246,78,80,270,100,370,160,630,350
30287,Fourqueux,78251,78,435,1192,275,1520,635,2430,1627
30288,Freneuse,78255,78,451,1279,400,1302,839,2541,1730
30289,Gaillon-sur-Montcient,78261,78,50,188,80,255,114,449,238
30290,Galluis,78262,78,61,320,85,365,206,656,381
30291,Gambais,78263,78,192,668,203,916,426,1545,860
30292,Gambaiseuil,78264,78,10,0,0,44,5,49,10
30293,Garancières,78265,78,275,505,235,925,385,1545,780
30294,Gargenville,78267,78,624,1777,642,2312,1270,4224,2401
30295,Gazeran,78269,78,57,321,70,465,217,752,378
30296,Gommecourt,78276,78,70,190,25,205,165,395,260
30297,Goupillières,78278,78,20,150,55,195,85,335,170
30298,Goussonville,78281,78,40,164,92,216,112,420,204
30299,Grandchamp,78283,78,21,104,20,84,72,176,125
30300,Gressey,78285,78,65,125,35,230,70,335,190
30301,Grosrouvre,78289,78,100,251,55,376,120,551,351
30302,Guernes,78290,78,104,290,130,355,220,705,394
30303,Guerville,78291,78,213,568,188,619,435,1242,781
30304,Guitrancourt,78296,78,35,160,30,276,130,436,195
30305,Guyancourt,78297,78,993,8105,3754,7640,6367,17761,9098
30306,Hardricourt,78299,78,210,507,276,735,309,1320,717
30307,Hargeville,78300,78,20,129,29,112,87,228,149
30308,La Hauteville,78302,78,25,55,10,40,50,100,80
30309,Herbeville,78305,78,25,60,10,115,45,170,85
30310,Hermeray,78307,78,96,254,55,342,196,593,350
30311,Houdan,78310,78,410,774,501,930,640,2071,1184
30312,Houilles,78311,78,3086,8513,3948,9348,7396,20692,11599
30313,Issou,78314,78,145,1408,472,1258,984,2714,1553
30314,Jambville,78317,78,45,229,95,305,119,519,274
30315,Jeufosse,78320,78,40,100,25,170,70,265,140
30316,Jouars-Pontchartrain,78321,78,548,1367,430,1703,966,3099,1915
30317,Jouy-en-Josas,78322,78,892,1889,689,2112,1223,4024,2781
30318,Jouy-Mauvoisin,78324,78,70,105,55,275,55,385,175
30319,Jumeauville,78325,78,44,172,48,204,128,380,216
30320,Juziers,78327,78,395,908,411,1339,724,2474,1303
30321,Lainville-en-Vexin,78329,78,70,170,50,240,155,445,240
30322,Lévis-Saint-Nom,78334,78,208,325,192,667,243,1102,533
30323,Limay,78335,78,1460,4763,2191,4348,3047,9586,6223
30324,Limetz-Villez,78337,78,160,512,204,652,392,1248,672
30325,Les Loges-en-Josas,78343,78,160,446,135,450,255,840,606
30326,Lommoye,78344,78,36,172,30,212,142,384,208
30327,Longnes,78346,78,100,435,140,490,300,930,535
30328,Longvilliers,78349,78,33,117,19,156,102,277,150
30329,Louveciennes,78350,78,939,1777,549,2191,1151,3891,2716
30330,Magnanville,78354,78,644,1525,524,1784,1085,3393,2169
30331,Magny-les-Hameaux,78356,78,678,2756,828,2968,1742,5538,3434
30332,Maisons-Laffitte,78358,78,3279,5867,2469,6809,4920,14198,9146
30333,Mantes-la-Jolie,78361,78,3708,13306,7166,10452,9079,26697,17014
30334,Mantes-la-Ville,78362,78,1913,5701,2557,5246,4163,11966,7614
30335,Marcq,78364,78,56,192,72,244,156,472,248
30336,Mareil-le-Guyon,78366,78,19,86,18,133,53,204,105
30337,Mareil-Marly,78367,78,428,1092,216,1141,596,1953,1520
30338,Mareil-sur-Mauldre,78368,78,160,448,80,700,296,1076,608
30339,Marly-le-Roi,78372,78,2294,3983,1399,5419,3018,9836,6277
30340,Maule,78380,78,733,1444,420,2029,936,3385,2177
30341,Maulette,78381,78,68,263,52,234,193,479,331
30342,Maurecourt,78382,78,374,1271,415,1168,1006,2589,1645
30343,Maurepas,78383,78,2100,4840,2233,5471,3878,11582,6940
30344,Médan,78384,78,84,384,82,500,259,841,468
30345,Ménerville,78385,78,10,70,0,75,50,125,80
30346,Méré,78389,78,264,388,148,636,232,1016,652
30347,Méricourt,78391,78,28,113,34,127,80,241,141
30348,Le Mesnil-le-Roi,78396,78,640,1708,485,2179,1113,3777,2348
30349,Le Mesnil-Saint-Denis,78397,78,877,1656,526,2237,1182,3945,2533
30350,Les Mesnuls,78398,78,80,191,47,323,118,488,271
30351,Meulan-en-Yvelines,78401,78,771,2419,1307,2573,1943,5823,3190
30352,Mézières-sur-Seine,78402,78,261,977,428,1077,821,2326,1238
30353,Mézy-sur-Seine,78403,78,165,500,153,659,340,1152,665
30354,Millemont,78404,78,28,60,12,112,40,164,88
30355,Milon-la-Chapelle,78406,78,31,41,13,83,41,137,72
30356,Mittainville,78407,78,52,200,20,252,96,368,252
30357,Moisson,78410,78,93,245,50,374,132,556,338
30358,Mondreville,78413,78,20,112,60,132,88,280,132
30359,Montainville,78415,78,44,147,38,155,78,271,191
30360,Montalet-le-Bois,78416,78,31,79,21,100,56,177,110
30361,Montchauvet,78417,78,37,54,3,72,70,145,91
30362,Montesson,78418,78,1331,4204,1514,4756,3114,9384,5535
30363,Montfort-l'Amaury,78420,78,331,740,263,817,519,1599,1071
30364,Montigny-le-Bretonneux,78423,78,1433,8702,4206,10848,7760,22814,10135
30365,Morainvilliers,78431,78,242,819,191,889,505,1585,1061
30366,Mousseaux-sur-Seine,78437,78,80,143,60,332,65,457,223
30367,Mulcent,78439,78,3,25,3,25,18,46,28
30368,Les Mureaux,78440,78,2429,9652,4462,8136,5999,18597,12081
30369,Neauphle-le-Château,78442,78,249,776,391,925,715,2031,1025
30370,Neauphle-le-Vieux,78443,78,60,324,56,259,257,572,384
30371,Neauphlette,78444,78,55,231,70,305,170,545,286
30372,Nézel,78451,78,92,326,116,296,257,669,418
30373,Noisy-le-Roi,78455,78,1155,1973,496,2808,1096,4400,3128
30374,Oinville-sur-Montcient,78460,78,118,252,117,419,145,681,370
30375,Orcemont,78464,78,51,249,90,327,125,542,300
30376,Orgerus,78465,78,297,516,160,949,333,1442,813
30377,Orgeval,78466,78,656,1882,374,1877,1093,3344,2538
30378,Orphin,78470,78,95,210,100,380,125,605,305
30379,Orsonville,78472,78,10,95,25,120,70,215,105
30380,Orvilliers,78474,78,92,216,76,196,140,412,308
30381,Osmoy,78475,78,15,80,40,175,55,270,95
30382,Paray-Douaville,78478,78,8,79,34,53,63,150,87
30383,Le Pecq,78481,78,2392,4070,1458,5130,2998,9586,6462
30384,Perdreauville,78484,78,30,195,50,238,125,413,225
30385,Le Perray-en-Yvelines,78486,78,933,1480,807,2201,1219,4227,2413
30386,Plaisir,78490,78,2004,8826,3884,9130,6937,19951,10830
30387,Poigny-la-Forêt,78497,78,49,201,50,354,149,553,250
30388,Poissy,78498,78,3887,9137,4979,9799,8281,23059,13024
30389,Ponthévrard,78499,78,45,215,35,165,160,360,260
30390,Porcheville,78501,78,265,815,380,940,490,1810,1080
30391,Le Port-Marly,78502,78,318,1473,631,1347,1377,3355,1791
30392,Port-Villez,78503,78,10,90,0,125,45,170,100
30393,Prunay-le-Temple,78505,78,12,131,24,161,85,270,143
30394,Prunay-en-Yvelines,78506,78,75,190,42,299,161,502,265
30395,La Queue-les-Yvelines,78513,78,260,448,264,704,332,1300,708
30396,Raizeux,78516,78,40,224,80,368,168,616,264
30397,Rambouillet,78517,78,3081,6141,3028,7855,4875,15758,9222
30398,Rennemoulin,78518,78,0,30,10,40,30,80,30
30399,Richebourg,78520,78,80,330,105,519,207,831,410
30400,Rochefort-en-Yvelines,78522,78,64,232,52,336,212,600,296
30401,Rocquencourt,78524,78,632,541,241,1186,414,1841,1173
30402,Rolleboise,78528,78,36,100,28,128,96,252,136
30403,Rosay,78530,78,30,70,30,150,80,260,100
30404,Rosny-sur-Seine,78531,78,455,1732,597,1837,1186,3620,2187
30405,Sailly,78536,78,15,123,25,132,80,237,138
30406,Saint-Arnoult-en-Yvelines,78537,78,703,1531,589,2021,1232,3842,2234
30407,Saint-Cyr-l'École,78545,78,1394,5104,2619,4398,4328,11345,6498
30408,Saint-Forget,78548,78,57,103,35,196,65,296,160
30409,Saint-Germain-de-la-Grange,78550,78,160,472,164,723,309,1196,632
30410,Saint-Germain-en-Laye,78551,78,4676,9844,4149,11431,8103,23683,14520
30411,Saint-Hilarion,78557,78,90,196,98,284,143,525,286
30412,Saint-Illiers-la-Ville,78558,78,26,82,25,116,47,188,108
30413,Saint-Illiers-le-Bois,78559,78,50,135,20,145,85,250,185
30414,Saint-Lambert,78561,78,30,105,39,178,90,307,135
30415,Saint-Léger-en-Yvelines,78562,78,125,359,130,553,221,904,484
30416,Saint-Martin-de-Bréthencourt,78564,78,70,182,38,198,117,353,252
30417,Saint-Martin-des-Champs,78565,78,50,80,20,95,65,180,130
30418,Saint-Martin-la-Garenne,78567,78,104,301,90,279,223,592,405
30419,Sainte-Mesme,78569,78,93,204,35,286,162,483,297
30420,Saint-Nom-la-Bretèche,78571,78,695,1365,319,1842,713,2874,2060
30421,Saint-Rémy-lès-Chevreuse,78575,78,895,1630,706,2589,1216,4511,2525
30422,Saint-Rémy-l'Honoré,78576,78,132,349,137,490,217,844,481
30423,Sartrouville,78586,78,4734,13457,6496,15000,10883,32379,18191
30424,Saulx-Marchais,78588,78,40,256,144,284,192,620,296
30425,Senlisse,78590,78,80,110,20,180,110,310,190
30426,Septeuil,78591,78,196,555,159,730,450,1339,751
30427,Soindres,78597,78,35,215,45,210,170,425,250
30428,Sonchamp,78601,78,159,352,150,584,265,999,511
30429,Tacoignières,78605,78,140,275,90,350,180,620,415
30430,Le Tartre-Gaudran,78606,78,0,0,4,20,0,24,0
30431,Le Tertre-Saint-Denis,78608,78,8,32,12,32,28,72,40
30432,Tessancourt-sur-Aubette,78609,78,86,269,57,351,204,612,355
30433,Thiverval-Grignon,78615,78,60,156,92,280,132,504,216
30434,Thoiry,78616,78,112,396,117,375,306,798,508
30435,Tilly,78618,78,65,155,30,165,105,300,220
30436,Toussus-le-Noble,78620,78,16,401,112,313,290,715,417
30437,Trappes,78621,78,1581,10534,4809,7671,6813,19293,12115
30438,Le Tremblay-sur-Mauldre,78623,78,49,218,64,292,218,574,267
30439,Triel-sur-Seine,78624,78,1101,3209,1266,3592,2424,7282,4310
30440,Vaux-sur-Seine,78638,78,350,1218,500,1512,929,2941,1568
30441,Vélizy-Villacoublay,78640,78,2732,4606,2603,6017,4083,12703,7338
30442,Verneuil-sur-Seine,78642,78,1429,3943,1571,4849,2866,9286,5372
30443,Vernouillet,78643,78,668,2826,1043,3023,1785,5851,3494
30444,La Verrière,78644,78,325,1790,720,1421,1241,3382,2115
30445,Versailles,78646,78,10590,21460,10321,23093,16678,50092,32050
30446,Vert,78647,78,108,208,64,268,168,500,316
30447,Le Vésinet,78650,78,2315,4110,1414,4857,2891,9162,6425
30448,Vicq,78653,78,31,91,25,94,86,205,122
30449,Vieille-Église-en-Yvelines,78655,78,104,175,60,264,115,439,279
30450,La Villeneuve-en-Chevrie,78668,78,21,178,29,215,127,371,199
30451,Villennes-sur-Seine,78672,78,452,1490,368,1760,1028,3156,1942
30452,Villepreux,78674,78,1037,2850,1037,3075,1862,5974,3887
30453,Villette,78677,78,50,114,45,234,73,352,164
30454,Villiers-le-Mahieu,78681,78,84,184,44,200,176,420,268
30455,Villiers-Saint-Frédéric,78683,78,209,638,313,1072,438,1823,847
30456,Viroflay,78686,78,1761,3979,1770,4440,3297,9507,5740
30457,Voisins-le-Bretonneux,78688,78,756,3151,1312,3863,2124,7299,3907
30458,L'Absie,79001,79,197,180,60,367,110,537,377
30459,Adilly,79002,79,33,71,12,105,49,166,104
30460,Aiffres,79003,79,596,1306,366,2059,940,3365,1902
30461,Aigonnay,79004,79,34,197,67,160,129,356,231
30462,Airvault,79005,79,537,551,270,1069,445,1784,1088
30463,Les Alleuds,79006,79,60,28,32,96,48,176,88
30464,Allonne,79007,79,80,165,50,230,140,420,245
30465,Amailloux,79008,79,146,202,50,217,181,448,348
30466,Amuré,79009,79,30,136,10,155,111,276,166
30467,Arçais,79010,79,90,95,70,255,75,400,185
30468,Ardilleux,79011,79,35,40,20,40,30,90,75
30469,Ardin,79012,79,111,311,78,430,225,733,422
30470,Argentonnay,79013,79,480,760,220,975,585,1780,1240
30471,Argenton-l'Église,79014,79,192,400,88,564,360,1012,592
30472,Asnières-en-Poitou,79015,79,58,30,4,56,29,89,88
30473,Assais-les-Jumeaux,79016,79,104,192,72,256,168,496,296
30474,Aubigné,79018,79,43,17,22,93,12,127,60
30475,Aubigny,79019,79,32,32,4,72,36,112,64
30476,Augé,79020,79,136,252,68,256,232,556,388
30477,Availles-Thouarsais,79022,79,41,34,16,58,20,94,75
30478,Avon,79023,79,20,15,10,20,15,45,35
30479,Azay-le-Brûlé,79024,79,180,448,172,604,416,1192,628
30480,Azay-sur-Thouet,79025,79,159,293,65,326,226,617,452
30481,La Bataille,79027,79,15,20,5,35,10,50,35
30482,Beaulieu-sous-Parthenay,79029,79,80,145,80,240,120,440,225
30483,Beaussais-Vitré,79030,79,113,260,32,332,210,574,373
30484,Beauvoir-sur-Niort,79031,79,230,400,180,525,365,1070,630
30485,Béceleuf,79032,79,56,180,52,184,140,376,236
30486,Belleville,79033,79,0,49,4,33,37,74,49
30487,Bessines,79034,79,181,380,89,515,371,975,561
30488,Le Beugnon,79035,79,75,53,15,97,31,143,128
30489,Boismé,79038,79,166,292,103,369,190,662,458
30490,Boisserolles,79039,79,20,0,0,20,5,25,20
30491,La Boissière-en-Gâtine,79040,79,35,40,10,95,55,160,75
30492,Bougon,79042,79,20,18,34,59,16,109,38
30493,Bouillé-Loretz,79043,79,123,228,143,308,165,616,351
30494,Bouillé-Saint-Paul,79044,79,70,115,5,120,70,195,185
30495,Bouin,79045,79,30,30,5,45,30,80,60
30496,Le Bourdet,79046,79,45,165,40,160,155,355,210
30497,Boussais,79047,79,92,88,32,132,80,244,180
30498,La Crèche,79048,79,639,1226,480,1949,994,3423,1865
30499,Bressuire,79049,79,2409,4584,2021,6157,3504,11682,6993
30500,Bretignolles,79050,79,30,161,65,241,125,431,191
30501,Le Breuil-Bernard,79051,79,57,122,33,152,101,286,179
30502,Brie,79054,79,30,30,15,78,35,128,60
30503,Brieuil-sur-Chizé,79055,79,4,4,4,28,4,36,8
30504,Brion-près-Thouet,79056,79,104,176,112,260,108,480,280
30505,Brioux-sur-Boutonne,79057,79,280,295,100,501,209,810,575
30506,Brûlain,79058,79,80,185,96,192,157,445,265
30507,Le Busseau,79059,79,145,170,55,225,140,420,315
30508,Caunay,79060,79,40,17,12,58,25,95,57
30509,Celles-sur-Belle,79061,79,472,868,384,1151,698,2233,1340
30510,Cerizay,79062,79,670,1177,432,1379,963,2774,1847
30511,Cersay,79063,79,188,255,95,275,180,550,443
30512,Chail,79064,79,104,115,30,175,80,285,219
30513,Champdeniers-Saint-Denis,79066,79,279,315,115,523,215,853,594
30514,Chantecorps,79068,79,36,80,0,116,96,212,116
30515,Chanteloup,79069,79,106,244,101,308,174,583,350
30516,La Chapelle-Bâton,79070,79,60,95,45,130,60,235,155
30517,La Chapelle-Bertrand,79071,79,40,135,30,194,90,314,175
30518,La Chapelle-Pouilloux,79074,79,12,29,8,77,33,118,41
30519,La Chapelle-Saint-Étienne,79075,79,35,50,60,135,50,245,85
30520,La Chapelle-Saint-Laurent,79076,79,280,479,170,593,380,1143,759
30521,La Chapelle-Thireuil,79077,79,34,93,24,157,59,240,127
30522,Prissé-la-Charrière,79078,79,72,164,64,172,184,420,236
30523,Mauléon,79079,79,990,2245,859,2491,1604,4954,3235
30524,Châtillon-sur-Thouet,79080,79,555,503,180,903,374,1457,1058
30525,Chauray,79081,79,608,1640,644,2513,1273,4430,2248
30526,Chef-Boutonne,79083,79,509,379,125,716,190,1031,888
30527,Chenay,79084,79,80,88,36,208,76,320,168
30528,Chérigné,79085,79,24,16,24,84,8,116,40
30529,Cherveux,79086,79,86,548,163,439,415,1017,634
30530,Chey,79087,79,90,151,30,211,105,346,241
30531,Chiché,79088,79,240,415,155,489,314,958,655
30532,Le Chillou,79089,79,55,35,10,35,45,90,90
30533,Chizé,79090,79,119,170,70,280,115,465,289
30534,Cirières,79091,79,120,276,72,316,212,600,396
30535,Clavé,79092,79,68,92,40,88,64,192,160
30536,Clessé,79094,79,170,225,80,295,165,540,395
30537,Clussais-la-Pommeraie,79095,79,125,125,35,235,90,360,250
30538,Combrand,79096,79,132,316,76,440,208,724,448
30539,La Couarde,79098,79,28,56,28,80,68,176,84
30540,Coulon,79100,79,274,499,145,862,394,1401,773
30541,Coulonges-sur-l'Autize,79101,79,405,500,150,815,315,1280,905
30542,Coulonges-Thouarsais,79102,79,80,133,25,105,105,235,213
30543,Courlay,79103,79,264,548,250,879,449,1578,812
30544,Cours,79104,79,40,148,60,176,108,344,188
30545,Coutières,79105,79,20,56,0,52,36,88,76
30546,Couture-d'Argenson,79106,79,75,60,5,202,35,242,135
30547,Crézières,79107,79,6,3,3,21,6,30,9
30548,Doux,79108,79,35,42,12,74,15,101,77
30549,Échiré,79109,79,487,769,152,1161,628,1941,1256
30550,Ensigné,79111,79,22,46,42,111,26,179,68
30551,Épannes,79112,79,70,233,44,257,193,494,303
30552,Exireuil,79114,79,251,434,160,497,275,932,685
30553,Exoudun,79115,79,116,144,40,196,128,364,260
30554,Faye-l'Abbesse,79116,79,150,230,75,285,195,555,380
30555,Faye-sur-Ardin,79117,79,35,175,50,185,150,385,210
30556,Fénery,79118,79,75,60,20,85,50,155,135
30557,Fenioux,79119,79,200,85,45,215,90,350,285
30558,La Ferrière-en-Parthenay,79120,79,80,193,86,238,133,457,273
30559,Fomperron,79121,79,30,130,40,130,104,274,160
30560,Fontenille-Saint-Martin-d'Entraigues,79122,79,85,107,25,249,86,360,192
30561,La Forêt-sur-Sèvre,79123,79,304,578,230,676,425,1331,882
30562,Les Forges,79124,79,15,40,15,60,20,95,55
30563,Fors,79125,79,112,508,152,588,412,1152,620
30564,Les Fosses,79126,79,39,109,47,108,79,234,148
30565,La Foye-Monjault,79127,79,94,188,31,255,174,460,282
30566,François,79128,79,60,252,56,384,216,656,312
30567,Fressines,79129,79,104,448,124,505,419,1048,552
30568,Frontenay-Rohan-Rohan,79130,79,310,660,175,1103,569,1847,970
30569,Geay,79131,79,10,60,40,135,75,250,70
30570,Genneton,79132,79,50,92,3,85,54,142,142
30571,Germond-Rouvre,79133,79,100,308,120,364,280,764,408
30572,Glénay,79134,79,80,144,20,196,112,328,224
30573,Gourgé,79135,79,191,218,53,272,151,476,409
30574,Gournay-Loizé,79136,79,70,120,45,255,85,385,190
30575,Granzay-Gript,79137,79,40,230,90,345,185,620,270
30576,Les Groseillers,79139,79,6,0,13,21,0,34,6
30577,Hanc,79140,79,76,35,10,90,35,135,111
30578,Irais,79141,79,25,30,5,105,30,140,55
30579,Juillé,79142,79,20,25,5,35,25,65,45
30580,Juscorps,79144,79,35,100,40,125,80,245,135
30581,Lageon,79145,79,40,86,25,74,81,180,126
30582,Largeasse,79147,79,136,148,61,226,107,394,284
30583,Lezay,79148,79,569,334,106,688,204,998,903
30584,Lhoumois,79149,79,20,32,16,60,24,100,52
30585,Limalonges,79150,79,140,155,40,290,125,455,295
30586,Lorigné,79152,79,69,42,20,85,50,155,111
30587,Loubigné,79153,79,34,28,16,24,20,60,62
30588,Loubillé,79154,79,82,67,24,135,55,214,149
30589,Louin,79156,79,130,165,30,284,117,431,295
30590,Louzy,79157,79,84,358,113,423,280,816,442
30591,Luché-sur-Brioux,79158,79,30,35,0,50,20,70,65
30592,Luché-Thouarsais,79159,79,36,160,52,124,124,300,196
30593,Lusseray,79160,79,35,20,20,70,15,105,55
30594,Luzay,79161,79,25,144,84,209,110,403,169
30595,Magné,79162,79,385,441,173,1249,356,1778,826
30596,Mairé-Levescault,79163,79,88,108,68,216,92,376,196
30597,Maisonnay,79164,79,20,45,25,71,53,149,65
30598,Maisontiers,79165,79,30,35,20,60,10,90,65
30599,Marigny,79166,79,65,230,40,350,170,560,295
30600,Marnes,79167,79,45,36,0,104,31,135,81
30601,Massais,79168,79,49,196,75,139,131,345,245
30602,Mauzé-sur-le-Mignon,79170,79,439,615,223,841,485,1549,1054
30603,Mauzé-Thouarsais,79171,79,244,540,192,692,508,1392,784
30604,Mazières-en-Gâtine,79172,79,125,215,130,354,165,649,340
30605,Mazières-sur-Béronne,79173,79,50,70,15,150,90,255,120
30606,Melle,79174,79,706,815,190,1107,508,1805,1521
30607,Melleran,79175,79,95,94,10,219,94,323,189
30608,Ménigoute,79176,79,150,128,41,304,108,453,278
30609,Messé,79177,79,24,24,16,104,20,140,48
30610,Missé,79178,79,105,170,55,360,155,570,275
30611,Moncoutant,79179,79,482,717,319,979,546,1844,1199
30612,Montalembert,79180,79,59,23,12,85,39,136,82
30613,Montravers,79183,79,50,100,20,90,105,215,150
30614,La Mothe-Saint-Héray,79184,79,240,375,165,560,230,955,615
30615,Mougon,79185,79,219,625,115,565,540,1220,844
30616,Moutiers-sous-Chantemerle,79188,79,124,116,24,204,124,352,240
30617,Nanteuil,79189,79,190,470,105,550,345,1000,660
30618,Neuvy-Bouin,79190,79,83,102,12,189,67,268,185
30619,Niort,79191,79,8161,12462,7304,17731,10679,35714,20623
30620,Nueil-les-Aubiers,79195,79,597,1468,520,1691,1051,3262,2065
30621,Oiron,79196,79,155,180,25,209,130,364,335
30622,Oroux,79197,79,25,20,5,40,10,55,45
30623,Paizay-le-Chapt,79198,79,45,60,10,85,55,150,105
30624,Paizay-le-Tort,79199,79,52,118,17,168,80,265,170
30625,Pamplie,79200,79,74,55,5,99,35,139,129
30626,Pamproux,79201,79,318,351,89,581,220,890,669
30627,Parthenay,79202,79,1966,2070,896,3357,1618,5871,4036
30628,Pas-de-Jeu,79203,79,71,88,56,92,45,193,159
30629,Périgné,79204,79,216,264,88,264,172,524,480
30630,Pers,79205,79,8,20,4,40,12,56,28
30631,La Petite-Boissière,79207,79,40,153,71,222,97,390,193
30632,La Peyratte,79208,79,186,233,39,359,189,587,419
30633,Pierrefitte,79209,79,56,111,24,72,73,169,167
30634,Le Pin,79210,79,101,259,81,296,226,603,360
30635,Pioussay,79211,79,75,39,16,86,36,138,114
30636,Pliboux,79212,79,40,44,20,76,44,140,84
30637,Pompaire,79213,79,245,365,145,888,320,1353,610
30638,Pouffonds,79214,79,65,123,35,135,74,244,188
30639,Pougne-Hérisson,79215,79,68,100,32,96,80,208,168
30640,Prahecq,79216,79,178,513,153,721,416,1290,691
30641,Prailles,79217,79,84,168,64,173,130,367,252
30642,Pressigny,79218,79,5,60,10,85,45,140,65
30643,Priaires,79219,79,5,15,5,60,25,90,20
30644,Prin-Deyrançon,79220,79,95,175,30,185,115,330,270
30645,Pugny,79222,79,45,55,0,60,60,120,100
30646,Puihardy,79223,79,0,15,0,20,15,35,15
30647,Reffannes,79225,79,31,82,24,84,54,162,113
30648,Le Retail,79226,79,36,56,36,104,52,192,92
30649,La Rochénard,79229,79,35,165,10,150,145,305,200
30650,Rom,79230,79,151,193,45,317,162,524,344
30651,Romans,79231,79,27,212,57,183,186,426,239
30652,Saint-Amand-sur-Sèvre,79235,79,105,387,109,449,259,817,492
30653,Saint-André-sur-Sèvre,79236,79,17,185,67,228,118,413,202
30654,Saint-Aubin-du-Plain,79238,79,90,140,55,190,70,315,230
30655,Saint-Aubin-le-Cloud,79239,79,228,386,111,669,275,1055,614
30656,Sainte-Blandine,79240,79,60,208,72,208,156,436,268
30657,Saint-Christophe-sur-Roc,79241,79,84,140,60,168,104,332,224
30658,Voulmentin,79242,79,117,289,80,337,201,618,406
30659,Saint-Coutant,79243,79,56,52,12,104,56,172,108
30660,Saint-Cyr-la-Lande,79244,79,36,94,27,95,62,184,130
30661,Sainte-Eanne,79246,79,47,173,36,209,129,374,220
30662,Saint-Étienne-la-Cigogne,79247,79,28,48,0,20,37,57,76
30663,Saint-Gelais,79249,79,199,485,130,683,445,1258,684
30664,Sainte-Gemme,79250,79,32,128,24,124,80,228,160
30665,Saint-Génard,79251,79,45,100,35,95,60,190,145
30666,Saint-Généroux,79252,79,45,115,25,120,80,225,160
30667,Saint-Georges-de-Noisné,79253,79,128,180,92,196,128,416,308
30668,Saint-Georges-de-Rex,79254,79,45,98,12,115,84,211,143
30669,Saint-Germain-de-Longue-Chaume,79255,79,72,104,36,152,60,248,176
30670,Saint-Germier,79256,79,32,43,8,60,47,115,75
30671,Saint-Hilaire-la-Palud,79257,79,268,372,88,592,280,960,640
30672,Saint-Jacques-de-Thouars,79258,79,36,125,55,137,59,251,161
30673,Saint-Jean-de-Thouars,79259,79,207,291,77,474,235,786,498
30674,Saint-Jouin-de-Marnes,79260,79,135,110,45,165,110,320,245
30675,Saint-Jouin-de-Milly,79261,79,15,45,15,65,50,130,60
30676,Saint-Laurs,79263,79,114,142,45,112,101,258,256
30677,Saint-Léger-de-la-Martinière,79264,79,253,142,38,362,122,522,395
30678,Saint-Léger-de-Montbrun,79265,79,85,330,115,440,295,850,415
30679,Saint-Lin,79267,79,45,70,15,144,50,209,115
30680,Saint-Loup-Lamairé,79268,79,189,173,44,328,148,520,362
30681,Saint-Maixent-de-Beugné,79269,79,21,87,33,140,57,230,108
30682,Saint-Maixent-l'École,79270,79,1118,1371,595,1591,1083,3269,2489
30683,Saint-Marc-la-Lande,79271,79,60,56,32,80,48,160,116
30684,Saint-Martin-de-Bernegoue,79273,79,60,180,70,310,145,525,240
30685,Saint-Martin-de-Mâcon,79274,79,60,70,40,80,60,180,130
30686,Saint-Martin-de-Saint-Maixent,79276,79,85,310,100,415,185,700,395
30687,Saint-Martin-de-Sanzay,79277,79,91,296,57,273,223,553,387
30688,Saint-Martin-du-Fouilloux,79278,79,32,39,8,60,55,123,71
30689,Saint-Martin-lès-Melle,79279,79,108,164,64,308,96,468,272
30690,Saint Maurice Étusson,79280,79,126,199,106,286,135,527,325
30691,Saint-Maxire,79281,79,73,329,82,436,271,789,402
30692,Saint-Médard,79282,79,10,15,5,55,15,75,25
30693,Sainte-Néomaye,79283,79,55,390,85,500,315,900,445
30694,Sainte-Ouenne,79284,79,55,250,100,230,190,520,305
30695,Saint-Pardoux,79285,79,230,380,75,490,360,925,610
30696,Saint-Paul-en-Gâtine,79286,79,70,105,35,155,80,270,175
30697,Saint-Pierre-des-Échaubrognes,79289,79,135,425,110,389,274,773,560
30698,Saint-Pompain,79290,79,125,245,90,280,185,555,370
30699,Sainte-Radegonde,79292,79,419,345,145,690,240,1075,764
30700,Saint-Rémy,79293,79,130,300,73,339,192,604,430
30701,Saint-Romans-des-Champs,79294,79,16,52,16,60,32,108,68
30702,Saint-Romans-lès-Melle,79295,79,96,172,40,248,156,444,268
30703,Sainte-Soline,79297,79,102,43,12,109,44,165,145
30704,Saint-Symphorien,79298,79,128,504,128,760,376,1264,632
30705,Saint-Varent,79299,79,390,525,175,780,465,1420,915
30706,Sainte-Verge,79300,79,225,270,105,525,250,880,495
30707,Saint-Vincent-la-Châtre,79301,79,104,191,68,196,124,388,295
30708,Saivres,79302,79,171,346,55,500,267,822,517
30709,Salles,79303,79,35,85,25,125,60,210,120
30710,Sansais,79304,79,59,165,40,307,150,497,224
30711,Saurais,79306,79,28,60,8,48,56,112,88
30712,Sauzé-Vaussais,79307,79,395,305,132,560,209,901,700
30713,Sciecq,79308,79,120,160,20,185,135,340,280
30714,Scillé,79309,79,63,53,24,157,45,226,116
30715,Secondigné-sur-Belle,79310,79,76,112,36,176,120,332,188
30716,Secondigny,79311,79,389,395,163,545,260,968,784
30717,Séligné,79312,79,23,10,6,41,9,56,33
30718,Sepvret,79313,79,70,175,35,220,110,365,245
30719,Sompt,79314,79,42,100,12,81,76,169,142
30720,Soudan,79316,79,45,100,65,145,70,280,145
30721,Soutiers,79318,79,10,80,45,64,65,174,90
30722,Souvigné,79319,79,95,220,40,320,200,560,315
30723,Surin,79320,79,60,204,40,164,192,396,264
30724,Taizé-Maulais,79321,79,105,170,70,300,115,485,275
30725,Le Tallud,79322,79,265,455,110,805,350,1265,720
30726,Tessonnière,79325,79,50,60,5,110,65,180,110
30727,Thénezay,79326,79,219,318,103,489,152,744,537
30728,Thorigné,79327,79,140,335,80,460,250,790,475
30729,Thorigny-sur-le-Mignon,79328,79,10,35,5,20,25,50,45
30730,Thouars,79329,79,1819,1696,899,3007,1330,5236,3515
30731,Tillou,79330,79,55,69,21,77,76,174,124
30732,Tourtenay,79331,79,15,35,0,30,35,65,50
30733,Trayes,79332,79,4,44,20,52,32,104,48
30734,Usseau,79334,79,68,252,44,324,216,584,320
30735,Vallans,79335,79,52,214,52,264,202,518,266
30736,Vançais,79336,79,60,31,5,120,10,135,91
30737,Le Vanneau-Irleau,79337,79,92,224,48,308,192,548,316
30738,Vanzay,79338,79,35,28,9,67,18,94,63
30739,Vasles,79339,79,275,340,115,605,275,995,615
30740,Vausseroux,79340,79,68,72,56,72,56,184,140
30741,Vautebis,79341,79,30,25,0,40,25,65,55
30742,Vernoux-en-Gâtine,79342,79,136,108,32,180,92,304,244
30743,Vernoux-sur-Boutonne,79343,79,20,49,16,90,38,144,69
30744,Verruyes,79345,79,185,210,85,280,125,490,395
30745,Le Vert,79346,79,35,35,5,30,25,60,70
30746,Viennay,79347,79,112,258,101,337,201,639,370
30747,Villefollet,79348,79,33,36,13,77,4,94,69
30748,Villemain,79349,79,44,19,9,47,10,66,63
30749,Villiers-en-Bois,79350,79,30,23,9,27,17,53,53
30750,Villiers-en-Plaine,79351,79,140,504,140,472,452,1064,644
30751,Villiers-sur-Chizé,79352,79,30,20,15,75,5,95,50
30752,Vouhé,79354,79,70,90,5,135,75,215,160
30753,Vouillé,79355,79,360,785,190,1267,605,2062,1145
30754,Xaintray,79357,79,25,60,0,95,55,150,85
30755,Abbeville,80001,80,3125,5502,2733,7572,3842,14147,8627
30756,Ablaincourt-Pressoir,80002,80,45,55,30,85,35,150,100
30757,Acheux-en-Amiénois,80003,80,52,198,40,152,141,333,250
30758,Acheux-en-Vimeu,80004,80,58,134,34,128,112,274,192
30759,Agenville,80005,80,17,44,3,24,19,46,61
30760,Agenvillers,80006,80,24,48,4,56,60,120,72
30761,Aigneville,80008,80,104,219,94,213,177,484,323
30762,Ailly-le-Haut-Clocher,80009,80,100,270,104,282,205,591,370
30763,Ailly-sur-Noye,80010,80,390,765,245,905,555,1705,1155
30764,Ailly-sur-Somme,80011,80,347,722,265,1036,600,1901,1069
30765,Airaines,80013,80,215,600,263,662,424,1349,815
30766,Aizecourt-le-Bas,80014,80,12,20,0,12,12,24,32
30767,Aizecourt-le-Haut,80015,80,15,15,10,35,5,50,30
30768,Albert,80016,80,1552,2220,1243,3023,1617,5883,3772
30769,Allaines,80017,80,37,103,16,159,73,248,140
30770,Allenay,80018,80,40,66,20,72,56,148,106
30771,Allery,80019,80,85,193,84,203,181,468,278
30772,Allonville,80020,80,65,200,80,255,125,460,265
30773,Amiens,80021,80,12083,33296,25647,32976,24500,83123,45379
30774,Andainville,80022,80,29,49,20,61,33,114,78
30775,Andechy,80023,80,30,75,10,65,75,150,105
30776,Argoeuves,80024,80,35,125,78,225,85,388,160
30777,Argoules,80025,80,38,28,10,72,26,108,66
30778,Arguel,80026,80,10,15,0,5,10,15,25
30779,Armancourt,80027,80,0,8,4,0,8,12,8
30780,Arquèves,80028,80,10,25,30,60,25,115,35
30781,Arrest,80029,80,160,170,80,320,125,525,330
30782,Arry,80030,80,4,60,4,60,64,128,64
30783,Arvillers,80031,80,88,224,84,208,192,484,312
30784,Assainvillers,80032,80,20,35,15,45,15,75,55
30785,Assevillers,80033,80,12,80,20,94,49,163,92
30786,Athies,80034,80,35,115,45,245,90,380,150
30787,Aubercourt,80035,80,0,36,4,8,28,40,36
30788,Aubigny,80036,80,60,60,53,173,44,270,120
30789,Aubvillers,80037,80,5,40,10,25,45,80,45
30790,Auchonvillers,80038,80,12,26,16,37,21,74,38
30791,Ault,80039,80,261,284,110,661,190,961,545
30792,Aumâtre,80040,80,21,34,17,52,30,99,55
30793,Aumont,80041,80,9,29,3,43,15,61,38
30794,Autheux,80042,80,12,28,16,44,16,76,40
30795,Authie,80043,80,45,90,15,90,60,165,135
30796,Authieule,80044,80,35,110,15,153,85,253,145
30797,Authuille,80045,80,20,28,4,68,40,112,48
30798,Avelesges,80046,80,0,12,8,16,12,36,12
30799,Aveluy,80047,80,55,110,75,205,60,340,165
30800,Avesnes-Chaussoy,80048,80,0,25,0,25,15,40,25
30801,Ayencourt,80049,80,8,49,21,60,29,110,57
30802,Bacouel-sur-Selle,80050,80,53,81,32,199,49,280,134
30803,Bailleul,80051,80,68,56,28,64,48,140,124
30804,Baizieux,80052,80,8,39,53,54,16,123,47
30805,Balâtre,80053,80,4,24,16,28,24,68,28
30806,Barleux,80054,80,40,40,30,80,50,160,80
30807,Barly,80055,80,15,45,10,70,30,110,60
30808,Bavelincourt,80056,80,8,44,16,28,28,72,52
30809,Bayencourt,80057,80,0,23,10,30,18,58,23
30810,Bayonvillers,80058,80,24,104,12,132,88,232,128
30811,Bazentin,80059,80,10,15,20,20,15,55,25
30812,Béalcourt,80060,80,12,20,24,24,12,60,32
30813,Beaucamps-le-Jeune,80061,80,28,80,16,80,36,132,108
30814,Beaucamps-le-Vieux,80062,80,245,308,107,463,197,767,553
30815,Beauchamps,80063,80,145,225,100,335,195,630,370
30816,Beaucourt-en-Santerre,80064,80,12,56,4,48,56,108,68
30817,Beaucourt-sur-l'Ancre,80065,80,15,35,0,20,25,45,50
30818,Beaucourt-sur-l'Hallue,80066,80,8,85,29,72,62,163,93
30819,Beaufort-en-Santerre,80067,80,8,61,16,42,52,110,69
30820,Beaumetz,80068,80,20,76,12,72,48,132,96
30821,Beaumont-Hamel,80069,80,4,59,25,42,47,114,63
30822,Beauquesne,80070,80,128,404,108,392,312,812,532
30823,Beauval,80071,80,260,580,195,675,380,1250,840
30824,Bécordel-Bécourt,80073,80,10,30,25,55,40,120,40
30825,Becquigny,80074,80,16,16,12,40,12,64,32
30826,Béhen,80076,80,72,88,56,144,100,300,160
30827,Béhencourt,80077,80,50,67,31,91,56,178,117
30828,Bellancourt,80078,80,24,108,36,228,124,388,132
30829,Belleuse,80079,80,12,87,38,118,58,214,99
30830,Belloy-en-Santerre,80080,80,25,20,15,55,30,100,45
30831,Belloy-Saint-Léonard,80081,80,8,20,8,28,20,56,28
30832,Belloy-sur-Somme,80082,80,90,225,25,265,145,435,315
30833,Bergicourt,80083,80,20,40,16,56,24,96,60
30834,Bermesnil,80084,80,10,60,0,100,45,145,70
30835,Bernâtre,80085,80,5,0,0,20,0,20,5
30836,Bernaville,80086,80,175,275,105,385,145,635,450
30837,Bernay-en-Ponthieu,80087,80,44,64,24,56,32,112,108
30838,Bernes,80088,80,24,84,52,112,68,232,108
30839,Berneuil,80089,80,31,65,12,47,61,120,96
30840,Berny-en-Santerre,80090,80,20,45,10,20,65,95,65
30841,Bertangles,80092,80,50,99,52,236,86,374,149
30842,Berteaucourt-les-Dames,80093,80,56,307,136,393,195,724,363
30843,Berteaucourt-lès-Thennes,80094,80,25,95,50,190,85,325,120
30844,Bertrancourt,80095,80,45,60,0,55,65,120,105
30845,Béthencourt-sur-Mer,80096,80,117,245,60,369,190,619,362
30846,Béthencourt-sur-Somme,80097,80,15,35,10,35,20,65,50
30847,Bettembos,80098,80,9,15,6,25,18,49,24
30848,Bettencourt-Rivière,80099,80,21,34,4,70,50,124,55
30849,Bettencourt-Saint-Ouen,80100,80,35,225,35,115,210,360,260
30850,Beuvraignes,80101,80,84,232,84,244,224,552,316
30851,Biaches,80102,80,16,25,42,176,50,268,41
30852,Biarre,80103,80,10,10,0,30,10,40,20
30853,Biencourt,80104,80,5,30,0,80,10,90,35
30854,Billancourt,80105,80,20,40,5,75,25,105,60
30855,Blangy-sous-Poix,80106,80,24,56,16,56,40,112,80
30856,Blangy-Tronville,80107,80,14,112,46,244,77,367,126
30857,Boisbergues,80108,80,20,15,0,20,15,35,35
30858,Le Boisle,80109,80,110,70,15,80,75,170,180
30859,Boismont,80110,80,52,65,16,174,91,281,117
30860,Bonnay,80112,80,25,40,40,75,60,175,65
30861,Bonneville,80113,80,22,87,32,94,53,179,109
30862,Bosquel,80114,80,35,95,29,80,95,204,130
30863,Bouchavesnes-Bergen,80115,80,51,56,25,132,30,187,107
30864,Bouchoir,80116,80,12,116,40,84,72,196,128
30865,Bouchon,80117,80,25,50,5,50,25,80,75
30866,Boufflers,80118,80,10,25,15,58,25,98,35
30867,Bougainville,80119,80,52,114,31,104,95,230,166
30868,Bouillancourt-en-Séry,80120,80,48,148,48,172,140,360,196
30869,Bouillancourt-la-Bataille,80121,80,25,35,4,20,38,62,60
30870,Bouquemaison,80122,80,45,157,40,204,87,331,202
30871,Bourdon,80123,80,28,104,48,132,84,264,132
30872,Bourseville,80124,80,59,169,63,325,98,486,228
30873,Boussicourt,80125,80,4,24,4,28,20,52,28
30874,Bouttencourt,80126,80,165,170,65,411,130,606,335
30875,Bouvaincourt-sur-Bresle,80127,80,116,220,60,244,168,472,336
30876,Bouvincourt-en-Vermandois,80128,80,8,28,12,64,32,108,36
30877,Bouzincourt,80129,80,25,166,55,231,95,381,191
30878,Bovelles,80130,80,45,105,35,154,85,274,150
30879,Boves,80131,80,342,753,260,1002,596,1858,1095
30880,Braches,80132,80,0,72,12,84,44,140,72
30881,Brailly-Cornehotte,80133,80,33,57,12,86,20,118,90
30882,Brassy,80134,80,0,21,9,16,17,42,21
30883,Bray-lès-Mareuil,80135,80,15,70,20,100,45,165,85
30884,Bray-sur-Somme,80136,80,120,248,114,394,182,690,368
30885,Breilly,80137,80,40,122,16,176,100,292,162
30886,Bresle,80138,80,10,45,5,5,55,65,55
30887,Breuil,80139,80,10,5,5,20,15,40,15
30888,Brévillers,80140,80,0,38,4,12,38,54,38
30889,Brie,80141,80,19,74,55,90,62,207,93
30890,Briquemesnil-Floxicourt,80142,80,24,49,8,66,32,106,73
30891,Brocourt,80143,80,0,15,5,35,20,60,15
30892,Brouchy,80144,80,135,120,40,150,95,285,255
30893,Brucamps,80145,80,8,36,8,36,48,92,44
30894,Brutelles,80146,80,20,32,8,64,53,125,52
30895,Buigny-l'Abbé,80147,80,30,45,30,150,60,240,75
30896,Buigny-lès-Gamaches,80148,80,70,75,45,144,65,254,145
30897,Buigny-Saint-Maclou,80149,80,24,116,48,212,128,388,140
30898,Buire-Courcelles,80150,80,32,60,16,96,40,152,92
30899,Buire-sur-l'Ancre,80151,80,38,48,57,55,69,181,86
30900,Bus-la-Mésière,80152,80,5,80,10,55,45,110,85
30901,Bus-lès-Artois,80153,80,23,34,6,29,25,60,57
30902,Bussu,80154,80,30,55,5,75,45,125,85
30903,Bussus-Bussuel,80155,80,35,85,0,106,70,176,120
30904,Bussy-lès-Daours,80156,80,20,88,28,136,68,232,108
30905,Bussy-lès-Poix,80157,80,8,16,0,37,8,45,24
30906,Buverchy,80158,80,0,9,0,25,0,25,9
30907,Cachy,80159,80,20,80,40,60,65,165,100
30908,Cagny,80160,80,98,177,56,553,120,729,275
30909,Cahon,80161,80,40,50,10,85,25,120,90
30910,Caix,80162,80,80,215,70,190,154,414,295
30911,Cambron,80163,80,64,180,76,284,152,512,244
30912,Camon,80164,80,628,946,342,1522,731,2595,1574
30913,Camps-en-Amiénois,80165,80,21,29,21,54,22,97,50
30914,Canaples,80166,80,36,177,95,175,137,407,213
30915,Canchy,80167,80,38,59,30,106,52,188,97
30916,Candas,80168,80,135,316,68,287,240,595,451
30917,Cannessières,80169,80,25,5,10,40,0,50,30
30918,Cantigny,80170,80,4,25,25,32,12,69,29
30919,Caours,80171,80,64,110,70,201,91,362,174
30920,Cappy,80172,80,70,81,35,181,76,292,151
30921,Cardonnette,80173,80,52,138,16,165,91,272,190
30922,Le Cardonnois,80174,80,5,40,10,20,20,50,45
30923,Carnoy,80175,80,3,23,6,37,16,59,26
30924,Carrépuis,80176,80,24,68,24,88,60,172,92
30925,Cartigny,80177,80,65,225,60,240,145,445,290
30926,Caulières,80179,80,10,65,5,80,50,135,75
30927,Cavillon,80180,80,16,25,0,25,12,37,41
30928,Cayeux-en-Santerre,80181,80,0,45,10,15,30,55,45
30929,Cayeux-sur-Mer,80182,80,509,419,140,1006,302,1448,928
30930,Cerisy-Buleux,80183,80,28,57,12,76,43,131,85
30931,Cerisy,80184,80,50,130,50,160,124,334,180
30932,Champien,80185,80,24,57,39,57,40,136,81
30933,Chaulnes,80186,80,214,529,245,585,364,1194,743
30934,La Chaussée-Tirancourt,80187,80,94,139,47,214,105,366,233
30935,Chaussoy-Epagny,80188,80,40,145,60,185,130,375,185
30936,La Chavatte,80189,80,4,32,4,8,28,40,36
30937,Chépy,80190,80,136,324,80,436,276,792,460
30938,Chilly,80191,80,20,60,5,75,35,115,80
30939,Chipilly,80192,80,20,45,5,45,55,105,65
30940,Chirmont,80193,80,20,40,0,45,35,80,60
30941,Chuignes,80194,80,4,20,20,60,24,104,24
30942,Chuignolles,80195,80,15,25,15,45,40,100,40
30943,Citerne,80196,80,25,60,20,110,40,170,85
30944,Cizancourt,80197,80,15,0,0,5,0,5,15
30945,Clairy-Saulchoix,80198,80,64,85,35,130,65,230,149
30946,Cléry-sur-Somme,80199,80,60,150,30,205,105,340,210
30947,Cocquerel,80200,80,28,56,12,64,64,140,84
30948,Coigneux,80201,80,15,10,0,3,9,12,25
30949,Coisy,80202,80,20,92,28,108,64,200,112
30950,Colincamps,80203,80,4,40,8,20,24,52,44
30951,Combles,80204,80,120,216,76,224,140,440,336
30952,Condé-Folie,80205,80,145,230,90,255,195,540,375
30953,Contalmaison,80206,80,5,25,5,25,55,85,30
30954,Contay,80207,80,38,93,26,77,74,177,131
30955,Conteville,80208,80,32,60,16,52,44,112,92
30956,Contoire,80209,80,35,135,25,145,120,290,170
30957,Contre,80210,80,8,40,12,40,36,88,48
30958,Conty,80211,80,179,412,144,443,322,909,591
30959,Corbie,80212,80,714,1437,727,1812,1052,3591,2151
30960,Cottenchy,80213,80,40,112,32,140,84,256,152
30961,Coullemelle,80214,80,35,100,20,95,80,195,135
30962,Coulonvillers,80215,80,15,70,60,60,30,150,85
30963,Courcelette,80216,80,12,30,12,29,30,71,42
30964,Courcelles-au-Bois,80217,80,10,25,5,5,20,30,35
30965,Courcelles-sous-Moyencourt,80218,80,12,17,6,47,15,68,29
30966,Courcelles-sous-Thoix,80219,80,8,12,12,4,8,24,20
30967,Courtemanche,80220,80,4,24,8,44,24,76,28
30968,Cramont,80221,80,76,68,24,80,60,164,144
30969,Crécy-en-Ponthieu,80222,80,220,350,100,500,215,815,570
30970,Crémery,80223,80,3,27,3,31,20,54,30
30971,Cressy-Omencourt,80224,80,6,27,13,29,26,68,33
30972,Creuse,80225,80,0,40,20,95,30,145,40
30973,Croix-Moligneaux,80226,80,26,68,33,92,39,164,94
30974,Croixrault,80227,80,45,125,35,80,120,235,170
30975,Le Crotoy,80228,80,357,395,177,811,308,1296,752
30976,Crouy-Saint-Pierre,80229,80,24,82,21,82,84,187,106
30977,Curchy,80230,80,23,49,45,85,50,180,72
30978,Curlu,80231,80,4,24,24,52,32,108,28
30979,Damery,80232,80,16,68,20,68,56,144,84
30980,Dancourt-Popincourt,80233,80,16,34,12,32,26,70,50
30981,Daours,80234,80,112,196,100,304,116,520,308
30982,Dargnies,80235,80,149,315,125,439,264,828,464
30983,Davenescourt,80236,80,53,174,64,102,124,290,227
30984,Démuin,80237,80,15,130,55,144,119,318,145
30985,Dernancourt,80238,80,69,92,40,157,83,280,161
30986,Devise,80239,80,0,10,0,30,10,40,10
30987,Doingt,80240,80,235,264,145,470,231,846,499
30988,Domart-en-Ponthieu,80241,80,113,280,100,302,202,604,393
30989,Domart-sur-la-Luce,80242,80,33,97,20,167,71,258,130
30990,Domesmont,80243,80,0,4,4,32,4,40,4
30991,Dominois,80244,80,15,40,20,70,30,120,55
30992,Domléger-Longvillers,80245,80,47,66,21,72,39,132,113
30993,Dommartin,80246,80,8,72,51,155,40,246,80
30994,Dompierre-Becquincourt,80247,80,68,172,112,244,100,456,240
30995,Dompierre-sur-Authie,80248,80,75,110,20,135,80,235,185
30996,Domqueur,80249,80,12,81,21,84,51,156,93
30997,Domvast,80250,80,20,105,10,125,95,230,125
30998,Doudelainville,80251,80,30,120,20,95,80,195,150
30999,Douilly,80252,80,40,68,4,56,68,128,108
31000,Doullens,80253,80,891,1497,693,1811,1048,3552,2388
31001,Dreuil-lès-Amiens,80256,80,205,325,143,533,262,938,530
31002,Driencourt,80258,80,12,16,16,24,28,68,28
31003,Dromesnil,80259,80,24,20,12,32,12,56,44
31004,Drucat,80260,80,123,198,52,348,144,544,321
31005,Dury,80261,80,104,260,80,436,184,700,364
31006,Eaucourt-sur-Somme,80262,80,102,70,22,142,43,207,172
31007,L'Échelle-Saint-Aurin,80263,80,15,20,0,25,5,30,35
31008,Éclusier-Vaux,80264,80,15,25,0,35,15,50,40
31009,Embreville,80265,80,45,141,51,161,111,323,186
31010,Englebelmer,80266,80,40,96,36,56,68,160,136
31011,Ennemain,80267,80,20,45,28,65,42,135,65
31012,Épagne-Épagnette,80268,80,40,117,23,224,116,363,157
31013,Épaumesnil,80269,80,4,28,16,37,16,69,32
31014,Épécamps,80270,80,0,0,0,10,0,10,0
31015,Épehy,80271,80,140,300,152,336,220,708,440
31016,Épénancourt,80272,80,12,22,8,37,12,57,34
31017,Éplessier,80273,80,64,100,40,112,68,220,164
31018,Eppeville,80274,80,306,445,160,625,260,1045,751
31019,Équancourt,80275,80,42,38,27,99,37,163,80
31020,Équennes-Éramecourt,80276,80,12,83,9,87,64,160,95
31021,Erches,80278,80,24,68,8,36,56,100,92
31022,Ercheu,80279,80,76,220,76,188,196,460,296
31023,Ercourt,80280,80,24,36,12,32,32,76,60
31024,Ergnies,80281,80,9,50,12,37,36,85,59
31025,Érondelle,80282,80,39,146,37,111,110,258,185
31026,Esclainvillers,80283,80,20,40,10,40,55,105,60
31027,Esmery-Hallon,80284,80,122,219,60,267,130,457,341
31028,Essertaux,80285,80,15,75,50,95,30,175,90
31029,Estréboeuf,80287,80,20,62,12,70,53,135,82
31030,Estrées-Deniécourt,80288,80,25,75,35,115,70,220,100
31031,Estrées-lès-Crécy,80290,80,40,105,40,115,90,245,145
31032,Estrées-sur-Noye,80291,80,36,68,32,104,48,184,104
31033,Étalon,80292,80,30,25,15,45,10,70,55
31034,Ételfay,80293,80,30,65,65,175,45,285,95
31035,Éterpigny,80294,80,25,30,20,65,50,135,55
31036,Étinehem,80295,80,30,105,30,100,120,250,135
31037,L'Étoile,80296,80,140,352,128,388,268,784,492
31038,Étréjust,80297,80,16,16,0,20,8,28,32
31039,Étricourt-Manancourt,80298,80,75,135,45,178,80,303,210
31040,La Faloise,80299,80,19,44,18,33,58,109,63
31041,Falvy,80300,80,12,17,13,51,20,84,29
31042,Famechon,80301,80,24,68,28,64,64,156,92
31043,Faverolles,80302,80,35,35,5,35,30,70,70
31044,Favières,80303,80,85,85,40,165,70,275,170
31045,Fay,80304,80,6,27,6,33,21,60,33
31046,Ferrières,80305,80,34,104,38,179,81,298,138
31047,Fescamps,80306,80,28,28,8,36,36,80,56
31048,Feuillères,80307,80,20,34,4,25,38,67,54
31049,Feuquières-en-Vimeu,80308,80,385,613,242,720,474,1436,998
31050,Fienvillers,80310,80,62,226,53,164,130,347,288
31051,Fignières,80311,80,20,55,20,40,25,85,75
31052,Fins,80312,80,25,81,31,74,46,151,106
31053,Flaucourt,80313,80,21,63,15,98,43,156,84
31054,Flers,80314,80,19,44,17,42,26,85,63
31055,Flers-sur-Noye,80315,80,25,159,47,119,140,306,184
31056,Flesselles,80316,80,175,528,193,724,437,1354,703
31057,Fleury,80317,80,10,55,25,65,80,170,65
31058,Flixecourt,80318,80,394,828,376,892,569,1837,1222
31059,Fluy,80319,80,12,78,17,115,72,204,90
31060,Folies,80320,80,6,40,18,30,18,66,46
31061,Folleville,80321,80,10,45,20,50,30,100,55
31062,Fonches-Fonchette,80322,80,40,52,16,20,20,56,92
31063,Fontaine-le-Sec,80324,80,20,33,4,43,26,73,53
31064,Fontaine-lès-Cappy,80325,80,5,10,10,0,15,25,15
31065,Fontaine-sous-Montdidier,80326,80,0,10,10,60,15,85,10
31066,Fontaine-sur-Maye,80327,80,12,56,16,56,28,100,68
31067,Fontaine-sur-Somme,80328,80,110,130,45,160,75,280,240
31068,Forceville,80329,80,30,50,25,40,25,90,80
31069,Forceville-en-Vimeu,80330,80,44,52,12,80,48,140,96
31070,Forest-l'Abbaye,80331,80,40,76,16,84,84,184,116
31071,Forest-Montiers,80332,80,50,155,30,95,105,230,205
31072,Fort-Mahon-Plage,80333,80,241,136,100,451,172,723,377
31073,Fossemanant,80334,80,20,10,15,30,10,55,30
31074,Foucaucourt-en-Santerre,80335,80,29,90,25,85,60,170,119
31075,Foucaucourt-Hors-Nesle,80336,80,0,4,13,29,8,50,4
31076,Fouencamps,80337,80,3,34,26,95,29,150,37
31077,Fouilloy,80338,80,195,460,141,517,368,1026,655
31078,Fouquescourt,80339,80,40,56,12,16,44,72,96
31079,Fourcigny,80340,80,19,43,12,46,28,86,62
31080,Fourdrinoy,80341,80,35,95,50,125,80,255,130
31081,Framerville-Rainecourt,80342,80,25,145,25,110,145,280,170
31082,Framicourt,80343,80,0,77,12,48,70,130,77
31083,Francières,80344,80,40,60,10,35,70,115,100
31084,Franleu,80345,80,28,127,48,183,77,308,155
31085,Franqueville,80346,80,20,40,30,15,50,95,60
31086,Fransart,80347,80,10,35,20,55,25,100,45
31087,Fransu,80348,80,34,48,12,8,46,66,82
31088,Fransures,80349,80,10,31,25,57,15,97,41
31089,Franvillers,80350,80,70,115,80,190,65,335,185
31090,Fréchencourt,80351,80,3,48,45,90,35,170,51
31091,Frémontiers,80352,80,20,50,5,45,40,90,70
31092,Fresnes-Mazancourt,80353,80,17,49,12,20,20,52,66
31093,Fresnes-Tilloloy,80354,80,0,58,22,43,49,114,58
31094,Fresneville,80355,80,12,9,12,28,3,43,21
31095,Fresnoy-Andainville,80356,80,5,10,0,50,10,60,15
31096,Fresnoy-au-Val,80357,80,35,55,20,85,45,150,90
31097,Fresnoy-en-Chaussée,80358,80,15,55,10,29,40,79,70
31098,Fresnoy-lès-Roye,80359,80,40,84,40,92,52,184,124
31099,Fressenneville,80360,80,334,458,189,869,348,1406,792
31100,Frettecuisse,80361,80,8,8,9,41,4,54,16
31101,Frettemeule,80362,80,28,97,16,91,68,175,125
31102,Friaucourt,80364,80,92,208,60,300,144,504,300
31103,Fricamps,80365,80,4,63,13,28,48,89,67
31104,Fricourt,80366,80,48,124,52,180,100,332,172
31105,Frise,80367,80,8,52,4,84,44,132,60
31106,Friville-Escarbotin,80368,80,625,1072,494,1594,793,2881,1697
31107,Frohen-sur-Authie,80369,80,25,70,25,75,50,150,95
31108,Froyelles,80371,80,21,34,19,21,9,49,55
31109,Frucourt,80372,80,20,45,10,35,25,70,65
31110,Gamaches,80373,80,495,519,208,877,440,1525,1014
31111,Gapennes,80374,80,28,64,28,80,64,172,92
31112,Gauville,80375,80,70,55,40,135,50,225,125
31113,Gentelles,80376,80,47,164,38,169,149,356,211
31114,Gézaincourt,80377,80,43,89,16,120,61,197,132
31115,Ginchy,80378,80,5,15,15,15,15,45,20
31116,Glisy,80379,80,50,195,40,205,181,426,245
31117,Gorenflos,80380,80,20,48,21,98,25,144,68
31118,Gorges,80381,80,0,5,0,25,5,30,5
31119,Goyencourt,80383,80,12,16,16,28,16,60,28
31120,Grandcourt,80384,80,20,40,15,75,30,120,60
31121,Grand-Laviers,80385,80,48,70,12,134,74,220,118
31122,Gratibus,80386,80,5,40,20,89,35,144,45
31123,Grattepanche,80387,80,41,80,8,80,74,162,121
31124,Grébault-Mesnil,80388,80,10,90,20,50,60,130,100
31125,Grécourt,80389,80,0,3,0,12,0,12,3
31126,Grivesnes,80390,80,29,115,31,140,69,240,144
31127,Grivillers,80391,80,0,12,28,20,8,56,12
31128,Grouches-Luchuel,80392,80,28,168,20,196,192,408,196
31129,Gruny,80393,80,20,75,20,135,70,225,95
31130,Guerbigny,80395,80,25,90,30,95,55,180,115
31131,Gueschart,80396,80,36,49,33,94,43,170,85
31132,Gueudecourt,80397,80,7,19,18,29,12,59,26
31133,Guignemicourt,80399,80,12,72,4,94,75,173,84
31134,Guillaucourt,80400,80,38,119,53,71,95,219,157
31135,Guillemont,80401,80,10,45,20,50,15,85,55
31136,Guizancourt,80402,80,3,26,0,50,24,74,29
31137,Guyencourt-sur-Noye,80403,80,16,26,30,57,8,95,42
31138,Guyencourt-Saulcourt,80404,80,20,52,4,72,12,88,72
31139,Hailles,80405,80,30,110,50,145,85,280,140
31140,Hallencourt,80406,80,215,295,84,456,207,747,510
31141,Hallivillers,80407,80,24,40,15,55,25,95,64
31142,Halloy-lès-Pernois,80408,80,25,105,25,120,90,235,130
31143,Hallu,80409,80,15,50,35,65,25,125,65
31144,Ham,80410,80,594,1200,415,1587,699,2701,1794
31145,Le Hamel,80411,80,28,136,36,172,144,352,164
31146,Hamelet,80412,80,44,156,64,184,156,404,200
31147,Hancourt,80413,80,9,26,9,15,15,39,35
31148,Hangard,80414,80,12,40,8,24,40,72,52
31149,Hangest-en-Santerre,80415,80,105,300,85,322,230,637,405
31150,Hangest-sur-Somme,80416,80,75,160,58,269,137,464,235
31151,Harbonnières,80417,80,136,432,220,440,324,984,568
31152,Hardecourt-aux-Bois,80418,80,15,0,5,45,10,60,15
31153,Hargicourt,80419,80,25,110,50,120,70,240,135
31154,Harponville,80420,80,44,52,20,32,32,84,96
31155,Hattencourt,80421,80,8,72,28,108,60,196,80
31156,Hautvillers-Ouville,80422,80,36,164,96,176,116,388,200
31157,Havernas,80423,80,15,115,15,185,70,270,130
31158,Hébécourt,80424,80,60,156,28,172,124,324,216
31159,Hédauville,80425,80,8,45,8,33,22,63,53
31160,Heilly,80426,80,25,100,70,120,100,290,125
31161,Hem-Hardinval,80427,80,29,106,23,71,73,167,135
31162,Hem-Monacu,80428,80,25,25,0,70,10,80,50
31163,Hénencourt,80429,80,10,55,10,80,50,140,65
31164,Herbécourt,80430,80,12,67,29,37,35,101,79
31165,Hérissart,80431,80,29,169,72,137,164,373,198
31166,Herleville,80432,80,0,60,32,48,40,120,60
31167,Herly,80433,80,0,17,13,12,6,31,17
31168,Hervilly,80434,80,4,40,12,68,28,108,44
31169,Hesbécourt,80435,80,0,3,12,27,6,45,3
31170,Hescamps,80436,80,85,105,45,230,75,350,190
31171,Heucourt-Croquoison,80437,80,24,32,16,40,8,64,56
31172,Heudicourt,80438,80,72,140,60,172,80,312,212
31173,Heuzecourt,80439,80,32,60,4,44,40,88,92
31174,Hiermont,80440,80,4,40,20,34,25,79,44
31175,Hombleux,80442,80,147,248,144,356,194,694,395
31176,Hornoy-le-Bourg,80443,80,200,363,132,532,259,923,563
31177,Huchenneville,80444,80,107,121,30,237,112,379,228
31178,Humbercourt,80445,80,24,65,22,77,50,149,89
31179,Huppy,80446,80,92,220,56,260,180,496,312
31180,Hyencourt-le-Grand,80447,80,9,6,9,12,12,33,15
31181,Ignaucourt,80449,80,25,25,5,15,30,50,50
31182,Inval-Boiron,80450,80,15,35,25,30,20,75,50
31183,Irles,80451,80,22,13,6,27,9,42,35
31184,Jumel,80452,80,28,152,128,120,92,340,180
31185,Laboissière-en-Santerre,80453,80,36,44,8,56,24,88,80
31186,Lachapelle,80455,80,4,12,12,16,20,48,16
31187,Lafresguimont-Saint-Martin,80456,80,79,109,64,184,51,299,188
31188,Lahoussoye,80458,80,5,150,75,160,105,340,155
31189,Laleu,80459,80,0,23,12,26,20,58,23
31190,Lamaronde,80460,80,16,6,3,25,0,28,22
31191,Lamotte-Brebière,80461,80,12,52,20,120,32,172,64
31192,Lamotte-Buleux,80462,80,50,118,8,64,99,171,168
31193,Lamotte-Warfusée,80463,80,48,196,60,196,208,464,244
31194,Lanchères,80464,80,111,186,72,296,157,525,297
31195,Languevoisin-Quiquery,80465,80,33,35,3,45,37,85,68
31196,Lanches-Saint-Hilaire,80466,80,16,22,0,33,30,63,38
31197,Laucourt,80467,80,12,45,32,37,48,117,57
31198,Laviéville,80468,80,8,40,8,68,32,108,48
31199,Lawarde-Mauger-l'Hortoy,80469,80,25,35,15,59,40,114,60
31200,Léalvillers,80470,80,25,28,6,56,32,94,53
31201,Lesboeufs,80472,80,0,51,13,42,42,97,51
31202,Liancourt-Fosse,80473,80,4,52,40,107,43,190,56
31203,Licourt,80474,80,44,72,36,160,68,264,116
31204,Liéramont,80475,80,15,54,15,85,63,163,69
31205,Liercourt,80476,80,37,89,31,81,84,196,126
31206,Ligescourt,80477,80,23,34,15,89,22,126,57
31207,Lignières,80478,80,5,40,5,60,15,80,45
31208,Lignières-Châtelain,80479,80,39,72,44,74,72,190,111
31209,Lignières-en-Vimeu,80480,80,20,20,15,45,5,65,40
31210,Lihons,80481,80,53,89,52,89,77,218,142
31211,Limeux,80482,80,16,36,8,44,52,104,52
31212,Liomer,80484,80,45,145,40,115,55,210,190
31213,Loeuilly,80485,80,60,210,70,353,150,573,270
31214,Long,80486,80,64,134,78,152,129,359,198
31215,Longavesnes,80487,80,10,15,15,34,25,74,25
31216,Longpré-les-Corps-Saints,80488,80,205,445,125,610,270,1005,650
31217,Longueau,80489,80,609,1409,526,1857,1023,3406,2018
31218,Longueval,80490,80,28,72,24,96,56,176,100
31219,Longuevillette,80491,80,12,16,8,4,24,36,28
31220,Louvencourt,80493,80,40,60,48,68,48,164,100
31221,Louvrechy,80494,80,48,55,25,35,45,105,103
31222,Lucheux,80495,80,70,105,70,205,85,360,175
31223,Machiel,80496,80,36,32,20,76,16,112,68
31224,Machy,80497,80,15,30,10,80,0,90,45
31225,Mailly-Maillet,80498,80,92,156,48,184,140,372,248
31226,Mailly-Raineval,80499,80,15,90,15,65,80,160,105
31227,Maisnières,80500,80,50,135,35,190,105,330,185
31228,Maison-Ponthieu,80501,80,30,52,26,74,41,141,82
31229,Maison-Roland,80502,80,15,42,10,40,20,70,57
31230,Maizicourt,80503,80,40,45,5,65,30,100,85
31231,Malpart,80504,80,20,24,4,8,20,32,44
31232,Mametz,80505,80,6,37,9,56,34,99,43
31233,Marcelcave,80507,80,111,341,100,299,248,647,452
31234,Marché-Allouarde,80508,80,3,24,3,18,9,30,27
31235,Marchélepot,80509,80,40,150,55,120,95,270,190
31236,Marestmontiers,80511,80,16,32,20,20,16,56,48
31237,Mareuil-Caubert,80512,80,135,215,65,255,145,465,350
31238,Maricourt,80513,80,15,40,5,60,50,115,55
31239,Marieux,80514,80,4,32,16,48,16,80,36
31240,Marlers,80515,80,15,40,25,50,20,95,55
31241,Marquaix,80516,80,16,41,14,84,31,129,57
31242,Marquivillers,80517,80,8,61,13,63,25,101,69
31243,Martainneville,80518,80,41,124,31,116,89,236,165
31244,Matigny,80519,80,73,92,37,162,64,263,165
31245,Maucourt,80520,80,16,63,12,25,49,86,79
31246,Maurepas,80521,80,25,20,25,95,35,155,45
31247,Le Mazis,80522,80,5,15,10,35,30,75,20
31248,Méaulte,80523,80,100,305,115,460,295,870,405
31249,Méharicourt,80524,80,79,113,62,169,95,326,192
31250,Meigneux,80525,80,20,30,15,75,20,110,50
31251,Le Meillard,80526,80,10,35,20,43,35,98,45
31252,Méneslies,80527,80,40,65,48,90,65,203,105
31253,Méréaucourt,80528,80,0,0,0,5,0,5,0
31254,Mérélessart,80529,80,16,56,40,60,28,128,72
31255,Méricourt-l'Abbé,80530,80,28,144,80,184,152,416,172
31256,Méricourt-en-Vimeu,80531,80,12,10,3,36,12,51,22
31257,Méricourt-sur-Somme,80532,80,35,65,15,55,40,110,100
31258,Mers-les-Bains,80533,80,625,480,250,1125,365,1740,1105
31259,Le Mesge,80535,80,15,45,0,75,35,110,60
31260,Mesnil-Bruntel,80536,80,40,60,30,105,70,205,100
31261,Mesnil-Domqueur,80537,80,6,16,3,15,21,39,22
31262,Mesnil-en-Arrouaise,80538,80,25,15,21,50,16,87,40
31263,Mesnil-Martinsart,80540,80,10,70,35,75,70,180,80
31264,Mesnil-Saint-Georges,80541,80,24,52,12,68,32,112,76
31265,Mesnil-Saint-Nicaise,80542,80,50,142,39,140,113,292,192
31266,Métigny,80543,80,12,48,8,8,40,56,60
31267,Mézerolles,80544,80,5,45,20,95,35,150,50
31268,Mézières-en-Santerre,80545,80,51,164,67,144,123,334,215
31269,Miannay,80546,80,54,88,48,239,76,363,142
31270,Millencourt,80547,80,25,55,15,46,53,114,80
31271,Millencourt-en-Ponthieu,80548,80,31,68,32,118,64,214,99
31272,Miraumont,80549,80,81,143,87,172,118,377,224
31273,Mirvaux,80550,80,30,35,15,30,35,80,65
31274,Misery,80551,80,15,40,15,30,30,75,55
31275,Moislains,80552,80,135,250,85,520,195,800,385
31276,Molliens-au-Bois,80553,80,30,80,45,140,35,220,110
31277,Molliens-Dreuil,80554,80,128,208,69,233,190,492,336
31278,Monchy-Lagache,80555,80,85,155,60,250,130,440,240
31279,Mons-Boubert,80556,80,56,136,94,138,91,323,192
31280,Estrées-Mons,80557,80,47,150,72,192,90,354,197
31281,Monsures,80558,80,20,52,28,88,28,144,72
31282,Montagne-Fayel,80559,80,16,48,4,56,48,108,64
31283,Montauban-de-Picardie,80560,80,16,90,28,52,68,148,106
31284,Montdidier,80561,80,729,1446,711,1966,960,3637,2175
31285,Montigny-sur-l'Hallue,80562,80,28,68,12,76,48,136,96
31286,Montigny-les-Jongleurs,80563,80,4,16,0,44,16,60,20
31287,Montonvillers,80565,80,0,25,5,45,10,60,25
31288,Fieffes-Montrelet,80566,80,55,70,20,125,50,195,125
31289,Morchain,80568,80,30,80,20,105,57,182,110
31290,Morcourt,80569,80,24,56,64,64,64,192,80
31291,Moreuil,80570,80,480,946,471,1187,779,2437,1426
31292,Morisel,80571,80,80,140,60,135,105,300,220
31293,Morlancourt,80572,80,72,96,12,112,72,196,168
31294,Morvillers-Saint-Saturnin,80573,80,65,125,50,95,90,235,190
31295,Mouflers,80574,80,4,21,4,29,20,53,25
31296,Mouflières,80575,80,15,40,0,25,25,50,55
31297,Moyencourt,80576,80,30,105,15,110,60,185,135
31298,Moyencourt-lès-Poix,80577,80,8,27,23,57,34,114,35
31299,Moyenneville,80578,80,60,192,48,224,176,448,252
31300,Muille-Villette,80579,80,115,195,80,275,140,495,310
31301,Nampont,80580,80,25,38,31,57,61,149,63
31302,Namps-Maisnil,80582,80,55,250,75,380,220,675,305
31303,Nampty,80583,80,16,60,36,92,52,180,76
31304,Naours,80584,80,108,257,73,384,191,648,365
31305,Nesle,80585,80,336,535,242,690,397,1329,871
31306,Nesle-l'Hôpital,80586,80,8,34,33,40,17,90,42
31307,Neslette,80587,80,15,0,5,50,10,65,15
31308,Neufmoulin,80588,80,17,72,12,145,71,228,89
31309,Neuilly-le-Dien,80589,80,6,13,0,47,6,53,19
31310,Neuilly-l'Hôpital,80590,80,28,57,25,115,36,176,85
31311,Neuville-au-Bois,80591,80,12,21,9,70,10,89,33
31312,Neuville-Coppegueule,80592,80,82,176,41,165,108,314,258
31313,La Neuville-lès-Bray,80593,80,38,35,22,85,40,147,73
31314,Neuville-lès-Loeuilly,80594,80,20,30,5,45,30,80,50
31315,La Neuville-Sire-Bernard,80595,80,9,53,30,92,51,173,62
31316,Neuvillette,80596,80,15,65,5,55,70,130,80
31317,Nibas,80597,80,109,174,72,256,169,497,283
31318,Nouvion,80598,80,150,327,84,394,244,722,477
31319,Noyelles-en-Chaussée,80599,80,36,38,3,85,42,130,74
31320,Noyelles-sur-Mer,80600,80,130,210,55,255,110,420,340
31321,Nurlu,80601,80,76,90,36,120,78,234,166
31322,Occoches,80602,80,9,16,9,36,15,60,25
31323,Ochancourt,80603,80,22,77,16,111,48,175,99
31324,Offignies,80604,80,15,15,0,20,15,35,30
31325,Offoy,80605,80,32,64,20,72,48,140,96
31326,Oisemont,80606,80,200,230,100,375,180,655,430
31327,Oissy,80607,80,5,90,25,75,55,155,95
31328,Omiécourt,80608,80,30,67,44,66,17,127,97
31329,Oneux,80609,80,45,115,10,130,85,225,160
31330,Oresmaux,80611,80,93,176,87,282,158,527,269
31331,Oust-Marest,80613,80,99,121,48,257,70,375,220
31332,Outrebois,80614,80,50,95,20,80,50,150,145
31333,Ovillers-la-Boisselle,80615,80,17,112,36,152,89,277,129
31334,Pargny,80616,80,12,72,17,21,63,101,84
31335,Parvillers-le-Quesnoy,80617,80,40,70,35,60,45,140,110
31336,Pendé,80618,80,160,272,84,368,224,676,432
31337,Pernois,80619,80,32,203,54,163,202,419,235
31338,Péronne,80620,80,1093,1781,761,2424,1252,4437,2874
31339,Pertain,80621,80,42,109,15,122,55,192,151
31340,Picquigny,80622,80,114,297,93,383,291,767,411
31341,Piennes-Onvillers,80623,80,40,98,16,120,60,196,138
31342,Pierregot,80624,80,16,69,8,112,53,173,85
31343,Pierrepont-sur-Avre,80625,80,48,151,61,202,149,412,199
31344,Pissy,80626,80,40,65,25,115,45,185,105
31345,Plachy-Buyon,80627,80,105,200,85,350,155,590,305
31346,Le Plessier-Rozainvillers,80628,80,80,196,64,177,187,428,276
31347,Poeuilly,80629,80,15,45,20,30,20,70,60
31348,Poix-de-Picardie,80630,80,275,525,265,675,375,1315,800
31349,Ponches-Estruval,80631,80,24,16,16,36,12,64,40
31350,Pont-de-Metz,80632,80,155,580,335,785,545,1665,735
31351,Ponthoile,80633,80,80,144,24,252,124,400,224
31352,Pont-Noyelles,80634,80,65,168,79,333,173,585,233
31353,Pont-Remy,80635,80,155,415,180,424,295,899,570
31354,Port-le-Grand,80637,80,21,39,18,102,46,166,60
31355,Potte,80638,80,5,15,15,30,30,75,20
31356,Poulainville,80639,80,233,245,74,460,180,714,478
31357,Pozières,80640,80,25,68,39,36,57,132,93
31358,Prouville,80642,80,43,60,23,59,57,139,103
31359,Prouzel,80643,80,46,129,21,154,103,278,175
31360,Proyart,80644,80,81,226,41,128,166,335,307
31361,Puchevillers,80645,80,33,112,42,193,100,335,145
31362,Punchy,80646,80,8,25,8,12,24,44,33
31363,Puzeaux,80647,80,25,80,30,105,30,165,105
31364,Pys,80648,80,4,37,8,37,13,58,41
31365,Quend,80649,80,275,275,135,475,240,850,550
31366,Querrieu,80650,80,93,115,77,231,82,390,208
31367,Le Quesne,80651,80,47,53,12,91,35,138,100
31368,Le Quesnel,80652,80,50,277,85,208,179,472,327
31369,Quesnoy-le-Montant,80654,80,100,140,40,190,115,345,240
31370,Quesnoy-sur-Airaines,80655,80,30,97,30,142,74,246,127
31371,Quevauvillers,80656,80,115,275,120,370,240,730,390
31372,Quiry-le-Sec,80657,80,44,112,28,88,60,176,156
31373,Quivières,80658,80,28,20,10,54,29,93,48
31374,Raincheval,80659,80,25,65,40,94,60,194,90
31375,Rainneville,80661,80,76,192,103,305,172,580,268
31376,Ramburelles,80662,80,28,71,0,71,66,137,99
31377,Rambures,80663,80,60,75,20,115,70,205,135
31378,Rancourt,80664,80,12,40,36,64,36,136,52
31379,Regnière-Écluse,80665,80,25,20,13,31,9,53,45
31380,Remaisnil,80666,80,10,10,0,5,10,15,20
31381,Remaugies,80667,80,8,39,34,25,31,90,47
31382,Remiencourt,80668,80,16,60,12,48,36,96,76
31383,Rethonvillers,80669,80,25,72,39,118,48,205,97
31384,Revelles,80670,80,36,119,37,205,80,322,155
31385,Ribeaucourt,80671,80,30,110,0,40,80,120,140
31386,Ribemont-sur-Ancre,80672,80,41,164,62,193,107,362,205
31387,Riencourt,80673,80,20,25,15,60,40,115,45
31388,Rivery,80674,80,495,734,294,1289,516,2099,1229
31389,Rogy,80675,80,10,25,5,55,20,80,35
31390,Roiglise,80676,80,9,27,19,46,27,92,36
31391,Roisel,80677,80,236,452,208,572,264,1044,688
31392,Rollot,80678,80,100,225,45,180,180,405,325
31393,Ronssoy,80679,80,67,141,67,203,66,336,208
31394,Rosières-en-Santerre,80680,80,420,707,261,1023,536,1820,1127
31395,Rouvrel,80681,80,20,56,21,80,74,175,76
31396,Rouvroy-en-Santerre,80682,80,25,47,12,57,25,94,72
31397,Rouy-le-Grand,80683,80,0,40,8,28,16,52,40
31398,Rouy-le-Petit,80684,80,10,28,6,39,9,54,38
31399,Roye,80685,80,726,1348,685,1902,939,3526,2074
31400,Rubempré,80686,80,62,205,46,212,141,399,267
31401,Rubescourt,80687,80,20,35,10,50,25,85,55
31402,Rue,80688,80,494,628,265,1025,431,1721,1122
31403,Rumigny,80690,80,60,128,40,200,124,364,188
31404,Saigneville,80691,80,25,85,55,165,75,295,110
31405,Sailly-Flibeaucourt,80692,80,115,265,100,340,220,660,380
31406,Sailly-Laurette,80693,80,45,80,35,124,35,194,125
31407,Sailly-le-Sec,80694,80,29,72,46,113,40,199,101
31408,Sailly-Saillisel,80695,80,64,148,68,104,88,260,212
31409,Sains-en-Amiénois,80696,80,143,300,95,498,173,766,443
31410,Saint-Acheul,80697,80,0,0,0,15,0,15,0
31411,Saint-Aubin-Montenoy,80698,80,15,60,10,70,75,155,75
31412,Saint-Aubin-Rivière,80699,80,5,25,0,55,20,75,30
31413,Saint-Blimont,80700,80,155,160,95,350,125,570,315
31414,Saint-Christ-Briost,80701,80,70,85,50,130,85,265,155
31415,Saint-Fuscien,80702,80,150,245,65,385,170,620,395
31416,Saint-Germain-sur-Bresle,80703,80,20,40,10,85,40,135,60
31417,Saint-Gratien,80704,80,30,110,10,140,85,235,140
31418,Saint-Léger-lès-Authie,80705,80,5,20,0,35,30,65,25
31419,Saint-Léger-lès-Domart,80706,80,200,510,205,580,370,1155,710
31420,Saint-Léger-sur-Bresle,80707,80,4,36,8,44,16,68,40
31421,Saint-Mard,80708,80,0,20,20,136,5,161,20
31422,Saint-Maulvis,80709,80,28,67,17,87,35,139,95
31423,Saint-Maxent,80710,80,40,85,35,120,100,255,125
31424,Saint-Ouen,80711,80,165,559,200,665,346,1211,724
31425,Saint-Quentin-en-Tourmont,80713,80,24,45,39,104,51,194,69
31426,Saint-Quentin-la-Motte-Croix-au-Bailly,80714,80,150,305,115,515,200,830,455
31427,Saint-Riquier,80716,80,111,233,108,356,163,627,344
31428,Saint-Sauflieu,80717,80,84,244,100,368,216,684,328
31429,Saint-Sauveur,80718,80,85,327,131,538,269,938,412
31430,Sainte-Segrée,80719,80,10,15,0,25,20,45,25
31431,Saint-Valery-sur-Somme,80721,80,396,377,195,953,363,1511,773
31432,Saint-Vaast-en-Chaussée,80722,80,15,100,30,240,120,390,115
31433,Saisseval,80723,80,35,45,25,95,30,150,80
31434,Saleux,80724,80,355,660,355,919,514,1788,1015
31435,Salouël,80725,80,296,761,404,1062,499,1965,1057
31436,Sancourt,80726,80,25,41,9,94,38,141,66
31437,Saulchoy-sous-Poix,80728,80,5,15,0,25,20,45,20
31438,Sauvillers-Mongival,80729,80,25,35,0,80,30,110,60
31439,Saveuse,80730,80,118,169,53,387,127,567,287
31440,Senarpont,80732,80,120,140,55,233,120,408,260
31441,Senlis-le-Sec,80733,80,43,67,30,92,50,172,110
31442,Sentelie,80734,80,16,43,13,55,35,103,59
31443,Seux,80735,80,4,40,16,76,40,132,44
31444,Sorel-en-Vimeu,80736,80,30,55,0,65,55,120,85
31445,Sorel,80737,80,35,30,20,70,10,100,65
31446,Soues,80738,80,10,40,5,60,30,95,50
31447,Sourdon,80740,80,8,88,40,108,44,192,96
31448,Soyécourt,80741,80,16,40,4,64,32,100,56
31449,Surcamps,80742,80,5,25,0,20,15,35,30
31450,Suzanne,80743,80,12,25,9,71,28,108,37
31451,Tailly,80744,80,16,8,12,8,8,28,24
31452,Talmas,80746,80,76,255,101,390,188,679,331
31453,Templeux-la-Fosse,80747,80,10,40,5,80,5,90,50
31454,Templeux-le-Guérard,80748,80,5,40,20,80,40,140,45
31455,Terramesnil,80749,80,4,79,30,117,44,191,83
31456,Tertry,80750,80,4,28,24,92,20,136,32
31457,Thennes,80751,80,64,140,16,140,104,260,204
31458,Thézy-Glimont,80752,80,44,144,61,184,95,340,188
31459,Thiepval,80753,80,5,50,10,33,45,88,55
31460,Thieulloy-l'Abbaye,80754,80,46,90,20,93,71,184,136
31461,Thieulloy-la-Ville,80755,80,4,43,8,50,25,83,47
31462,Thièvres,80756,80,8,24,0,16,12,28,32
31463,Thoix,80757,80,16,52,8,36,44,88,68
31464,Thory,80758,80,4,36,36,64,28,128,40
31465,Tilloloy,80759,80,16,57,26,107,42,175,73
31466,Tilloy-Floriville,80760,80,35,125,30,165,60,255,160
31467,Tilloy-lès-Conty,80761,80,12,64,22,65,59,146,76
31468,Tincourt-Boucly,80762,80,20,90,50,135,55,240,110
31469,Le Titre,80763,80,28,108,44,124,76,244,136
31470,Toeufles,80764,80,24,52,20,136,72,228,76
31471,Tours-en-Vimeu,80765,80,57,199,60,302,178,540,256
31472,Toutencourt,80766,80,38,120,45,199,80,324,158
31473,Le Translay,80767,80,25,40,16,71,38,125,65
31474,Treux,80769,80,8,51,12,80,41,133,59
31475,Tully,80770,80,35,142,44,195,105,344,177
31476,Ugny-l'Équipée,80771,80,0,10,20,15,0,35,10
31477,Vadencourt,80773,80,8,28,0,28,32,60,36
31478,Vaire-sous-Corbie,80774,80,28,68,36,76,72,184,96
31479,Valines,80775,80,43,122,108,249,59,416,165
31480,Varennes,80776,80,10,75,20,85,50,155,85
31481,Vauchelles-lès-Authie,80777,80,35,50,5,40,40,85,85
31482,Vauchelles-lès-Domart,80778,80,8,26,8,41,25,74,34
31483,Vauchelles-les-Quesnoy,80779,80,129,181,62,275,121,458,310
31484,Vaudricourt,80780,80,40,70,65,170,50,285,110
31485,Vauvillers,80781,80,25,45,30,95,55,180,70
31486,Vaux-en-Amiénois,80782,80,35,100,40,160,70,270,135
31487,Vaux-Marquenneville,80783,80,12,16,12,29,12,53,28
31488,Vaux-sur-Somme,80784,80,20,48,34,110,34,178,68
31489,Vecquemont,80785,80,45,150,15,198,125,338,195
31490,Velennes,80786,80,20,30,5,40,45,90,50
31491,Vercourt,80787,80,19,25,6,23,9,38,44
31492,Vergies,80788,80,10,55,25,40,30,95,65
31493,Vermandovillers,80789,80,12,48,12,40,40,92,60
31494,Verpillières,80790,80,6,22,13,57,27,97,28
31495,Vers-sur-Selle,80791,80,125,115,65,285,120,470,240
31496,La Vicogne,80792,80,40,55,10,65,80,155,95
31497,Vignacourt,80793,80,230,626,215,745,525,1485,856
31498,Villecourt,80794,80,0,10,5,40,10,55,10
31499,Ville-le-Marclet,80795,80,75,110,30,130,120,280,185
31500,Villeroy,80796,80,10,40,35,85,35,155,50
31501,Villers-aux-Érables,80797,80,10,35,5,40,35,80,45
31502,Villers-Bocage,80798,80,135,352,148,496,280,924,487
31503,Villers-Bretonneux,80799,80,436,1122,371,1356,929,2656,1558
31504,Villers-Campsart,80800,80,17,17,34,29,20,83,34
31505,Villers-Carbonnel,80801,80,12,112,37,77,63,177,124
31506,Villers-Faucon,80802,80,57,156,44,177,125,346,213
31507,Villers-lès-Roye,80803,80,24,64,28,88,56,172,88
31508,Villers-sous-Ailly,80804,80,8,56,20,68,36,124,64
31509,Villers-Tournelle,80805,80,20,52,16,28,36,80,72
31510,Villers-sur-Authie,80806,80,65,135,40,100,105,245,200
31511,Ville-sur-Ancre,80807,80,19,64,19,67,63,149,83
31512,Vironchaux,80808,80,70,90,40,165,100,305,160
31513,Vismes,80809,80,68,110,45,140,100,285,178
31514,Vitz-sur-Authie,80810,80,20,20,4,37,29,70,40
31515,Voyennes,80811,80,116,132,80,220,80,380,248
31516,Vraignes-en-Vermandois,80812,80,15,20,30,60,15,105,35
31517,Vraignes-lès-Hornoy,80813,80,22,8,4,38,8,50,30
31518,Vrély,80814,80,60,95,65,135,70,270,155
31519,Vron,80815,80,104,236,44,248,200,492,340
31520,Wargnies,80819,80,10,25,10,40,10,60,35
31521,Warloy-Baillon,80820,80,80,210,55,230,150,435,290
31522,Warlus,80821,80,29,45,30,75,50,155,74
31523,Warsy,80822,80,8,24,16,48,28,92,32
31524,Warvillers,80823,80,0,44,12,43,33,88,44
31525,Wiencourt-l'Équipée,80824,80,25,67,12,69,44,125,92
31526,Wiry-au-Mont,80825,80,10,25,15,35,30,80,35
31527,Woignarue,80826,80,88,212,60,344,148,552,300
31528,Woincourt,80827,80,156,280,115,489,209,813,436
31529,Woirel,80828,80,0,16,8,16,4,28,16
31530,Y,80829,80,16,28,16,8,28,52,44
31531,Yaucourt-Bussus,80830,80,13,58,17,54,56,127,71
31532,Yvrench,80832,80,21,120,33,47,80,160,141
31533,Yvrencheux,80833,80,9,33,6,35,30,71,42
31534,Yzengremer,80834,80,85,135,35,165,100,300,220
31535,Yzeux,80835,80,5,50,45,105,60,210,55
31536,Yonval,80836,80,25,65,0,100,40,140,90
31537,Aguts,81001,81,30,41,3,74,38,115,71
31538,Aiguefonde,81002,81,377,525,212,979,381,1572,902
31539,Alban,81003,81,176,172,104,304,156,564,348
31540,Albi,81004,81,8155,10246,6799,14925,7142,28866,18401
31541,Albine,81005,81,101,85,50,198,75,323,186
31542,Algans,81006,81,9,56,0,57,53,110,65
31543,Alos,81007,81,10,5,15,45,10,70,15
31544,Almayrac,81008,81,43,40,16,113,27,156,83
31545,Amarens,81009,81,12,12,8,32,8,48,24
31546,Ambialet,81010,81,69,105,35,155,80,270,174
31547,Ambres,81011,81,114,256,71,311,174,556,370
31548,Andillac,81012,81,24,28,8,40,16,64,52
31549,Andouque,81013,81,104,72,28,116,76,220,176
31550,Anglès,81014,81,100,75,15,195,65,275,175
31551,Appelle,81015,81,6,13,13,24,10,47,19
31552,Arfons,81016,81,40,32,12,72,20,104,72
31553,Arifat,81017,81,38,12,4,49,28,81,50
31554,Arthès,81018,81,370,525,240,920,420,1580,895
31555,Assac,81019,81,35,30,10,35,30,75,65
31556,Aussac,81020,81,20,65,15,80,75,170,85
31557,Aussillon,81021,81,1375,1174,433,2137,841,3411,2549
31558,Bannières,81022,81,20,60,0,80,45,125,80
31559,Barre,81023,81,44,36,12,68,44,124,80
31560,Beauvais-sur-Tescou,81024,81,46,88,12,90,62,164,134
31561,Belcastel,81025,81,40,44,8,64,40,112,84
31562,Bellegarde-Marsal,81026,81,80,167,34,242,156,432,247
31563,Belleserre,81027,81,15,20,20,100,15,135,35
31564,Berlats,81028,81,33,0,16,24,10,50,33
31565,Bernac,81029,81,18,47,3,66,33,102,65
31566,Bertre,81030,81,0,50,4,43,40,87,50
31567,Le Bez,81031,81,75,155,60,365,165,590,230
31568,Blan,81032,81,100,272,110,370,216,696,372
31569,Blaye-les-Mines,81033,81,599,603,338,976,470,1784,1202
31570,Boissezon,81034,81,60,56,32,148,88,268,116
31571,Bournazel,81035,81,25,45,20,85,15,120,70
31572,Bout-du-Pont-de-Larn,81036,81,148,244,108,502,216,826,392
31573,Brassac,81037,81,234,236,110,504,182,796,470
31574,Brens,81038,81,257,605,155,636,473,1264,862
31575,Briatexte,81039,81,370,460,115,680,310,1105,830
31576,Brousse,81040,81,34,109,12,105,111,228,143
31577,Broze,81041,81,30,16,12,37,12,61,46
31578,Burlats,81042,81,209,488,179,761,384,1324,697
31579,Busque,81043,81,80,176,40,300,156,496,256
31580,Cabanès,81044,81,16,83,4,60,92,156,99
31581,Les Cabannes,81045,81,64,75,35,129,85,249,139
31582,Cadalen,81046,81,160,315,121,497,258,876,475
31583,Cadix,81047,81,24,52,20,96,32,148,76
31584,Cagnac-les-Mines,81048,81,464,452,207,708,444,1359,916
31585,Cahuzac,81049,81,19,60,0,100,25,125,79
31586,Cambon-lès-Lavaur,81050,81,8,86,25,82,70,177,94
31587,Cahuzac-sur-Vère,81051,81,283,236,60,307,202,569,519
31588,Cambon,81052,81,144,553,168,774,441,1383,697
31589,Cambounès,81053,81,90,50,35,135,55,225,140
31590,Cambounet-sur-le-Sor,81054,81,65,243,65,274,210,549,308
31591,Les Cammazes,81055,81,29,77,9,114,48,171,106
31592,Campagnac,81056,81,24,42,8,28,28,64,66
31593,Carbes,81058,81,29,61,8,37,59,104,90
31594,Carlus,81059,81,55,174,10,274,169,453,229
31595,Carmaux,81060,81,2349,1693,680,3219,1262,5161,4042
31596,Castanet,81061,81,30,40,40,60,30,130,70
31597,Fontrieu,81062,81,202,112,68,364,120,552,314
31598,Castelnau-de-Lévis,81063,81,183,283,100,641,196,937,466
31599,Castelnau-de-Montmiral,81064,81,144,252,56,424,144,624,396
31600,Castres,81065,81,6642,9311,4282,13328,6344,23954,15953
31601,Caucalières,81066,81,60,60,15,110,40,165,120
31602,Cestayrols,81067,81,130,110,10,145,75,230,240
31603,Combefa,81068,81,20,40,5,60,35,100,60
31604,Cordes-sur-Ciel,81069,81,208,148,72,324,116,512,356
31605,Coufouleux,81070,81,276,750,194,730,631,1555,1026
31606,Courris,81071,81,5,10,10,35,10,55,15
31607,Crespin,81072,81,9,31,9,47,22,78,40
31608,Crespinet,81073,81,28,40,12,60,32,104,68
31609,Cunac,81074,81,140,380,70,695,245,1010,520
31610,Cuq,81075,81,48,129,20,196,80,296,177
31611,Cuq-Toulza,81076,81,84,195,40,212,160,412,279
31612,Curvalle,81077,81,52,56,31,177,52,260,108
31613,Damiatte,81078,81,120,246,71,341,181,593,366
31614,Dénat,81079,81,58,227,56,210,169,435,285
31615,Donnazac,81080,81,10,15,5,35,5,45,25
31616,Dourgne,81081,81,152,252,104,404,196,704,404
31617,Le Dourn,81082,81,15,32,5,46,21,72,47
31618,Durfort,81083,81,56,52,16,76,44,136,108
31619,Escoussens,81084,81,60,175,85,230,80,395,235
31620,Escroux,81085,81,0,20,0,35,10,45,20
31621,Espérausses,81086,81,48,16,4,60,12,76,64
31622,Fayssac,81087,81,37,96,6,100,75,181,133
31623,Fauch,81088,81,71,101,57,151,82,290,172
31624,Faussergues,81089,81,44,32,8,48,28,84,76
31625,Fénols,81090,81,32,44,16,100,40,156,76
31626,Fiac,81092,81,100,196,80,332,204,616,296
31627,Florentin,81093,81,78,137,36,202,94,332,215
31628,Fraissines,81094,81,12,10,7,42,13,62,22
31629,Frausseilles,81095,81,16,16,0,36,12,48,32
31630,Le Fraysse,81096,81,35,65,40,155,80,275,100
31631,Fréjairolles,81097,81,135,360,70,445,300,815,495
31632,Fréjeville,81098,81,73,161,36,180,121,337,234
31633,Gaillac,81099,81,2381,3459,1437,4471,2657,8565,5840
31634,Garrevaques,81100,81,30,70,40,170,75,285,100
31635,Le Garric,81101,81,180,273,88,501,212,801,453
31636,Garrigues,81102,81,15,72,20,70,86,176,87
31637,Gijounet,81103,81,17,15,7,49,12,68,32
31638,Giroussens,81104,81,156,400,72,440,356,868,556
31639,Graulhet,81105,81,2196,2687,952,4132,1772,6856,4883
31640,Grazac,81106,81,24,145,48,195,127,370,169
31641,Itzac,81108,81,12,35,4,46,24,74,47
31642,Jonquières,81109,81,75,95,15,175,65,255,170
31643,Jouqueviel,81110,81,25,15,0,40,10,50,40
31644,Labarthe-Bleys,81111,81,30,10,5,25,5,35,40
31645,Labastide-de-Lévis,81112,81,135,231,45,310,212,567,366
31646,Labastide-Dénat,81113,81,44,88,40,132,76,248,132
31647,Labastide-Gabausse,81114,81,76,105,32,153,92,277,181
31648,Labastide-Rouairoux,81115,81,385,194,93,455,138,686,579
31649,Labastide-Saint-Georges,81116,81,188,514,148,632,381,1161,702
31650,Labessière-Candeil,81117,81,100,130,25,254,128,407,230
31651,Laboulbène,81118,81,15,35,10,65,25,100,50
31652,Laboutarie,81119,81,32,120,52,212,80,344,152
31653,Labruguière,81120,81,950,1434,478,2199,1091,3768,2384
31654,Lacabarède,81121,81,60,36,18,133,30,181,96
31655,Lacapelle-Pinet,81122,81,12,13,0,17,20,37,25
31656,Lacapelle-Ségalar,81123,81,25,25,0,21,16,37,50
31657,Lacaune,81124,81,440,415,214,948,369,1531,855
31658,Lacaze,81125,81,85,30,5,149,25,179,115
31659,Lacougotte-Cadoul,81126,81,8,32,8,72,25,105,40
31660,Lacroisille,81127,81,5,40,5,50,25,80,45
31661,Lacrouzette,81128,81,285,350,120,668,264,1052,635
31662,Lagardiolle,81129,81,40,52,32,92,28,152,92
31663,Lagarrigue,81130,81,241,365,162,651,290,1103,606
31664,Lagrave,81131,81,252,500,108,656,397,1161,752
31665,Guitalens-L'Albarède,81132,81,130,215,55,284,175,514,345
31666,Lamillarié,81133,81,53,126,29,170,100,299,179
31667,Lamontélarié,81134,81,5,20,10,30,10,50,25
31668,Laparrouquial,81135,81,44,20,4,36,12,52,64
31669,Larroque,81136,81,28,32,4,76,28,108,60
31670,Lasfaillades,81137,81,30,20,0,25,10,35,50
31671,Lasgraisses,81138,81,65,122,50,176,108,334,187
31672,Lautrec,81139,81,305,400,80,515,360,955,705
31673,Lavaur,81140,81,1632,2288,891,3319,1783,5993,3920
31674,Lédas-et-Penthiès,81141,81,35,25,15,40,20,75,60
31675,Lempaut,81142,81,99,226,44,313,157,514,325
31676,Lescout,81143,81,65,210,65,200,150,415,275
31677,Lescure-d'Albigeois,81144,81,583,976,306,1633,723,2662,1559
31678,Lisle-sur-Tarn,81145,81,780,1041,350,1428,813,2591,1821
31679,Livers-Cazelles,81146,81,50,30,20,100,20,140,80
31680,Lombers,81147,81,158,241,94,364,169,627,399
31681,Loubers,81148,81,0,25,0,45,20,65,25
31682,Loupiac,81149,81,45,125,5,150,85,240,170
31683,Lugan,81150,81,26,111,16,106,85,207,137
31684,Magrin,81151,81,4,44,20,44,32,96,48
31685,Mailhoc,81152,81,24,64,12,96,60,168,88
31686,Marnaves,81154,81,10,10,0,40,10,50,20
31687,Marssac-sur-Tarn,81156,81,509,690,223,993,559,1775,1199
31688,Marzens,81157,81,24,48,28,136,44,208,72
31689,Le Masnau-Massuguiès,81158,81,94,55,15,85,25,125,149
31690,Massac-Séran,81159,81,28,85,32,104,52,188,113
31691,Massaguel,81160,81,75,110,45,120,65,230,185
31692,Massals,81161,81,30,30,10,20,25,55,60
31693,Maurens-Scopont,81162,81,0,68,4,47,61,112,68
31694,Mazamet,81163,81,1985,1970,887,3353,1369,5609,3955
31695,Mézens,81164,81,43,109,25,133,99,257,152
31696,Milhars,81165,81,68,13,7,74,38,119,81
31697,Milhavet,81166,81,26,16,8,28,4,40,42
31698,Miolles,81167,81,8,21,0,47,12,59,29
31699,Mirandol-Bourgnounac,81168,81,279,220,15,339,180,534,499
31700,Missècle,81169,81,15,5,15,50,15,80,20
31701,Monestiés,81170,81,287,245,60,520,155,735,532
31702,Montans,81171,81,169,390,99,463,265,827,559
31703,Montauriol,81172,81,8,0,0,28,8,36,8
31704,Montcabrier,81173,81,32,68,4,76,76,156,100
31705,Montdragon,81174,81,59,123,27,191,129,347,182
31706,Montdurausse,81175,81,33,128,30,122,68,220,161
31707,Montels,81176,81,30,20,5,40,10,55,50
31708,Montfa,81177,81,25,130,8,154,110,272,155
31709,Montgaillard,81178,81,40,104,16,140,80,236,144
31710,Montgey,81179,81,70,60,5,65,65,135,130
31711,Montirat,81180,81,80,35,5,115,15,135,115
31712,Montpinier,81181,81,15,35,9,65,27,101,50
31713,Montredon-Labessonnié,81182,81,275,427,140,802,315,1257,702
31714,Mont-Roc,81183,81,32,40,20,72,32,124,72
31715,Montrosier,81184,81,0,0,0,15,0,15,0
31716,Montvalen,81185,81,26,43,9,69,55,133,69
31717,Moularès,81186,81,88,48,16,92,28,136,136
31718,Moulayrès,81187,81,40,24,20,56,28,104,64
31719,Moulin-Mage,81188,81,49,45,15,87,58,160,94
31720,Mouzens,81189,81,4,32,8,68,24,100,36
31721,Mouzieys-Teulet,81190,81,32,100,33,154,92,279,132
31722,Mouzieys-Panens,81191,81,48,64,24,68,52,144,112
31723,Murat-sur-Vèbre,81192,81,161,116,29,327,62,418,277
31724,Nages,81193,81,56,40,44,152,36,232,96
31725,Navès,81195,81,32,158,26,308,105,439,190
31726,Noailhac,81196,81,117,201,76,294,168,538,318
31727,Noailles,81197,81,31,66,12,50,44,106,97
31728,Orban,81198,81,25,90,25,120,80,225,115
31729,Padiès,81199,81,75,25,10,70,10,90,100
31730,Palleville,81200,81,48,112,36,136,92,264,160
31731,Pampelonne,81201,81,145,135,50,300,115,465,280
31732,Parisot,81202,81,76,280,44,292,252,588,356
31733,Paulinet,81203,81,108,84,17,190,72,279,192
31734,Payrin-Augmontel,81204,81,292,427,172,878,363,1413,719
31735,Péchaudier,81205,81,25,26,20,59,28,107,51
31736,Penne,81206,81,104,100,48,232,84,364,204
31737,Peyregoux,81207,81,12,9,6,28,3,37,21
31738,Peyrole,81208,81,29,193,37,133,123,293,222
31739,Pont-de-Larn,81209,81,491,538,208,1143,451,1802,1029
31740,Poudis,81210,81,35,65,15,75,50,140,100
31741,Poulan-Pouzols,81211,81,43,109,45,144,80,269,152
31742,Prades,81212,81,10,45,20,35,35,90,55
31743,Pratviel,81213,81,25,15,10,30,0,40,40
31744,Puéchoursi,81214,81,4,24,4,32,40,76,28
31745,Puybegon,81215,81,135,150,35,155,169,359,285
31746,Puycalvel,81216,81,25,55,0,100,30,130,80
31747,Puycelsi,81217,81,140,55,10,207,35,252,195
31748,Puygouzon,81218,81,475,589,187,1124,411,1722,1064
31749,Puylaurens,81219,81,505,740,255,1129,555,1939,1245
31750,Rabastens,81220,81,765,1366,399,1624,1153,3176,2131
31751,Rayssac,81221,81,28,32,40,116,32,188,60
31752,Réalmont,81222,81,532,698,384,1024,618,2026,1230
31753,Le Rialet,81223,81,16,8,0,16,8,24,24
31754,Le Riols,81224,81,25,5,5,55,10,70,30
31755,Rivières,81225,81,104,253,71,247,243,561,357
31756,Ronel,81226,81,40,80,30,95,90,215,120
31757,Roquecourbe,81227,81,406,430,210,784,375,1369,836
31758,Roquemaure,81228,81,36,120,4,144,116,264,156
31759,Roquevidal,81229,81,8,32,4,60,24,88,40
31760,Rosières,81230,81,135,185,50,285,120,455,320
31761,Rouairoux,81231,81,67,82,12,102,63,177,149
31762,Rouffiac,81232,81,40,152,64,260,120,444,192
31763,Roumégoux,81233,81,39,48,27,59,23,109,87
31764,Roussayrolles,81234,81,8,32,0,20,16,36,40
31765,Saint-Affrique-les-Montagnes,81235,81,65,221,104,224,156,484,286
31766,Saint-Agnan,81236,81,4,76,12,104,48,164,80
31767,Saint-Amancet,81237,81,0,40,20,92,24,136,40
31768,Saint-Amans-Soult,81238,81,280,320,124,572,252,948,600
31769,Saint-Amans-Valtoret,81239,81,167,152,80,307,126,513,319
31770,Saint-André,81240,81,9,15,13,36,13,62,24
31771,Saint-Antonin-de-Lacalm,81241,81,40,55,20,85,60,165,95
31772,Saint-Avit,81242,81,30,85,10,110,30,150,115
31773,Saint-Beauzile,81243,81,4,46,4,32,26,62,50
31774,Saint-Benoît-de-Carmaux,81244,81,520,475,170,630,360,1160,995
31775,Saint-Christophe,81245,81,12,36,12,44,40,96,48
31776,Sainte-Cécile-du-Cayrou,81246,81,21,16,6,43,13,62,37
31777,Saint-Cirgue,81247,81,31,31,10,62,29,101,62
31778,Saint-Gauzens,81248,81,110,240,40,277,185,502,350
31779,Sainte-Gemme,81249,81,116,169,67,340,112,519,285
31780,Saint-Genest-de-Contest,81250,81,32,84,0,108,60,168,116
31781,Saint-Germain-des-Prés,81251,81,89,291,51,236,187,474,380
31782,Saint-Germier,81252,81,15,35,10,69,25,104,50
31783,Saint-Grégoire,81253,81,28,138,93,116,104,313,166
31784,Saint-Jean-de-Marcel,81254,81,55,90,20,165,50,235,145
31785,Saint-Jean-de-Rives,81255,81,25,151,31,136,118,285,176
31786,Saint-Jean-de-Vals,81256,81,5,30,10,15,15,40,35
31787,Saint-Juéry,81257,81,1176,1483,649,2286,1134,4069,2659
31788,Saint-Julien-du-Puy,81258,81,44,92,56,152,76,284,136
31789,Saint-Julien-Gaulène,81259,81,55,60,25,65,25,115,115
31790,Saint-Lieux-Lafenasse,81260,81,64,104,56,164,60,280,168
31791,Saint-Lieux-lès-Lavaur,81261,81,44,321,52,231,335,618,365
31792,Saint-Marcel-Campes,81262,81,45,36,9,65,28,102,81
31793,Saint-Martin-Laguépie,81263,81,108,60,36,144,60,240,168
31794,Saint-Michel-Labadié,81264,81,25,25,15,25,5,45,50
31795,Saint-Michel-de-Vax,81265,81,24,8,0,20,4,24,32
31796,Saint-Paul-Cap-de-Joux,81266,81,158,269,56,392,149,597,427
31797,Saint-Pierre-de-Trivisy,81267,81,100,92,44,188,120,352,192
31798,Saint-Salvi-de-Carcavès,81268,81,3,6,3,38,7,48,9
31799,Saint-Salvy-de-la-Balme,81269,81,78,77,22,206,94,322,155
31800,Saint-Sernin-lès-Lavaur,81270,81,20,25,20,60,25,105,45
31801,Saint-Sulpice-la-Pointe,81271,81,778,2490,609,2387,2100,5096,3268
31802,Saint-Urcisse,81272,81,30,45,10,65,55,130,75
31803,Saïx,81273,81,507,684,257,1339,480,2076,1191
31804,Saliès,81274,81,44,224,52,272,212,536,268
31805,Salles,81275,81,40,15,20,68,35,123,55
31806,Salvagnac,81276,81,224,239,62,257,212,531,463
31807,Saussenac,81277,81,56,136,52,180,140,372,192
31808,Sauveterre,81278,81,25,20,25,90,10,125,45
31809,La Sauzière-Saint-Jean,81279,81,45,35,30,90,40,160,80
31810,Le Ségur,81280,81,55,22,18,77,33,128,77
31811,Sémalens,81281,81,245,453,205,770,378,1353,698
31812,Senaux,81282,81,3,0,3,12,3,18,3
31813,Senouillac,81283,81,112,284,68,352,264,684,396
31814,Le Sequestre,81284,81,154,346,153,690,225,1068,500
31815,Sérénac,81285,81,68,45,34,109,35,178,113
31816,Serviès,81286,81,60,149,32,174,96,302,209
31817,Sieurac,81287,81,32,60,40,60,64,164,92
31818,Sorèze,81288,81,445,611,299,820,468,1587,1056
31819,Soual,81289,81,360,572,234,692,453,1379,932
31820,Souel,81290,81,52,36,15,41,13,69,88
31821,Taïx,81291,81,32,115,66,134,85,285,147
31822,Tanus,81292,81,100,115,20,145,120,285,215
31823,Tauriac,81293,81,55,82,24,76,70,170,137
31824,Técou,81294,81,87,257,30,315,212,557,344
31825,Teillet,81295,81,86,63,15,170,53,238,149
31826,Terre-Clapier,81296,81,42,45,20,62,51,133,87
31827,Terssac,81297,81,124,268,88,434,165,687,392
31828,Teulat,81298,81,25,150,20,170,115,305,175
31829,Teyssode,81299,81,22,103,10,98,96,204,125
31830,Tonnac,81300,81,45,16,6,23,6,35,61
31831,Le Travet,81301,81,19,15,15,50,20,85,34
31832,Tréban,81302,81,0,12,4,16,13,33,12
31833,Trébas,81303,81,68,49,16,90,48,154,117
31834,Trévien,81304,81,25,50,0,90,35,125,75
31835,Vabre,81305,81,259,164,35,263,100,398,423
31836,Valderiès,81306,81,147,180,95,244,111,450,327
31837,Valdurenque,81307,81,110,225,60,265,145,470,335
31838,Valence-d'Albigeois,81308,81,193,280,65,375,234,674,473
31839,Vaour,81309,81,28,105,16,104,88,208,133
31840,Veilhes,81310,81,12,20,8,36,28,72,32
31841,Vénès,81311,81,138,171,52,205,150,407,309
31842,Verdalle,81312,81,66,250,49,318,153,520,316
31843,Le Verdier,81313,81,50,65,5,70,35,110,115
31844,Viane,81314,81,100,102,16,181,81,278,202
31845,Vielmur-sur-Agout,81315,81,176,392,128,492,280,900,568
31846,Vieux,81316,81,31,33,16,81,29,126,64
31847,Villefranche-d'Albigeois,81317,81,223,247,114,363,191,668,470
31848,Villeneuve-lès-Lavaur,81318,81,20,40,12,40,40,92,60
31849,Villeneuve-sur-Vère,81319,81,65,130,15,155,120,290,195
31850,Vindrac-Alayrac,81320,81,36,28,4,76,20,100,64
31851,Le Vintrou,81321,81,12,12,20,16,20,56,24
31852,Virac,81322,81,48,36,16,96,20,132,84
31853,Viterbe,81323,81,37,90,13,81,90,184,127
31854,Viviers-lès-Lavaur,81324,81,15,65,10,70,60,140,80
31855,Viviers-lès-Montagnes,81325,81,190,500,180,695,360,1235,690
31856,Sainte-Croix,81326,81,30,82,16,146,75,237,112
31857,Albefeuille-Lagarde,82001,82,81,145,46,170,115,331,226
31858,Albias,82002,82,353,780,299,967,685,1951,1133
31859,Angeville,82003,82,12,78,13,79,47,139,90
31860,Asques,82004,82,20,20,20,35,20,75,40
31861,Aucamville,82005,82,134,292,75,347,256,678,426
31862,Auterive,82006,82,12,16,8,16,12,36,28
31863,Auty,82007,82,12,32,0,60,40,100,44
31864,Auvillar,82008,82,125,200,70,360,165,595,325
31865,Balignac,82009,82,12,6,0,9,0,9,18
31866,Bardigues,82010,82,30,106,16,67,44,127,136
31867,Barry-d'Islemade,82011,82,63,236,86,259,211,556,299
31868,Les Barthes,82012,82,85,145,50,150,105,305,230
31869,Beaumont-de-Lomagne,82013,82,550,854,309,1102,678,2089,1404
31870,Beaupuy,82014,82,56,87,10,71,63,144,143
31871,Belbèze-en-Lomagne,82015,82,5,35,15,40,30,85,40
31872,Belvèze,82016,82,33,19,15,70,29,114,52
31873,Bessens,82017,82,97,521,73,252,455,780,618
31874,Bioule,82018,82,102,317,91,273,264,628,419
31875,Boudou,82019,82,100,153,52,236,129,417,253
31876,Bouillac,82020,82,63,210,15,213,150,378,273
31877,Bouloc,82021,82,39,25,20,89,25,134,64
31878,Bourg-de-Visa,82022,82,84,57,23,121,44,188,141
31879,Bourret,82023,82,76,233,84,268,172,524,309
31880,Brassac,82024,82,36,40,44,136,12,192,76
31881,Bressols,82025,82,412,956,315,1153,747,2215,1368
31882,Bruniquel,82026,82,85,80,50,255,130,435,165
31883,Campsas,82027,82,55,395,130,374,330,834,450
31884,Canals,82028,82,88,202,40,216,185,441,290
31885,Castanet,82029,82,53,48,17,75,39,131,101
31886,Castelferrus,82030,82,56,117,39,104,89,232,173
31887,Castelmayran,82031,82,121,332,82,300,242,624,453
31888,Castelsagrat,82032,82,127,145,30,164,119,313,272
31889,Castelsarrasin,82033,82,2039,3125,1334,4041,2219,7594,5164
31890,Castéra-Bouzet,82034,82,20,24,8,44,16,68,44
31891,Caumont,82035,82,45,100,20,115,65,200,145
31892,Le Causé,82036,82,25,20,21,32,12,65,45
31893,Caussade,82037,82,1166,1556,732,2047,1098,3877,2722
31894,Caylus,82038,82,230,270,30,586,220,836,500
31895,Cayrac,82039,82,30,165,60,200,95,355,195
31896,Cayriech,82040,82,24,60,12,132,48,192,84
31897,Cazals,82041,82,55,49,10,110,19,139,104
31898,Cazes-Mondenard,82042,82,325,271,35,370,185,590,596
31899,Comberouger,82043,82,37,57,17,73,55,145,94
31900,Corbarieu,82044,82,215,448,105,499,374,978,663
31901,Cordes-Tolosannes,82045,82,36,88,0,145,64,209,124
31902,Coutures,82046,82,15,17,0,31,12,43,32
31903,Cumont,82047,82,25,10,0,5,10,15,35
31904,Dieupentale,82048,82,109,573,131,348,396,875,682
31905,Donzac,82049,82,104,304,100,292,208,600,408
31906,Dunes,82050,82,160,264,112,448,232,792,424
31907,Durfort-Lacapelette,82051,82,112,180,88,348,116,552,292
31908,Escatalens,82052,82,76,340,52,292,245,589,416
31909,Escazeaux,82053,82,52,80,16,72,60,148,132
31910,Espalais,82054,82,29,93,33,139,65,237,122
31911,Esparsac,82055,82,56,40,8,100,32,140,96
31912,Espinas,82056,82,29,17,8,82,8,98,46
31913,Fabas,82057,82,50,175,30,160,155,345,225
31914,Fajolles,82058,82,20,12,8,36,12,56,32
31915,Faudoas,82059,82,92,40,4,112,48,164,132
31916,Fauroux,82060,82,55,50,10,70,50,130,105
31917,Féneyrols,82061,82,12,30,3,69,19,91,42
31918,Finhan,82062,82,148,447,88,342,396,826,595
31919,Garganvillar,82063,82,68,188,36,204,156,396,256
31920,Gariès,82064,82,8,30,0,48,13,61,38
31921,Gasques,82065,82,80,60,10,180,60,250,140
31922,Génébrières,82066,82,64,200,44,192,168,404,264
31923,Gensac,82067,82,5,30,10,55,20,85,35
31924,Gimat,82068,82,28,60,12,68,32,112,88
31925,Ginals,82069,82,65,27,9,66,9,84,92
31926,Glatens,82070,82,4,24,0,20,20,40,28
31927,Goas,82071,82,0,10,0,25,0,25,10
31928,Golfech,82072,82,86,257,87,275,185,547,343
31929,Goudourville,82073,82,81,212,61,393,153,607,293
31930,Gramont,82074,82,10,35,20,69,15,104,45
31931,Grisolles,82075,82,439,987,345,1189,854,2388,1426
31932,L'Honor-de-Cos,82076,82,234,297,121,556,241,918,531
31933,Labarthe,82077,82,88,68,24,128,80,232,156
31934,Labastide-de-Penne,82078,82,12,28,0,60,36,96,40
31935,Labastide-Saint-Pierre,82079,82,370,977,305,1279,683,2267,1347
31936,Labastide-du-Temple,82080,82,144,363,97,326,230,653,507
31937,Labourgade,82081,82,20,40,15,75,20,110,60
31938,Lacapelle-Livron,82082,82,48,56,4,56,44,104,104
31939,Lachapelle,82083,82,25,25,0,35,15,50,50
31940,Lacour,82084,82,65,15,20,55,20,95,80
31941,Lacourt-Saint-Pierre,82085,82,112,280,100,360,252,712,392
31942,Lafitte,82086,82,30,40,15,90,60,165,70
31943,Lafrançaise,82087,82,509,728,200,897,524,1621,1237
31944,Laguépie,82088,82,172,81,40,229,52,321,253
31945,Lamagistère,82089,82,141,269,68,383,170,621,410
31946,Lamothe-Capdeville,82090,82,125,275,55,370,200,625,400
31947,Lamothe-Cumont,82091,82,6,10,10,49,10,69,16
31948,Lapenche,82092,82,56,56,12,96,40,148,112
31949,Larrazet,82093,82,72,156,24,184,140,348,228
31950,Lauzerte,82094,82,332,252,40,584,164,788,584
31951,Lavaurette,82095,82,17,39,8,68,49,125,56
31952,La Ville-Dieu-du-Temple,82096,82,302,902,317,866,691,1874,1204
31953,Lavit,82097,82,172,276,112,428,224,764,448
31954,Léojac,82098,82,85,346,51,360,268,679,431
31955,Lizac,82099,82,85,165,20,145,110,275,250
31956,Loze,82100,82,16,20,16,72,8,96,36
31957,Malause,82101,82,169,243,111,355,167,633,412
31958,Mansonville,82102,82,65,82,4,95,29,128,147
31959,Marignac,82103,82,20,32,12,32,24,68,52
31960,Marsac,82104,82,25,29,10,74,30,114,54
31961,Mas-Grenier,82105,82,146,390,147,325,314,786,536
31962,Maubec,82106,82,34,19,3,48,15,66,53
31963,Maumusson,82107,82,0,20,0,20,16,36,20
31964,Meauzac,82108,82,152,378,112,422,267,801,530
31965,Merles,82109,82,9,59,9,49,53,111,68
31966,Mirabel,82110,82,148,248,76,352,204,632,396
31967,Miramont-de-Quercy,82111,82,41,77,12,102,59,173,118
31968,Moissac,82112,82,1977,2814,991,4231,1968,7190,4791
31969,Molières,82113,82,256,234,116,354,198,668,490
31970,Monbéqui,82114,82,31,154,66,166,148,380,185
31971,Monclar-de-Quercy,82115,82,171,536,149,494,419,1062,707
31972,Montagudet,82116,82,55,25,20,85,25,130,80
31973,Montaigu-de-Quercy,82117,82,403,205,65,408,171,644,608
31974,Montaïn,82118,82,35,30,20,30,10,60,65
31975,Montalzat,82119,82,115,165,55,195,120,370,280
31976,Montastruc,82120,82,64,68,12,120,56,188,132
31977,Montauban,82121,82,7999,13307,6362,19061,10217,35640,21306
31978,Montbarla,82122,82,23,22,3,57,17,77,45
31979,Montbartier,82123,82,53,330,152,400,228,780,383
31980,Montbeton,82124,82,276,1087,318,1137,828,2283,1363
31981,Montech,82125,82,608,1772,478,1686,1426,3590,2380
31982,Monteils,82126,82,178,333,99,591,189,879,511
31983,Montesquieu,82127,82,92,216,8,280,176,464,308
31984,Montfermier,82128,82,12,16,3,28,22,53,28
31985,Montgaillard,82129,82,4,16,8,57,20,85,20
31986,Montjoi,82130,82,25,10,15,85,25,125,35
31987,Montpezat-de-Quercy,82131,82,298,269,77,526,273,876,567
31988,Montricoux,82132,82,152,357,81,339,183,603,509
31989,Mouillac,82133,82,20,25,15,25,15,55,45
31990,Nègrepelisse,82134,82,610,1352,420,1754,980,3154,1962
31991,Nohic,82135,82,117,361,83,373,279,735,478
31992,Orgueil,82136,82,92,484,139,446,357,942,576
31993,Parisot,82137,82,134,112,34,150,90,274,246
31994,Perville,82138,82,28,20,20,32,24,76,48
31995,Le Pin,82139,82,35,13,3,27,15,45,48
31996,Piquecos,82140,82,45,101,19,135,53,207,146
31997,Pommevic,82141,82,60,140,48,212,100,360,200
31998,Pompignan,82142,82,127,452,84,394,318,796,579
31999,Poupas,82143,82,5,25,5,35,20,60,30
32000,Puycornet,82144,82,100,168,28,224,173,425,268
32001,Puygaillard-de-Quercy,82145,82,65,67,24,119,57,200,132
32002,Puygaillard-de-Lomagne,82146,82,15,15,10,25,0,35,30
32003,Puylagarde,82147,82,72,56,8,160,48,216,128
32004,Puylaroque,82148,82,112,140,48,268,112,428,252
32005,Réalville,82149,82,246,468,193,622,315,1130,714
32006,Reyniès,82150,82,130,238,75,275,173,523,368
32007,Roquecor,82151,82,95,65,30,190,35,255,160
32008,Saint-Aignan,82152,82,60,88,44,168,48,260,148
32009,Saint-Amans-du-Pech,82153,82,56,40,0,72,32,104,96
32010,Saint-Amans-de-Pellagal,82154,82,36,37,0,70,35,105,73
32011,Saint-Antonin-Noble-Val,82155,82,320,340,120,755,270,1145,660
32012,Saint-Arroumex,82156,82,20,56,8,44,40,92,76
32013,Saint-Beauzeil,82157,82,0,36,6,54,36,96,36
32014,Saint-Cirice,82158,82,18,26,9,48,15,72,44
32015,Saint-Cirq,82159,82,80,140,50,155,120,325,220
32016,Saint-Clair,82160,82,30,75,50,100,30,180,105
32017,Saint-Étienne-de-Tulmont,82161,82,331,891,278,1368,669,2315,1222
32018,Saint-Georges,82162,82,8,84,4,76,72,152,92
32019,Saint-Jean-du-Bouzet,82163,82,21,15,11,10,10,31,36
32020,Sainte-Juliette,82164,82,32,32,4,56,16,76,64
32021,Saint-Loup,82165,82,52,116,40,196,88,324,168
32022,Saint-Michel,82166,82,64,48,0,64,68,132,112
32023,Saint-Nauphary,82167,82,160,449,148,613,320,1081,609
32024,Saint-Nazaire-de-Valentane,82168,82,95,70,15,128,45,188,165
32025,Saint-Nicolas-de-la-Grave,82169,82,401,456,200,696,357,1253,857
32026,Saint-Paul-d'Espis,82170,82,130,115,25,175,110,310,245
32027,Saint-Porquier,82171,82,150,395,100,475,260,835,545
32028,Saint-Projet,82172,82,67,51,3,87,44,134,118
32029,Saint-Sardos,82173,82,111,253,106,305,243,654,364
32030,Saint-Vincent-d'Autéjac,82174,82,28,48,28,124,48,200,76
32031,Saint-Vincent-Lespinasse,82175,82,29,50,5,89,60,154,79
32032,La Salvetat-Belmontet,82176,82,92,185,47,174,220,441,277
32033,Sauveterre,82177,82,30,40,5,50,50,105,70
32034,Savenès,82178,82,95,235,40,205,195,440,330
32035,Septfonds,82179,82,332,480,172,736,364,1272,812
32036,Sérignac,82180,82,107,95,45,142,80,267,202
32037,Sistels,82181,82,16,52,8,96,32,136,68
32038,Touffailles,82182,82,109,30,30,162,50,242,139
32039,Tréjouls,82183,82,53,50,6,78,32,116,103
32040,Vaïssac,82184,82,108,204,76,272,180,528,312
32041,Valeilles,82185,82,37,36,19,68,32,119,73
32042,Valence,82186,82,935,1065,585,1643,755,2983,2000
32043,Varen,82187,82,205,70,25,280,60,365,275
32044,Varennes,82188,82,40,160,80,165,120,365,200
32045,Vazerac,82189,82,175,140,25,239,120,384,315
32046,Verdun-sur-Garonne,82190,82,498,1177,424,1354,1040,2818,1675
32047,Verfeil,82191,82,80,60,8,120,60,188,140
32048,Verlhac-Tescou,82192,82,55,110,45,190,119,354,165
32049,Vigueron,82193,82,8,28,8,80,8,96,36
32050,Villebrumier,82194,82,74,328,112,421,260,793,402
32051,Villemade,82195,82,137,126,41,286,79,406,263
32052,Les Adrets-de-l'Estérel,83001,83,315,580,175,1045,510,1730,895
32053,Aiguines,83002,83,59,44,6,84,41,131,103
32054,Ampus,83003,83,124,213,85,345,185,615,337
32055,Les Arcs,83004,83,943,1582,702,2485,1294,4481,2525
32056,Artignosc-sur-Verdon,83005,83,49,45,10,154,60,224,94
32057,Artigues,83006,83,49,55,10,55,50,115,104
32058,Aups,83007,83,428,412,152,728,324,1204,840
32059,Bagnols-en-Forêt,83008,83,415,524,208,986,429,1623,939
32060,Bandol,83009,83,2238,1098,520,2913,809,4242,3336
32061,Bargème,83010,83,32,28,16,88,28,132,60
32062,Bargemon,83011,83,252,339,118,505,209,832,591
32063,Barjols,83012,83,432,659,233,1099,513,1845,1091
32064,La Bastide,83013,83,45,28,13,76,17,106,73
32065,Baudinard-sur-Verdon,83014,83,28,33,12,102,20,134,61
32066,Bauduen,83015,83,20,49,30,169,50,249,69
32067,Le Beausset,83016,83,1191,2072,893,3501,1714,6108,3263
32068,Belgentier,83017,83,245,650,245,805,490,1540,895
32069,Besse-sur-Issole,83018,83,344,748,165,1120,501,1786,1092
32070,Bormes-les-Mimosas,83019,83,1515,1306,471,2967,1284,4722,2821
32071,Le Bourguet,83020,83,10,0,0,15,0,15,10
32072,Bras,83021,83,263,691,145,904,572,1621,954
32073,Brenon,83022,83,0,0,0,15,0,15,0
32074,Brignoles,83023,83,2011,4472,1624,4917,3093,9634,6483
32075,Brue-Auriac,83025,83,75,305,140,437,274,851,380
32076,Cabasse,83026,83,185,535,144,584,383,1111,720
32077,La Cadière-d'Azur,83027,83,826,1136,471,2135,884,3490,1962
32078,Callas,83028,83,272,323,119,664,250,1033,595
32079,Callian,83029,83,462,688,277,1268,467,2012,1150
32080,Camps-la-Source,83030,83,215,466,103,624,369,1096,681
32081,Le Cannet-des-Maures,83031,83,672,877,362,1538,715,2615,1549
32082,Carcès,83032,83,656,723,238,1192,512,1942,1379
32083,Carnoules,83033,83,362,794,339,1230,672,2241,1156
32084,Carqueiranne,83034,83,2166,1726,837,3583,1525,5945,3892
32085,Le Castellet,83035,83,671,784,304,1604,613,2521,1455
32086,Cavalaire-sur-Mer,83036,83,1625,1213,579,2429,1164,4172,2838
32087,La Celle,83037,83,217,306,132,428,213,773,523
32088,Châteaudouble,83038,83,65,90,33,141,61,235,155
32089,Châteauvert,83039,83,0,21,20,60,20,100,21
32090,Châteauvieux,83040,83,20,30,15,25,5,45,50
32091,Claviers,83041,83,92,110,50,324,110,484,202
32092,Cogolin,83042,83,1267,2952,1592,3841,2599,8032,4219
32093,Collobrières,83043,83,247,396,174,697,307,1178,643
32094,Comps-sur-Artuby,83044,83,40,85,44,150,55,249,125
32095,Correns,83045,83,109,201,52,317,123,492,310
32096,Cotignac,83046,83,431,399,157,894,263,1314,830
32097,La Crau,83047,83,2128,3835,1458,6169,2860,10487,5963
32098,La Croix-Valmer,83048,83,650,661,337,1263,657,2257,1311
32099,Cuers,83049,83,1298,2591,1053,3336,1915,6304,3889
32100,Draguignan,83050,83,5035,9421,4395,12647,7179,24221,14456
32101,Entrecasteaux,83051,83,187,248,52,440,139,631,435
32102,Esparron,83052,83,55,95,10,100,80,190,150
32103,Évenos,83053,83,237,493,164,814,427,1405,730
32104,La Farlède,83054,83,1120,1684,863,2756,1385,5004,2804
32105,Fayence,83055,83,984,1212,379,1898,1054,3331,2196
32106,Figanières,83056,83,293,574,181,1022,417,1620,867
32107,Flassans-sur-Issole,83057,83,391,976,298,996,720,2014,1367
32108,Flayosc,83058,83,748,850,355,1642,691,2688,1598
32109,Forcalqueiret,83059,83,349,738,191,943,478,1612,1087
32110,Fox-Amphoux,83060,83,91,90,40,186,70,296,181
32111,Fréjus,83061,83,9779,11003,5164,17052,9000,31216,20782
32112,La Garde,83062,83,3794,5245,3154,7526,4150,14830,9039
32113,La Garde-Freinet,83063,83,206,394,172,773,223,1168,600
32114,Garéoult,83064,83,783,1118,337,2230,778,3345,1901
32115,Gassin,83065,83,468,453,160,1093,374,1627,921
32116,Ginasservis,83066,83,172,392,166,553,296,1015,564
32117,Gonfaron,83067,83,619,1065,391,1287,833,2511,1684
32118,Grimaud,83068,83,508,826,291,1582,755,2628,1334
32119,Hyères,83069,83,10319,10831,5391,17682,9330,32403,21150
32120,Le Lavandou,83070,83,1313,807,381,1920,671,2972,2120
32121,La Londe-les-Maures,83071,83,1902,1293,441,3437,1000,4878,3195
32122,Lorgues,83072,83,1588,1825,718,3429,1377,5524,3413
32123,Le Luc,83073,83,1468,2544,1058,3074,1822,5954,4012
32124,La Martre,83074,83,22,25,13,77,25,115,47
32125,Les Mayons,83075,83,105,115,50,300,65,415,220
32126,Mazaugues,83076,83,69,255,65,247,235,547,324
32127,Méounes-lès-Montrieux,83077,83,185,563,176,777,389,1342,748
32128,Moissac-Bellevue,83078,83,75,35,10,120,35,165,110
32129,La Môle,83079,83,94,391,94,458,355,907,485
32130,Mons,83080,83,188,168,44,336,140,520,356
32131,Montauroux,83081,83,702,1645,390,2166,1227,3783,2347
32132,Montferrat,83082,83,55,211,136,250,241,627,266
32133,Montfort-sur-Argens,83083,83,226,317,70,396,208,674,543
32134,Montmeyan,83084,83,120,100,25,220,100,345,220
32135,La Motte,83085,83,387,593,202,1258,449,1909,980
32136,Le Muy,83086,83,1455,2173,922,3109,1538,5569,3628
32137,Nans-les-Pins,83087,83,520,871,326,1367,590,2283,1391
32138,Néoules,83088,83,237,713,230,818,516,1564,950
32139,Ollières,83089,83,33,147,42,262,72,376,180
32140,Ollioules,83090,83,1771,2655,1223,4873,2126,8222,4426
32141,Pierrefeu-du-Var,83091,83,674,1441,583,1951,1065,3599,2115
32142,Pignans,83092,83,398,927,354,1231,723,2308,1325
32143,Plan-d'Aups-Sainte-Baume,83093,83,194,599,96,537,548,1181,793
32144,Le Plan-de-la-Tour,83094,83,384,619,185,941,535,1661,1003
32145,Pontevès,83095,83,148,184,32,280,144,456,332
32146,Pourcieux,83096,83,138,370,123,478,302,903,508
32147,Pourrières,83097,83,453,1316,369,1626,1007,3002,1769
32148,Le Pradet,83098,83,1966,1914,904,4072,1391,6367,3880
32149,Puget-sur-Argens,83099,83,992,1821,707,2202,1403,4312,2813
32150,Puget-Ville,83100,83,575,1045,419,1247,709,2375,1620
32151,Ramatuelle,83101,83,432,255,130,885,355,1370,687
32152,Régusse,83102,83,565,439,129,912,308,1349,1004
32153,Le Revest-les-Eaux,83103,83,437,762,266,1503,523,2292,1199
32154,Rians,83104,83,510,1021,330,1540,775,2645,1531
32155,Riboux,83105,83,0,8,4,16,4,24,8
32156,Rocbaron,83106,83,338,1332,369,1627,1069,3065,1670
32157,Roquebrune-sur-Argens,83107,83,1972,2481,1015,4529,2102,7646,4453
32158,La Roquebrussanne,83108,83,260,665,216,828,497,1541,925
32159,La Roque-Esclapon,83109,83,104,60,12,88,36,136,164
32160,Rougiers,83110,83,139,439,146,513,327,986,578
32161,Sainte-Anastasie-sur-Issole,83111,83,300,436,152,676,304,1132,736
32162,Saint-Cyr-sur-Mer,83112,83,2240,2568,1002,4250,1867,7119,4808
32163,Saint-Julien,83113,83,258,593,184,744,480,1408,851
32164,Saint-Martin-de-Pallières,83114,83,52,64,4,80,52,136,116
32165,Sainte-Maxime,83115,83,2872,2356,1185,4832,2360,8377,5228
32166,Saint-Maximin-la-Sainte-Baume,83116,83,1964,3665,1553,5576,2656,9785,5629
32167,Saint-Paul-en-Forêt,83117,83,290,420,85,590,280,955,710
32168,Saint-Raphaël,83118,83,9670,5363,2253,11951,4704,18908,15033
32169,Saint-Tropez,83119,83,883,590,375,1644,735,2754,1473
32170,Saint-Zacharie,83120,83,626,1260,474,1839,938,3251,1886
32171,Salernes,83121,83,589,791,245,1387,663,2295,1380
32172,Les Salles-sur-Verdon,83122,83,50,35,25,73,64,162,85
32173,Sanary-sur-Mer,83123,83,4268,2261,1040,6037,1911,8988,6529
32174,Seillans,83124,83,478,472,220,841,388,1449,950
32175,Seillons-Source-d'Argens,83125,83,183,759,205,675,580,1460,942
32176,La Seyne-sur-Mer,83126,83,9541,14669,7046,20593,11716,39355,24210
32177,Signes,83127,83,272,795,226,909,513,1648,1067
32178,Sillans-la-Cascade,83128,83,78,117,38,290,132,460,195
32179,Six-Fours-les-Plages,83129,83,7200,5936,2584,12202,5300,20086,13136
32180,Solliès-Pont,83130,83,1365,2503,1050,4079,1876,7005,3868
32181,Solliès-Toucas,83131,83,479,1341,533,1876,1104,3513,1820
32182,Solliès-Ville,83132,83,234,477,253,971,383,1607,711
32183,Tanneron,83133,83,169,345,84,580,313,977,514
32184,Taradeau,83134,83,312,376,132,671,284,1087,688
32185,Tavernes,83135,83,190,258,73,583,225,881,448
32186,Le Thoronet,83136,83,316,541,143,924,383,1450,857
32187,Toulon,83137,83,26031,34956,19087,51051,30149,100287,60987
32188,Tourrettes,83138,83,487,592,248,1034,467,1749,1079
32189,Tourtour,83139,83,130,105,25,210,95,330,235
32190,Tourves,83140,83,624,1261,428,1579,924,2931,1885
32191,Trans-en-Provence,83141,83,791,1166,502,2206,889,3597,1957
32192,Trigance,83142,83,16,20,40,72,20,132,36
32193,Le Val,83143,83,626,942,277,1559,725,2561,1568
32194,La Valette-du-Var,83144,83,3687,4381,2567,7406,3875,13848,8068
32195,Varages,83145,83,152,245,64,480,204,748,397
32196,La Verdière,83146,83,302,364,80,610,252,942,666
32197,Vérignon,83147,83,0,0,0,5,0,5,0
32198,Vidauban,83148,83,1371,2846,1141,3544,2022,6707,4217
32199,Villecroze,83149,83,228,276,100,493,256,849,504
32200,Vinon-sur-Verdon,83150,83,545,1021,430,1373,815,2618,1566
32201,Vins-sur-Caramy,83151,83,82,255,57,341,178,576,337
32202,Rayol-Canadel-sur-Mer,83152,83,138,118,17,310,77,404,256
32203,Saint-Mandrier-sur-Mer,83153,83,1131,837,516,1672,745,2933,1968
32204,Saint-Antonin-du-Var,83154,83,120,136,60,291,112,463,256
32205,Althen-des-Paluds,84001,84,239,679,236,803,548,1587,918
32206,Ansouis,84002,84,165,202,90,451,135,676,367
32207,Apt,84003,84,1802,2996,973,3659,2187,6819,4798
32208,Aubignan,84004,84,631,1293,539,1790,1055,3384,1924
32209,Aurel,84005,84,20,40,20,90,30,140,60
32210,Auribeau,84006,84,19,3,0,15,9,24,22
32211,Avignon,84007,84,11247,23039,13364,26318,16256,55938,34286
32212,Le Barroux,84008,84,70,112,45,220,85,350,182
32213,La Bastide-des-Jourdans,84009,84,176,312,100,528,223,851,488
32214,La Bastidonne,84010,84,84,164,28,296,120,444,248
32215,Le Beaucet,84011,84,48,43,23,101,53,177,91
32216,Beaumes-de-Venise,84012,84,365,537,156,703,471,1330,902
32217,Beaumettes,84013,84,20,46,8,104,30,142,66
32218,Beaumont-de-Pertuis,84014,84,162,245,90,409,229,728,407
32219,Beaumont-du-Ventoux,84015,84,55,50,20,135,35,190,105
32220,Bédarrides,84016,84,730,1134,386,1769,884,3039,1864
32221,Bédoin,84017,84,528,574,225,1222,469,1916,1102
32222,Blauvac,84018,84,32,118,48,182,93,323,150
32223,Bollène,84019,84,1892,3302,1411,4566,2232,8209,5194
32224,Bonnieux,84020,84,214,270,140,466,273,879,484
32225,Brantes,84021,84,12,8,0,34,8,42,20
32226,Buisson,84022,84,25,86,20,89,52,161,111
32227,Buoux,84023,84,0,6,12,66,12,90,6
32228,Cabrières-d'Aigues,84024,84,98,183,93,336,137,566,281
32229,Cabrières-d'Avignon,84025,84,199,344,115,632,331,1078,543
32230,Cadenet,84026,84,586,907,418,1293,764,2475,1493
32231,Caderousse,84027,84,271,652,260,953,523,1736,923
32232,Cairanne,84028,84,139,261,81,260,240,581,400
32233,Camaret-sur-Aigues,84029,84,439,1189,382,1663,908,2953,1628
32234,Caromb,84030,84,418,734,225,1215,527,1967,1152
32235,Carpentras,84031,84,3959,6927,2971,8987,4797,16755,10886
32236,Caseneuve,84032,84,60,129,32,136,136,304,189
32237,Castellet,84033,84,12,13,4,49,12,65,25
32238,Caumont-sur-Durance,84034,84,466,1077,459,1885,827,3171,1543
32239,Cavaillon,84035,84,3560,6252,3041,8217,4490,15748,9812
32240,Châteauneuf-de-Gadagne,84036,84,405,680,210,1322,595,2127,1085
32241,Châteauneuf-du-Pape,84037,84,244,519,250,625,441,1316,763
32242,Cheval-Blanc,84038,84,445,962,284,1366,917,2567,1407
32243,Courthézon,84039,84,693,1264,518,1843,933,3294,1957
32244,Crestet,84040,84,56,94,30,130,52,212,150
32245,Crillon-le-Brave,84041,84,64,93,8,207,54,269,157
32246,Cucuron,84042,84,254,321,133,640,283,1056,575
32247,Entraigues-sur-la-Sorgue,84043,84,948,1972,880,2732,1571,5183,2920
32248,Entrechaux,84044,84,172,281,68,383,218,669,453
32249,Faucon,84045,84,59,88,24,153,42,219,147
32250,Flassan,84046,84,41,104,0,189,74,263,145
32251,Gargas,84047,84,489,489,214,1246,380,1840,978
32252,Gignac,84048,84,0,20,0,36,4,40,20
32253,Gigondas,84049,84,50,105,65,198,105,368,155
32254,Gordes,84050,84,384,304,95,793,263,1151,688
32255,Goult,84051,84,169,188,58,438,178,674,357
32256,Grambois,84052,84,259,285,90,419,185,694,544
32257,Grillon,84053,84,260,396,152,652,292,1096,656
32258,L'Isle-sur-la-Sorgue,84054,84,2797,4166,1782,6741,3354,11877,6963
32259,Jonquerettes,84055,84,183,341,134,489,240,863,524
32260,Jonquières,84056,84,404,1413,461,1382,1154,2997,1817
32261,Joucas,84057,84,80,56,24,120,48,192,136
32262,Lacoste,84058,84,68,72,20,204,52,276,140
32263,Lafare,84059,84,12,32,4,24,53,81,44
32264,Lagarde-d'Apt,84060,84,0,4,0,12,8,20,4
32265,Lagarde-Paréol,84061,84,30,80,10,130,60,200,110
32266,Lagnes,84062,84,160,317,140,667,239,1046,477
32267,Lamotte-du-Rhône,84063,84,36,56,56,172,72,300,92
32268,Lapalud,84064,84,446,1008,395,1183,769,2347,1454
32269,Lauris,84065,84,465,822,298,1355,592,2245,1287
32270,Lioux,84066,84,28,76,4,104,36,144,104
32271,Loriol-du-Comtat,84067,84,260,612,147,859,541,1547,872
32272,Lourmarin,84068,84,180,212,64,464,200,728,392
32273,Malaucène,84069,84,453,580,201,926,383,1510,1033
32274,Malemort-du-Comtat,84070,84,153,459,188,506,337,1031,612
32275,Maubec,84071,84,204,504,164,652,360,1176,708
32276,Mazan,84072,84,798,1357,483,2172,917,3572,2155
32277,Ménerbes,84073,84,230,170,55,385,115,555,400
32278,Mérindol,84074,84,284,449,143,708,337,1188,733
32279,Méthamis,84075,84,83,90,12,145,49,206,173
32280,Mirabeau,84076,84,104,308,88,428,276,792,412
32281,Modène,84077,84,32,136,36,100,148,284,168
32282,Mondragon,84078,84,392,1009,379,1193,804,2376,1401
32283,Monieux,84079,84,28,88,36,116,72,224,116
32284,Monteux,84080,84,1440,3342,1325,3749,2473,7547,4782
32285,Morières-lès-Avignon,84081,84,1118,1832,671,2808,1475,4954,2950
32286,Mormoiron,84082,84,260,484,132,652,348,1132,744
32287,Mornas,84083,84,259,571,225,799,509,1533,830
32288,La Motte-d'Aigues,84084,84,164,324,116,500,224,840,488
32289,Murs,84085,84,80,96,44,116,88,248,176
32290,Oppède,84086,84,216,264,124,500,204,828,480
32291,Orange,84087,84,3989,7273,3063,8849,5092,17004,11262
32292,Pernes-les-Fontaines,84088,84,1505,2169,783,3742,1495,6020,3674
32293,Pertuis,84089,84,2617,4471,2315,6332,3458,12105,7088
32294,Peypin-d'Aigues,84090,84,47,167,30,251,106,387,214
32295,Piolenc,84091,84,595,1245,465,1785,970,3220,1840
32296,Le Pontet,84092,84,2042,4271,1957,5086,2902,9945,6313
32297,Puget,84093,84,124,144,34,288,68,390,268
32298,Puyméras,84094,84,99,125,15,284,90,389,224
32299,Puyvert,84095,84,112,196,48,252,160,460,308
32300,Rasteau,84096,84,105,155,100,310,135,545,260
32301,Richerenches,84097,84,50,196,50,219,123,392,246
32302,Roaix,84098,84,68,168,52,240,132,424,236
32303,Robion,84099,84,636,911,351,1490,678,2519,1547
32304,La Roque-Alric,84100,84,10,6,0,13,9,22,16
32305,La Roque-sur-Pernes,84101,84,50,80,30,180,65,275,130
32306,Roussillon,84102,84,204,248,100,556,212,868,452
32307,Rustrel,84103,84,110,179,40,306,94,440,289
32308,Sablet,84104,84,211,267,48,383,199,630,478
32309,Saignon,84105,84,177,180,40,427,169,636,357
32310,Sainte-Cécile-les-Vignes,84106,84,388,542,182,744,413,1339,930
32311,Saint-Christol,84107,84,35,150,45,240,105,390,185
32312,Saint-Didier,84108,84,380,395,140,765,250,1155,775
32313,Saint-Hippolyte-le-Graveyron,84109,84,40,45,10,45,25,80,85
32314,Saint-Léger-du-Ventoux,84110,84,8,0,8,20,0,28,8
32315,Saint-Marcellin-lès-Vaison,84111,84,57,50,25,110,50,185,107
32316,Saint-Martin-de-Castillon,84112,84,104,132,43,195,124,362,236
32317,Saint-Martin-de-la-Brasque,84113,84,90,217,33,267,174,474,307
32318,Saint-Pantaléon,84114,84,28,64,12,32,64,108,92
32319,Saint-Pierre-de-Vassols,84115,84,34,110,47,180,100,327,144
32320,Saint-Romain-en-Viennois,84116,84,120,170,45,403,105,553,290
32321,Saint-Roman-de-Malegarde,84117,84,30,80,40,110,75,225,110
32322,Saint-Saturnin-lès-Apt,84118,84,465,530,185,1090,390,1665,995
32323,Saint-Saturnin-lès-Avignon,84119,84,665,1105,385,1855,720,2960,1770
32324,Saint-Trinit,84120,84,19,9,6,59,3,68,28
32325,Sannes,84121,84,16,65,16,41,49,106,81
32326,Sarrians,84122,84,625,1492,568,1936,1098,3602,2117
32327,Sault,84123,84,228,264,108,468,236,812,492
32328,Saumane-de-Vaucluse,84124,84,103,216,48,371,140,559,319
32329,Savoillan,84125,84,26,6,7,19,13,39,32
32330,Séguret,84126,84,119,125,34,351,132,517,244
32331,Sérignan-du-Comtat,84127,84,328,624,235,877,373,1485,952
32332,Sivergues,84128,84,0,8,0,20,8,28,8
32333,Sorgues,84129,84,2243,4712,2068,5550,3477,11095,6955
32334,Suzette,84130,84,24,32,0,40,24,64,56
32335,Taillades,84131,84,256,411,158,695,356,1209,667
32336,Le Thor,84132,84,882,2353,721,2892,1660,5273,3235
32337,La Tour-d'Aigues,84133,84,535,1004,319,1427,698,2444,1539
32338,Travaillan,84134,84,65,175,75,230,155,460,240
32339,Uchaux,84135,84,191,253,127,613,246,986,444
32340,Vacqueyras,84136,84,145,294,151,345,261,757,439
32341,Vaison-la-Romaine,84137,84,1440,1178,526,1866,863,3255,2618
32342,Valréas,84138,84,1506,2188,882,3102,1543,5527,3694
32343,Fontaine-de-Vaucluse,84139,84,58,143,66,202,107,375,201
32344,Vaugines,84140,84,79,109,46,149,109,304,188
32345,Vedène,84141,84,1029,2903,1101,3527,2191,6819,3932
32346,Velleron,84142,84,416,594,215,1114,448,1777,1010
32347,Venasque,84143,84,263,124,66,394,92,552,387
32348,Viens,84144,84,146,104,24,188,85,297,250
32349,Villars,84145,84,109,195,55,266,172,493,304
32350,Villedieu,84146,84,84,120,12,176,128,316,204
32351,Villelaure,84147,84,274,885,266,1178,581,2025,1159
32352,Villes-sur-Auzon,84148,84,164,300,160,440,224,824,464
32353,Violès,84149,84,203,384,123,492,285,900,587
32354,Visan,84150,84,228,432,169,763,276,1208,660
32355,Vitrolles-en-Lubéron,84151,84,44,44,4,96,28,128,88
32356,L'Aiguillon-sur-Mer,85001,85,754,201,77,801,172,1050,955
32357,L'Aiguillon-sur-Vie,85002,85,247,415,173,606,367,1146,662
32358,Aizenay,85003,85,825,2504,862,2631,1928,5421,3329
32359,Angles,85004,85,680,415,184,1019,355,1558,1095
32360,Antigny,85005,85,88,204,120,420,164,704,292
32361,Apremont,85006,85,157,452,203,512,369,1084,609
32362,Aubigny-Les Clouzeaux,85008,85,511,1734,441,2065,1305,3811,2245
32363,Auzay,85009,85,60,184,64,184,136,384,244
32364,Avrillé,85010,85,184,271,103,469,216,788,455
32365,Barbâtre,85011,85,365,332,136,618,297,1051,697
32366,La Barre-de-Monts,85012,85,499,370,130,698,338,1166,869
32367,Bazoges-en-Paillers,85013,85,53,377,201,297,341,839,430
32368,Bazoges-en-Pareds,85014,85,140,332,84,404,216,704,472
32369,Beaufou,85015,85,100,460,170,370,325,865,560
32370,Beaulieu-sous-la-Roche,85016,85,192,529,220,700,432,1352,721
32371,Beaurepaire,85017,85,156,729,225,528,564,1317,885
32372,Beauvoir-sur-Mer,85018,85,783,663,300,1449,579,2328,1446
32373,Bellevigny,85019,85,325,1660,536,1756,1456,3748,1985
32374,Benet,85020,85,467,960,377,1337,752,2466,1427
32375,La Bernardière,85021,85,88,513,204,472,444,1120,601
32376,Le Bernard,85022,85,200,290,70,460,205,735,490
32377,Bessay,85023,85,35,120,25,158,90,273,155
32378,Bois-de-Céné,85024,85,268,493,182,587,346,1115,761
32379,La Boissière-de-Montaigu,85025,85,173,629,218,632,560,1410,802
32380,La Boissière-des-Landes,85026,85,106,374,128,398,267,793,480
32381,Boufféré,85027,85,144,1041,280,792,938,2010,1185
32382,Bouillé-Courdault,85028,85,56,161,39,136,122,297,217
32383,Bouin,85029,85,408,375,138,757,271,1166,783
32384,Le Boupère,85031,85,331,807,274,943,594,1811,1138
32385,Bourneau,85033,85,31,202,66,236,156,458,233
32386,Bournezeau,85034,85,294,876,286,998,692,1976,1170
32387,Bretignolles-sur-Mer,85035,85,988,730,257,1717,655,2629,1718
32388,La Bretonnière-la-Claye,85036,85,95,155,55,150,115,320,250
32389,Breuil-Barret,85037,85,80,165,45,250,100,395,245
32390,Les Brouzils,85038,85,190,767,215,856,587,1658,957
32391,La Bruffière,85039,85,296,1067,402,1105,860,2367,1363
32392,La Caillère-Saint-Hilaire,85040,85,192,206,57,337,149,543,398
32393,Cezais,85041,85,33,64,32,76,53,161,97
32394,Chaillé-les-Marais,85042,85,259,374,165,623,298,1086,633
32395,Chaix,85044,85,40,110,30,195,85,310,150
32396,La Chaize-Giraud,85045,85,150,240,115,290,200,605,390
32397,La Chaize-le-Vicomte,85046,85,357,1115,365,838,903,2106,1472
32398,Challans,85047,85,3335,4294,1510,6888,3152,11550,7629
32399,Chambretaud,85048,85,192,380,144,456,364,964,572
32400,Champagné-les-Marais,85049,85,190,395,114,639,265,1018,585
32401,Le Champ-Saint-Père,85050,85,303,359,202,623,224,1049,662
32402,Chantonnay,85051,85,1127,2010,617,2655,1534,4806,3137
32403,La Chapelle-Achard,85052,85,117,570,156,542,532,1230,687
32404,La Chapelle-aux-Lys,85053,85,45,55,10,95,55,160,100
32405,La Chapelle-Hermier,85054,85,76,255,40,334,209,583,331
32406,La Chapelle-Palluau,85055,85,89,263,64,261,188,513,352
32407,La Chapelle-Thémer,85056,85,105,70,29,145,34,208,175
32408,Chasnais,85058,85,54,183,42,231,132,405,237
32409,La Châtaigneraie,85059,85,345,480,210,953,349,1512,825
32410,Château-d'Olonne,85060,85,3216,2311,873,5448,1711,8032,5527
32411,Château-Guibert,85061,85,172,440,136,396,312,844,612
32412,Châteauneuf,85062,85,90,305,60,280,260,600,395
32413,Chauché,85064,85,292,558,248,732,513,1493,850
32414,Chavagnes-en-Paillers,85065,85,400,875,336,985,677,1998,1275
32415,Chavagnes-les-Redoux,85066,85,88,238,64,192,172,428,326
32416,Cheffois,85067,85,80,257,85,273,236,594,337
32417,Coëx,85070,85,381,691,198,1095,530,1823,1072
32418,Commequiers,85071,85,445,787,353,933,634,1920,1232
32419,La Copechagnière,85072,85,40,268,164,276,196,636,308
32420,Corpe,85073,85,72,383,132,228,228,588,455
32421,La Couture,85074,85,40,60,16,80,28,124,100
32422,Cugand,85076,85,284,821,275,1149,620,2044,1105
32423,Curzon,85077,85,58,130,20,138,102,260,188
32424,Damvix,85078,85,101,150,28,302,111,441,251
32425,Doix lès Fontaines,85080,85,145,399,144,592,302,1038,544
32426,Dompierre-sur-Yon,85081,85,238,1188,305,1479,838,2622,1426
32427,Les Epesses,85082,85,224,684,364,852,598,1814,908
32428,L'Épine,85083,85,350,268,73,628,218,919,618
32429,Essarts en Bocage,85084,85,751,2440,894,2307,1954,5155,3191
32430,Falleron,85086,85,80,385,179,532,334,1045,465
32431,Faymoreau,85087,85,48,32,20,72,32,124,80
32432,Le Fenouiller,85088,85,868,834,262,1750,660,2672,1702
32433,La Ferrière,85089,85,443,1393,513,1523,1125,3161,1836
32434,Sèvremont,85090,85,555,1745,682,1939,1322,3943,2300
32435,Fontenay-le-Comte,85092,85,2285,2740,1150,4469,1809,7428,5025
32436,Fougeré,85093,85,73,332,93,353,258,704,405
32437,Foussais-Payré,85094,85,197,191,119,387,140,646,388
32438,Froidfond,85095,85,128,505,206,416,455,1077,633
32439,La Garnache,85096,85,442,1228,474,1555,943,2972,1670
32440,La Gaubretière,85097,85,323,770,290,925,655,1870,1093
32441,La Génétouze,85098,85,125,534,170,642,400,1212,659
32442,Le Girouard,85099,85,80,272,70,340,238,648,352
32443,Givrand,85100,85,268,460,136,721,348,1205,728
32444,Le Givre,85101,85,20,130,20,213,105,338,150
32445,Grand'Landes,85102,85,44,185,80,128,144,352,229
32446,Grosbreuil,85103,85,198,569,124,625,505,1254,767
32447,Grues,85104,85,190,140,30,364,105,499,330
32448,Le Gué-de-Velluire,85105,85,85,115,45,210,70,325,200
32449,La Guérinière,85106,85,288,271,55,531,261,847,559
32450,La Guyonnière,85107,85,161,731,310,811,593,1714,892
32451,L'Herbergement,85108,85,204,875,325,778,757,1860,1079
32452,Les Herbiers,85109,85,1649,3903,1665,5254,2928,9847,5552
32453,L'Hermenault,85110,85,140,188,40,284,128,452,328
32454,L'Île-d'Elle,85111,85,216,375,108,501,322,931,591
32455,L'Île-d'Olonne,85112,85,280,712,120,1082,506,1708,992
32456,L'Île-d'Yeu,85113,85,766,828,411,1686,827,2924,1594
32457,Jard-sur-Mer,85114,85,883,222,80,1155,175,1410,1105
32458,La Jaudonnière,85115,85,68,156,68,172,132,372,224
32459,La Jonchère,85116,85,72,96,24,168,60,252,168
32460,Lairoux,85117,85,61,119,23,252,96,371,180
32461,Landeronde,85118,85,145,675,175,855,440,1470,820
32462,Les Landes-Genusson,85119,85,211,587,235,652,431,1318,798
32463,Landevieille,85120,85,203,336,71,355,302,728,539
32464,Le Langon,85121,85,137,244,96,406,190,692,381
32465,Liez,85123,85,16,76,32,108,48,188,92
32466,Loge-Fougereuse,85125,85,44,76,28,144,72,244,120
32467,Longèves,85126,85,108,308,112,483,260,855,416
32468,Longeville-sur-Mer,85127,85,641,340,135,887,350,1372,981
32469,Luçon,85128,85,1836,1632,910,3270,1244,5424,3468
32470,Les Lucs-sur-Boulogne,85129,85,300,846,375,951,751,2077,1146
32471,Maché,85130,85,114,370,105,431,306,842,484
32472,Les Magnils-Reigniers,85131,85,119,406,105,653,306,1064,525
32473,Maillé,85132,85,100,175,75,250,120,445,275
32474,Maillezais,85133,85,160,180,64,352,168,584,340
32475,Mallièvre,85134,85,78,62,20,63,50,133,140
32476,Mareuil-sur-Lay-Dissais,85135,85,462,655,275,895,405,1575,1117
32477,Marillet,85136,85,20,35,0,45,20,65,55
32478,Marsais-Sainte-Radégonde,85137,85,48,132,44,200,124,368,180
32479,Martinet,85138,85,80,302,120,265,277,662,382
32480,Le Mazeau,85139,85,100,92,28,160,76,264,192
32481,La Meilleraie-Tillay,85140,85,226,352,126,586,255,967,578
32482,Menomblet,85141,85,57,168,25,249,101,375,225
32483,La Merlatière,85142,85,35,282,72,285,263,620,317
32484,Mervent,85143,85,170,225,75,425,140,640,395
32485,Mesnard-la-Barotière,85144,85,88,387,164,365,322,851,475
32486,Monsireigne,85145,85,90,255,105,285,214,604,345
32487,Montaigu,85146,85,696,1167,561,1541,907,3009,1863
32488,Montournais,85147,85,250,415,115,600,300,1015,665
32489,Montreuil,85148,85,105,185,85,235,165,485,290
32490,Moreilles,85149,85,16,104,44,124,72,240,120
32491,Mortagne-sur-Sèvre,85151,85,622,1420,431,2090,1017,3538,2042
32492,La Mothe-Achard,85152,85,344,664,231,869,571,1671,1008
32493,Mouchamps,85153,85,316,721,323,834,606,1763,1037
32494,Mouilleron-Saint-Germain,85154,85,144,472,138,608,334,1080,616
32495,Mouilleron-le-Captif,85155,85,403,1346,302,1684,932,2918,1749
32496,Moutiers-les-Mauxfaits,85156,85,345,481,181,583,354,1118,826
32497,Moutiers-sur-le-Lay,85157,85,134,149,105,217,97,419,283
32498,Mouzeuil-Saint-Martin,85158,85,144,332,136,400,220,756,476
32499,Nalliers,85159,85,335,555,215,750,390,1355,890
32500,Nesmy,85160,85,184,807,260,898,642,1800,991
32501,Nieul-le-Dolent,85161,85,256,622,214,743,430,1387,878
32502,Nieul-sur-l'Autise,85162,85,132,369,124,332,252,708,501
32503,Noirmoutier-en-l'Île,85163,85,1051,711,261,1807,557,2625,1762
32504,Notre-Dame-de-Monts,85164,85,408,332,144,704,304,1152,740
32505,Olonne-sur-Mer,85166,85,2268,3010,1082,5779,2271,9132,5278
32506,L'Orbrie,85167,85,63,173,36,321,150,507,236
32507,Oulmes,85168,85,80,245,80,235,160,475,325
32508,Palluau,85169,85,80,365,80,273,228,581,445
32509,Péault,85171,85,70,185,70,175,90,335,255
32510,Le Perrier,85172,85,225,445,104,699,345,1148,670
32511,Petosse,85174,85,45,225,85,187,155,427,270
32512,Les Pineaux,85175,85,72,196,88,148,116,352,268
32513,Pissotte,85176,85,144,203,71,413,150,634,347
32514,Le Poiré-sur-Velluire,85177,85,122,139,29,167,115,311,261
32515,Le Poiré-sur-Vie,85178,85,586,2486,779,2447,1830,5056,3072
32516,Poiroux,85179,85,138,247,117,341,159,617,385
32517,Pouillé,85181,85,95,175,40,175,125,340,270
32518,Pouzauges,85182,85,630,1335,550,1840,970,3360,1965
32519,Puy-de-Serre,85184,85,64,84,24,104,56,184,148
32520,Puyravault,85185,85,76,184,24,160,180,364,260
32521,La Rabatelière,85186,85,88,250,108,288,184,580,338
32522,Réaumur,85187,85,100,225,70,250,160,480,325
32523,La Réorthe,85188,85,115,305,80,350,255,685,420
32524,Notre-Dame-de-Riez,85189,85,228,545,125,713,380,1218,773
32525,Rocheservière,85190,85,324,865,252,812,752,1816,1189
32526,La Roche-sur-Yon,85191,85,6653,12263,6850,16548,8793,32191,18916
32527,Rochetrejoux,85192,85,95,257,76,231,201,508,352
32528,Rosnay,85193,85,94,150,29,135,128,292,244
32529,Les Sables-d'Olonne,85194,85,4816,1735,703,5114,1482,7299,6551
32530,Saint-André-Goule-d'Oie,85196,85,108,513,152,479,490,1121,621
32531,Montréverd,85197,85,205,1025,395,861,824,2080,1230
32532,Saint-Aubin-des-Ormeaux,85198,85,116,380,124,420,280,824,496
32533,Saint-Aubin-la-Plaine,85199,85,48,176,88,120,96,304,224
32534,Saint-Avaugourd-des-Landes,85200,85,105,260,75,350,225,650,365
32535,Saint-Benoist-sur-Mer,85201,85,68,84,16,180,80,276,152
32536,Sainte-Cécile,85202,85,123,472,141,396,342,879,595
32537,Saint-Christophe-du-Ligneron,85204,85,199,663,355,737,502,1594,862
32538,Saint-Cyr-des-Gâts,85205,85,60,135,25,228,85,338,195
32539,Saint-Cyr-en-Talmondais,85206,85,49,58,12,149,54,215,107
32540,Saint-Denis-du-Payré,85207,85,100,72,16,132,64,212,172
32541,Saint-Denis-la-Chevasse,85208,85,174,629,216,614,491,1321,803
32542,Saint-Étienne-de-Brillouet,85209,85,24,165,54,159,140,353,189
32543,Saint-Étienne-du-Bois,85210,85,198,553,260,507,425,1192,751
32544,Sainte-Flaive-des-Loups,85211,85,170,650,300,669,550,1519,820
32545,Rives de l'Yon,85213,85,422,997,289,1375,775,2439,1419
32546,Sainte-Foy,85214,85,144,459,176,705,368,1249,603
32547,Saint-Fulgent,85215,85,424,954,409,1047,775,2231,1378
32548,Sainte-Gemme-la-Plaine,85216,85,177,525,188,613,407,1208,702
32549,Saint-Georges-de-Montaigu,85217,85,265,1205,485,1275,947,2707,1470
32550,Saint-Georges-de-Pointindoux,85218,85,116,460,148,536,372,1056,576
32551,Saint-Germain-de-Prinçay,85220,85,135,383,179,500,259,938,518
32552,Saint-Gervais,85221,85,370,634,194,754,532,1480,1004
32553,Saint-Gilles-Croix-de-Vie,85222,85,1898,1027,514,2901,873,4288,2925
32554,Sainte-Hermine,85223,85,353,789,226,796,538,1560,1142
32555,Saint-Hilaire-de-Loulay,85224,85,302,1326,354,1377,1019,2750,1628
32556,Saint-Hilaire-de-Riez,85226,85,2693,1933,661,4497,1520,6678,4626
32557,Saint-Hilaire-des-Loges,85227,85,235,510,145,654,330,1129,745
32558,Saint-Hilaire-de-Voust,85229,85,114,148,42,195,102,339,262
32559,Saint-Hilaire-la-Forêt,85231,85,112,184,36,332,160,528,296
32560,Saint-Hilaire-le-Vouhis,85232,85,65,285,120,339,214,673,350
32561,Saint-Jean-de-Beugné,85233,85,33,152,43,186,122,351,185
32562,Saint-Jean-de-Monts,85234,85,1662,1403,562,3322,1117,5001,3065
32563,Saint-Juire-Champgillon,85235,85,45,110,75,115,60,250,155
32564,Saint-Julien-des-Landes,85236,85,276,395,172,456,333,961,671
32565,Saint-Laurent-de-la-Salle,85237,85,55,90,35,160,30,225,145
32566,Saint-Laurent-sur-Sèvre,85238,85,333,843,265,970,687,1922,1176
32567,Saint-Maixent-sur-Vie,85239,85,50,270,95,348,260,703,320
32568,Saint-Malô-du-Bois,85240,85,109,491,151,404,380,935,600
32569,Saint-Mars-la-Réorthe,85242,85,123,240,35,250,245,530,363
32570,Brem-sur-Mer,85243,85,558,440,160,948,374,1482,998
32571,Saint-Martin-de-Fraigneau,85244,85,56,178,61,288,148,497,234
32572,Saint-Martin-des-Fontaines,85245,85,16,26,16,37,43,96,42
32573,Saint-Martin-des-Noyers,85246,85,285,595,260,679,414,1353,880
32574,Saint-Martin-des-Tilleuls,85247,85,95,310,105,310,210,625,405
32575,Saint-Martin-Lars-en-Sainte-Hermine,85248,85,65,78,45,130,43,218,143
32576,Saint-Mathurin,85250,85,208,566,248,628,489,1365,774
32577,Saint-Maurice-des-Noues,85251,85,46,134,84,231,104,419,180
32578,Saint-Maurice-le-Girard,85252,85,100,130,40,185,105,330,230
32579,Saint-Mesmin,85254,85,198,423,88,656,286,1030,621
32580,Saint-Michel-en-l'Herm,85255,85,479,382,152,978,256,1386,861
32581,Saint-Michel-le-Cloucq,85256,85,140,288,112,520,184,816,428
32582,Saint-Paul-en-Pareds,85259,85,77,366,132,343,320,795,443
32583,Saint-Paul-Mont-Penit,85260,85,45,221,57,249,145,451,266
32584,Sainte-Pexine,85261,85,40,55,25,80,45,150,95
32585,Saint-Philbert-de-Bouaine,85262,85,260,976,332,792,828,1952,1236
32586,Saint-Pierre-du-Chemin,85264,85,197,272,146,390,149,685,469
32587,Saint-Pierre-le-Vieux,85265,85,75,265,78,325,167,570,340
32588,Saint-Prouant,85266,85,112,381,204,488,280,972,493
32589,Sainte-Radégonde-des-Noyers,85267,85,85,235,60,322,190,572,320
32590,Saint-Révérend,85268,85,154,372,113,469,246,828,526
32591,Saint-Sigismond,85269,85,30,105,35,168,60,263,135
32592,Saint-Sulpice-en-Pareds,85271,85,65,104,28,100,75,203,169
32593,Saint-Urbain,85273,85,103,553,160,513,444,1117,656
32594,Saint-Valérien,85274,85,67,112,44,209,72,325,179
32595,Saint-Vincent-Sterlanges,85276,85,42,192,97,219,155,471,234
32596,Saint-Vincent-sur-Graon,85277,85,94,365,123,455,321,899,459
32597,Saint-Vincent-sur-Jard,85278,85,337,200,72,531,164,767,537
32598,Sallertaine,85280,85,383,740,156,1025,596,1777,1123
32599,Sérigné,85281,85,104,244,80,332,228,640,348
32600,Sigournais,85282,85,96,184,76,332,144,552,280
32601,Soullans,85284,85,675,876,328,1505,690,2523,1551
32602,Le Tablier,85285,85,44,236,96,188,172,456,280
32603,La Taillée,85286,85,89,147,16,172,106,294,236
32604,Tallud-Sainte-Gemme,85287,85,45,130,35,135,120,290,175
32605,Talmont-Saint-Hilaire,85288,85,1163,1421,490,2757,1124,4371,2584
32606,La Tardière,85289,85,170,308,138,470,228,836,478
32607,Thiré,85290,85,100,145,40,175,100,315,245
32608,Thorigny,85291,85,94,305,138,346,305,789,399
32609,Thouarsais-Bouildroux,85292,85,59,155,70,233,180,483,214
32610,Tiffauges,85293,85,200,436,141,442,362,945,636
32611,La Tranche-sur-Mer,85294,85,754,348,108,1160,328,1596,1102
32612,Treize-Septiers,85295,85,254,862,259,985,652,1896,1116
32613,Treize-Vents,85296,85,180,350,110,315,279,704,530
32614,Triaize,85297,85,111,224,80,405,213,698,335
32615,Vairé,85298,85,163,412,109,494,340,943,575
32616,Velluire,85299,85,65,180,54,181,123,358,245
32617,Venansault,85300,85,284,1362,352,1556,1009,2917,1646
32618,Vendrennes,85301,85,128,500,187,336,408,931,628
32619,La Verrie,85302,85,435,910,384,1398,655,2437,1345
32620,Vix,85303,85,249,398,139,597,273,1009,647
32621,Vouillé-les-Marais,85304,85,72,208,48,196,144,388,280
32622,Vouvant,85305,85,116,127,32,362,71,465,243
32623,Xanton-Chassenon,85306,85,35,185,45,290,155,490,220
32624,La Faute-sur-Mer,85307,85,202,91,15,301,60,376,293
32625,Adriers,86001,86,200,75,45,285,60,390,275
32626,Amberre,86002,86,65,159,36,131,125,292,224
32627,Anché,86003,86,44,76,24,148,68,240,120
32628,Angles-sur-l'Anglin,86004,86,132,76,8,112,56,176,208
32629,Angliers,86005,86,75,155,50,220,120,390,230
32630,Antigny,86006,86,152,111,19,161,72,252,263
32631,Antran,86007,86,159,304,90,397,275,762,463
32632,Arçay,86008,86,55,75,40,155,45,240,130
32633,Archigny,86009,86,208,297,76,316,208,600,505
32634,Aslonnes,86010,86,90,315,50,334,299,683,405
32635,Asnières-sur-Blour,86011,86,24,24,4,68,44,116,48
32636,Asnois,86012,86,32,24,8,64,12,84,56
32637,Aulnay,86013,86,9,20,3,51,10,64,29
32638,Availles-en-Châtellerault,86014,86,175,460,125,655,315,1095,635
32639,Availles-Limouzine,86015,86,336,264,84,416,200,700,600
32640,Avanton,86016,86,157,575,135,620,509,1264,732
32641,Ayron,86017,86,175,255,135,344,234,713,430
32642,Basses,86018,86,31,57,18,148,41,207,88
32643,Beaumont,86019,86,178,509,165,646,428,1239,687
32644,Bellefonds,86020,86,28,68,8,80,56,144,96
32645,Benassay,86021,86,72,217,90,221,182,493,289
32646,Berrie,86022,86,40,55,5,100,45,150,95
32647,Berthegon,86023,86,44,77,20,84,42,146,121
32648,Béruges,86024,86,74,330,83,518,255,856,404
32649,Béthines,86025,86,74,67,15,144,61,220,141
32650,Beuxes,86026,86,70,155,30,135,160,325,225
32651,Biard,86027,86,164,373,187,484,291,962,537
32652,Bignoux,86028,86,92,241,37,385,223,645,333
32653,Blanzay,86029,86,133,190,25,325,110,460,323
32654,Blaslay,86030,86,36,160,52,184,120,356,196
32655,Bonnes,86031,86,195,425,85,615,385,1085,620
32656,Bonneuil-Matours,86032,86,205,570,175,715,435,1325,775
32657,Bouresse,86034,86,84,115,65,225,70,360,199
32658,Bourg-Archambault,86035,86,40,25,5,95,15,115,65
32659,Bournand,86036,86,133,205,70,224,195,489,338
32660,Brigueil-le-Chantre,86037,86,96,71,20,220,40,280,167
32661,Brion,86038,86,20,64,8,92,56,156,84
32662,Brux,86039,86,148,132,32,270,140,442,280
32663,La Bussière,86040,86,85,50,25,125,50,200,135
32664,Buxerolles,86041,86,1460,2185,1400,3245,1577,6222,3645
32665,Buxeuil,86042,86,136,236,60,372,164,596,372
32666,Ceaux-en-Couhé,86043,86,54,135,30,190,100,320,189
32667,Ceaux-en-Loudun,86044,86,70,117,20,189,139,348,187
32668,Celle-Lévescault,86045,86,180,376,92,336,336,764,556
32669,Cenon-sur-Vienne,86046,86,275,340,160,730,295,1185,615
32670,Cernay,86047,86,80,124,32,132,92,256,204
32671,Chabournay,86048,86,85,322,57,242,295,594,407
32672,Chalais,86049,86,68,108,36,220,96,352,176
32673,Chalandray,86050,86,112,196,88,200,172,460,308
32674,Champagné-le-Sec,86051,86,30,40,10,80,45,135,70
32675,Champagné-Saint-Hilaire,86052,86,124,259,100,308,175,583,383
32676,Champigny-le-Sec,86053,86,94,323,68,299,250,617,417
32677,Champniers,86054,86,80,50,15,140,65,220,130
32678,La Chapelle-Bâton,86055,86,75,54,8,113,41,162,129
32679,La Chapelle-Montreuil,86056,86,65,185,73,215,185,473,250
32680,La Chapelle-Moulière,86058,86,76,176,44,216,152,412,252
32681,Chapelle-Viviers,86059,86,64,143,48,128,117,293,207
32682,Charrais,86060,86,60,335,135,195,330,660,395
32683,Charroux,86061,86,312,185,80,447,141,668,497
32684,Chasseneuil-du-Poitou,86062,86,416,912,1158,1269,862,3289,1328
32685,Chatain,86063,86,35,45,15,105,45,165,80
32686,Château-Garnier,86064,86,115,160,25,185,105,315,275
32687,Château-Larcher,86065,86,88,272,40,376,220,636,360
32688,Châtellerault,86066,86,5773,6938,2991,10529,4721,18241,12711
32689,Châtillon,86067,86,12,80,20,64,72,156,92
32690,Chaunay,86068,86,220,185,93,335,164,592,405
32691,La Chaussée,86069,86,25,35,15,85,40,140,60
32692,Chauvigny,86070,86,1209,1455,565,2191,1285,4041,2664
32693,Cheneché,86071,86,8,93,26,108,82,216,101
32694,Chenevelles,86072,86,85,140,25,105,90,220,225
32695,Cherves,86073,86,125,140,25,185,125,335,265
32696,Chiré-en-Montreuil,86074,86,128,236,96,252,180,528,364
32697,Chouppes,86075,86,70,195,50,270,155,475,265
32698,Cissé,86076,86,200,734,204,884,644,1732,934
32699,Civaux,86077,86,160,308,100,268,252,620,468
32700,Civray,86078,86,709,433,125,740,315,1180,1142
32701,La Roche-Rigault,86079,86,100,77,40,176,76,292,177
32702,Cloué,86080,86,68,132,36,128,144,308,200
32703,Colombiers,86081,86,168,340,89,460,265,814,508
32704,Couhé,86082,86,369,375,122,491,259,872,744
32705,Coulombiers,86083,86,137,257,86,372,171,629,394
32706,Coulonges,86084,86,60,10,10,125,20,155,70
32707,Coussay,86085,86,49,44,30,49,34,113,93
32708,Coussay-les-Bois,86086,86,192,235,65,236,171,472,427
32709,Craon,86087,86,46,23,20,50,20,90,69
32710,Croutelle,86088,86,105,215,70,275,145,490,320
32711,Cuhon,86089,86,50,95,30,140,70,240,145
32712,Curçay-sur-Dive,86090,86,25,45,0,120,25,145,70
32713,Curzay-sur-Vonne,86091,86,60,90,45,119,100,264,150
32714,Dangé-Saint-Romain,86092,86,460,640,205,1225,445,1875,1100
32715,Dercé,86093,86,45,40,0,50,15,65,85
32716,Dienné,86094,86,31,142,87,92,130,309,173
32717,Dissay,86095,86,244,942,359,923,692,1974,1186
32718,Doussay,86096,86,76,165,76,200,144,420,241
32719,La Ferrière-Airoux,86097,86,65,70,10,105,65,180,135
32720,Fleix,86098,86,20,66,0,50,40,90,86
32721,Fleuré,86099,86,104,272,121,278,219,618,376
32722,Fontaine-le-Comte,86100,86,437,866,346,1418,733,2497,1303
32723,Frozes,86102,86,36,172,56,136,145,337,208
32724,Gençay,86103,86,406,298,168,499,197,864,704
32725,Genouillé,86104,86,115,85,35,200,65,300,200
32726,Gizay,86105,86,12,104,20,136,116,272,116
32727,Glénouze,86106,86,20,12,4,64,0,68,32
32728,Gouex,86107,86,65,114,40,219,90,349,179
32729,La Grimaudière,86108,86,80,58,31,121,38,190,138
32730,Guesnes,86109,86,52,32,20,88,32,140,84
32731,Haims,86110,86,24,60,36,68,40,144,84
32732,Ingrandes,86111,86,245,400,135,675,285,1095,645
32733,L'Isle-Jourdain,86112,86,345,154,52,345,99,496,499
32734,Iteuil,86113,86,294,688,173,1062,507,1742,982
32735,Jardres,86114,86,148,370,86,307,281,674,518
32736,Jaunay-Clan,86115,86,646,1452,834,1661,1299,3794,2098
32737,Jazeneuil,86116,86,111,183,70,266,175,511,294
32738,Jouhet,86117,86,52,120,48,196,88,332,172
32739,Journet,86118,86,77,69,20,117,47,184,146
32740,Joussé,86119,86,92,30,5,120,50,175,122
32741,Lathus-Saint-Rémy,86120,86,330,215,60,415,155,630,545
32742,Latillé,86121,86,224,360,80,436,328,844,584
32743,Lauthiers,86122,86,16,21,4,21,4,29,37
32744,Lavausseau,86123,86,64,212,108,276,128,512,276
32745,Lavoux,86124,86,91,284,96,401,216,713,375
32746,Leigné-les-Bois,86125,86,57,144,49,152,116,317,201
32747,Leignes-sur-Fontaine,86126,86,50,185,70,155,155,380,235
32748,Leigné-sur-Usseau,86127,86,65,109,60,86,98,244,174
32749,Lencloître,86128,86,395,540,140,845,440,1425,935
32750,Lésigny,86129,86,83,119,16,175,102,293,202
32751,Leugny,86130,86,80,100,40,135,70,245,180
32752,Lhommaizé,86131,86,125,224,109,187,204,500,349
32753,Liglet,86132,86,84,40,0,152,40,192,124
32754,Ligugé,86133,86,374,730,214,1128,670,2012,1104
32755,Linazay,86134,86,16,48,30,86,12,128,64
32756,Liniers,86135,86,17,121,58,218,89,365,138
32757,Lizant,86136,86,82,77,15,148,37,200,159
32758,Loudun,86137,86,1208,1297,571,2378,973,3922,2505
32759,Luchapt,86138,86,66,30,10,106,20,136,96
32760,Lusignan,86139,86,445,525,160,855,425,1440,970
32761,Lussac-les-Châteaux,86140,86,475,485,165,820,300,1285,960
32762,Magné,86141,86,100,165,30,227,145,402,265
32763,Maillé,86142,86,75,240,25,147,180,352,315
32764,Mairé,86143,86,50,20,0,65,15,80,70
32765,Maisonneuve,86144,86,34,81,25,100,48,173,115
32766,Marçay,86145,86,47,321,103,338,240,681,368
32767,Marigny-Brizay,86146,86,109,405,90,420,285,795,514
32768,Marigny-Chemereau,86147,86,68,163,54,111,130,295,231
32769,Marnay,86148,86,64,208,76,212,136,424,272
32770,Martaizé,86149,86,65,65,30,135,75,240,130
32771,Massognes,86150,86,20,76,36,84,76,196,96
32772,Maulay,86151,86,44,34,9,46,19,74,78
32773,Mauprévoir,86152,86,174,82,47,201,51,299,256
32774,Mazerolles,86153,86,121,189,65,218,178,461,310
32775,Mazeuil,86154,86,60,42,20,50,29,99,102
32776,Messemé,86156,86,13,48,22,78,35,135,61
32777,Mignaloux-Beauvoir,86157,86,358,1044,434,1486,724,2644,1402
32778,Migné-Auxances,86158,86,608,1379,522,2212,1050,3784,1987
32779,Millac,86159,86,75,96,49,209,46,304,171
32780,Mirebeau,86160,86,309,561,173,609,374,1156,870
32781,Moncontour,86161,86,182,182,52,303,129,484,364
32782,Mondion,86162,86,21,9,12,34,9,55,30
32783,Montamisé,86163,86,329,904,239,1262,655,2156,1233
32784,Monthoiron,86164,86,45,140,55,245,165,465,185
32785,Montmorillon,86165,86,1089,968,488,2210,822,3520,2057
32786,Montreuil-Bonnin,86166,86,60,232,32,200,212,444,292
32787,Monts-sur-Guesnes,86167,86,90,166,73,185,80,338,256
32788,Morton,86169,86,35,115,35,100,75,210,150
32789,Moulismes,86170,86,65,83,32,91,64,187,148
32790,Moussac,86171,86,100,55,20,192,70,282,155
32791,Mouterre-sur-Blourde,86172,86,10,26,16,44,10,70,36
32792,Mouterre-Silly,86173,86,103,146,59,165,144,368,249
32793,Naintré,86174,86,792,1411,469,2030,981,3480,2203
32794,Nalliers,86175,86,40,69,24,111,37,172,109
32795,Nérignac,86176,86,48,15,0,18,17,35,63
32796,Neuville-de-Poitou,86177,86,595,1273,611,1578,1026,3215,1868
32797,Nieuil-l'Espoir,86178,86,198,702,162,714,581,1457,900
32798,Nouaillé-Maupertuis,86180,86,250,675,180,1060,530,1770,925
32799,Nueil-sous-Faye,86181,86,58,42,0,94,26,120,100
32800,Orches,86182,86,51,77,47,142,34,223,128
32801,Les Ormes,86183,86,190,436,150,540,345,1035,626
32802,Ouzilly,86184,86,99,273,29,233,196,458,372
32803,Oyré,86186,86,100,237,60,376,205,641,337
32804,Paizay-le-Sec,86187,86,85,125,25,159,85,269,210
32805,Payré,86188,86,124,244,92,328,224,644,368
32806,Payroux,86189,86,75,60,30,135,55,220,135
32807,Persac,86190,86,226,165,40,247,106,393,391
32808,Pindray,86191,86,44,42,12,99,32,143,86
32809,Plaisance,86192,86,35,45,5,50,35,90,80
32810,Pleumartin,86193,86,174,255,110,349,213,672,429
32811,Poitiers,86194,86,8873,19709,20302,20298,13916,54516,28582
32812,Port-de-Piles,86195,86,94,151,56,121,80,257,245
32813,Pouançay,86196,86,8,49,0,84,53,137,57
32814,Pouant,86197,86,42,77,16,185,38,239,119
32815,Pouillé,86198,86,43,186,52,168,148,368,229
32816,Pressac,86200,86,135,100,45,205,70,320,235
32817,Prinçay,86201,86,31,41,15,63,30,108,72
32818,La Puye,86202,86,100,132,28,164,88,280,232
32819,Queaux,86203,86,107,51,43,171,53,267,158
32820,Quinçay,86204,86,180,600,150,705,500,1355,780
32821,Ranton,86205,86,37,40,6,47,34,87,77
32822,Raslay,86206,86,26,18,4,41,8,53,44
32823,La Roche-Posay,86207,86,265,320,130,590,225,945,585
32824,Le Rochereau,86208,86,80,240,70,205,205,480,320
32825,Roches-Prémarie-Andillé,86209,86,155,500,165,685,450,1300,655
32826,Roiffé,86210,86,45,222,54,213,167,434,267
32827,Romagne,86211,86,172,186,37,239,128,404,358
32828,Rouillé,86213,86,330,568,206,785,425,1416,898
32829,Saint-Benoît,86214,86,1225,1481,804,2370,935,4109,2706
32830,Saint-Christophe,86217,86,44,87,3,114,45,162,131
32831,Saint-Clair,86218,86,32,60,28,56,40,124,92
32832,Saint-Cyr,86219,86,116,298,88,308,257,653,414
32833,Saint-Gaudent,86220,86,35,45,15,155,35,205,80
32834,Saint-Genest-d'Ambière,86221,86,150,305,90,390,295,775,455
32835,Saint-Georges-lès-Baillargeaux,86222,86,371,1064,380,1389,699,2468,1435
32836,Saint-Germain,86223,86,265,180,100,340,65,505,445
32837,Saint-Gervais-les-Trois-Clochers,86224,86,170,320,85,415,275,775,490
32838,Saint-Jean-de-Sauves,86225,86,214,319,88,379,230,697,533
32839,Saint-Julien-l'Ars,86226,86,204,610,214,865,520,1599,814
32840,Saint-Laon,86227,86,24,20,0,60,20,80,44
32841,Saint-Laurent-de-Jourdes,86228,86,32,56,12,24,76,112,88
32842,Saint-Léger-de-Montbrillais,86229,86,64,92,16,148,64,228,156
32843,Saint-Léomer,86230,86,38,12,8,75,8,91,50
32844,Saint-Macoux,86231,86,85,110,10,169,100,279,195
32845,Valdivienne,86233,86,348,692,241,793,627,1661,1040
32846,Saint-Martin-l'Ars,86234,86,109,45,20,110,35,165,154
32847,Saint-Maurice-la-Clouère,86235,86,150,375,85,440,275,800,525
32848,Saint-Pierre-de-Maillé,86236,86,212,120,76,292,96,464,332
32849,Saint-Pierre-d'Exideuil,86237,86,99,136,39,245,131,415,235
32850,Sainte-Radégonde,86239,86,20,30,5,60,45,110,50
32851,Saint-Rémy-sur-Creuse,86241,86,90,50,40,160,40,240,140
32852,Saint-Romain,86242,86,90,80,20,190,30,240,170
32853,Saint-Sauvant,86244,86,180,293,135,371,262,768,473
32854,Senillé-Saint-Sauveur,86245,86,117,425,137,740,292,1169,542
32855,Saint-Savin,86246,86,224,164,44,288,144,476,388
32856,Saint-Saviol,86247,86,92,108,38,152,74,264,200
32857,Saint-Secondin,86248,86,105,129,25,190,98,313,234
32858,Saires,86249,86,20,25,5,45,25,75,45
32859,Saix,86250,86,40,97,28,48,76,152,137
32860,Sammarçolles,86252,86,60,155,65,255,100,420,215
32861,Sanxay,86253,86,116,84,40,192,104,336,200
32862,Saulgé,86254,86,164,200,68,396,168,632,364
32863,Savigné,86255,86,265,280,90,580,140,810,545
32864,Savigny-Lévescault,86256,86,80,300,125,413,235,773,380
32865,Savigny-sous-Faye,86257,86,44,102,36,96,88,220,146
32866,Scorbé-Clairvaux,86258,86,270,541,175,866,401,1442,811
32867,Sérigny,86260,86,76,60,44,84,60,188,136
32868,Sèvres-Anxaumont,86261,86,196,476,184,672,396,1252,672
32869,Sillars,86262,86,116,140,55,205,115,375,256
32870,Smarves,86263,86,366,642,177,844,442,1463,1008
32871,Sommières-du-Clain,86264,86,128,235,20,283,135,438,363
32872,Sossais,86265,86,45,125,65,180,50,295,170
32873,Surin,86266,86,28,20,0,45,12,57,48
32874,Tercé,86268,86,83,280,73,376,236,685,363
32875,Ternay,86269,86,25,50,0,60,45,105,75
32876,Thollet,86270,86,60,20,0,50,25,75,80
32877,Thurageau,86271,86,80,220,55,310,145,510,300
32878,Thuré,86272,86,317,675,171,1130,523,1824,992
32879,La Trimouille,86273,86,220,140,60,360,104,524,360
32880,Les Trois-Moutiers,86274,86,160,248,96,336,188,620,408
32881,Usseau,86275,86,43,173,55,178,118,351,216
32882,Usson-du-Poitou,86276,86,289,219,74,398,171,643,508
32883,Varennes,86277,86,20,75,40,125,70,235,95
32884,Vaux,86278,86,85,185,100,306,125,531,270
32885,Vaux-sur-Vienne,86279,86,72,108,40,248,81,369,180
32886,Vellèches,86280,86,61,77,20,129,75,224,138
32887,Vendeuvre-du-Poitou,86281,86,231,896,219,936,763,1918,1127
32888,Vernon,86284,86,60,146,103,190,139,432,206
32889,Verrières,86285,86,117,248,63,243,234,540,365
32890,Verrue,86286,86,64,76,16,140,104,260,140
32891,Vézières,86287,86,36,64,40,148,76,264,100
32892,Vicq-sur-Gartempe,86288,86,132,95,35,284,60,379,227
32893,Le Vigeant,86289,86,110,145,30,235,130,395,255
32894,La Villedieu-du-Clain,86290,86,133,438,91,440,416,947,571
32895,Villemort,86291,86,18,26,3,42,3,48,44
32896,Villiers,86292,86,72,253,83,220,190,493,325
32897,Vivonne,86293,86,395,825,345,1247,689,2281,1220
32898,Vouillé,86294,86,400,960,275,1170,695,2140,1360
32899,Voulême,86295,86,55,40,25,159,75,259,95
32900,Voulon,86296,86,43,115,22,102,115,239,158
32901,Vouneuil-sous-Biard,86297,86,565,1345,679,1839,995,3513,1910
32902,Vouneuil-sur-Vienne,86298,86,240,551,202,567,405,1174,791
32903,Vouzailles,86299,86,80,155,104,161,108,373,235
32904,Yversay,86300,86,40,130,30,100,140,270,170
32905,Aixe-sur-Vienne,87001,87,911,1204,410,2011,970,3391,2115
32906,Ambazac,87002,87,608,1277,388,1962,1038,3388,1885
32907,Arnac-la-Poste,87003,87,178,170,53,342,167,562,348
32908,Augne,87004,87,10,10,15,55,10,80,20
32909,Aureil,87005,87,100,235,80,365,200,645,335
32910,Azat-le-Ris,87006,87,32,29,12,109,30,151,61
32911,Balledent,87007,87,25,45,5,120,30,155,70
32912,La Bazeuge,87008,87,22,17,9,41,16,66,39
32913,Beaumont-du-Lac,87009,87,16,32,16,64,20,100,48
32914,Bellac,87011,87,826,660,300,1342,534,2176,1486
32915,Berneuil,87012,87,55,74,28,115,78,221,129
32916,Bersac-sur-Rivalier,87013,87,100,113,56,151,128,335,213
32917,Bessines-sur-Gartempe,87014,87,450,615,215,1010,495,1720,1065
32918,Beynac,87015,87,88,182,48,184,146,378,270
32919,Les Billanges,87016,87,45,60,0,115,55,170,105
32920,Blanzac,87017,87,64,100,28,208,96,332,164
32921,Blond,87018,87,75,165,45,339,95,479,240
32922,Boisseuil,87019,87,282,720,209,1016,551,1776,1002
32923,Bonnac-la-Côte,87020,87,140,515,130,465,430,1025,655
32924,Bosmie-l'Aiguille,87021,87,258,635,193,918,490,1601,893
32925,Breuilaufa,87022,87,5,30,25,55,25,105,35
32926,Le Buis,87023,87,10,55,25,75,35,135,65
32927,Bujaleuf,87024,87,225,130,25,320,105,450,355
32928,Burgnac,87025,87,60,224,44,296,184,524,284
32929,Bussière-Galant,87027,87,332,208,68,572,184,824,540
32930,Bussière-Poitevine,87028,87,296,128,52,304,124,480,424
32931,Les Cars,87029,87,90,145,30,203,95,328,235
32932,Chaillac-sur-Vienne,87030,87,112,295,64,416,303,783,407
32933,Le Chalard,87031,87,75,55,0,110,60,170,130
32934,Châlus,87032,87,387,202,109,466,206,781,589
32935,Chamboret,87033,87,112,152,52,308,148,508,264
32936,Champagnac-la-Rivière,87034,87,144,88,52,212,84,348,232
32937,Champnétery,87035,87,125,130,35,175,100,310,255
32938,Champsac,87036,87,112,132,52,284,92,428,244
32939,La Chapelle-Montbrandeix,87037,87,61,27,0,96,33,129,88
32940,Chaptelat,87038,87,168,533,132,670,461,1263,701
32941,Château-Chervix,87039,87,101,157,38,247,158,443,258
32942,Châteauneuf-la-Forêt,87040,87,344,300,88,524,248,860,644
32943,Châteauponsac,87041,87,434,360,135,750,273,1158,794
32944,Le Châtenet-en-Dognon,87042,87,28,100,32,93,109,234,128
32945,Cheissoux,87043,87,20,25,15,100,15,130,45
32946,Chéronnac,87044,87,95,16,12,160,12,184,111
32947,Cieux,87045,87,152,207,60,352,151,563,359
32948,Cognac-la-Forêt,87046,87,140,260,120,414,225,759,400
32949,Compreignac,87047,87,260,407,168,539,389,1096,667
32950,Condat-sur-Vienne,87048,87,476,1258,383,1766,995,3144,1734
32951,Coussac-Bonneval,87049,87,260,240,85,505,205,795,500
32952,Couzeix,87050,87,1211,2104,634,3065,1656,5355,3315
32953,La Croisille-sur-Briance,87051,87,192,100,64,248,100,412,292
32954,La Croix-sur-Gartempe,87052,87,43,25,4,67,12,83,68
32955,Cromac,87053,87,52,56,8,108,28,144,108
32956,Cussac,87054,87,244,200,35,463,184,682,444
32957,Darnac,87055,87,84,42,3,148,46,197,126
32958,Dinsac,87056,87,4,34,21,132,28,181,38
32959,Dompierre-les-Églises,87057,87,104,68,32,164,40,236,172
32960,Domps,87058,87,25,8,4,41,22,67,33
32961,Le Dorat,87059,87,375,215,130,625,150,905,590
32962,Dournazac,87060,87,154,94,25,272,68,365,248
32963,Droux,87061,87,66,58,19,144,33,196,124
32964,Eybouleuf,87062,87,35,120,40,135,105,280,155
32965,Eyjeaux,87063,87,92,341,79,398,297,774,433
32966,Eymoutiers,87064,87,472,328,148,732,264,1144,800
32967,Feytiat,87065,87,749,1508,532,1998,1102,3632,2257
32968,Flavignac,87066,87,141,213,56,323,248,627,354
32969,Folles,87067,87,164,88,28,164,48,240,252
32970,Fromental,87068,87,64,145,50,197,109,356,209
32971,Gajoubert,87069,87,53,37,5,45,15,65,90
32972,La Geneytouse,87070,87,86,223,39,266,220,525,309
32973,Glandon,87071,87,130,150,30,280,210,520,280
32974,Glanges,87072,87,83,121,41,120,93,254,204
32975,Gorre,87073,87,44,98,16,128,73,217,142
32976,Les Grands-Chézeaux,87074,87,75,40,15,65,50,130,115
32977,Isle,87075,87,1323,1414,633,2889,1106,4628,2737
32978,Jabreilles-les-Bordes,87076,87,32,51,9,70,42,121,83
32979,Janailhac,87077,87,110,150,20,115,120,255,260
32980,Javerdat,87078,87,80,192,36,268,136,440,272
32981,La Jonchère-Saint-Maurice,87079,87,165,180,65,225,185,475,345
32982,Jouac,87080,87,32,44,20,68,32,120,76
32983,Jourgnac,87081,87,48,289,68,375,258,701,337
32984,Ladignac-le-Long,87082,87,272,196,48,408,160,616,468
32985,Laurière,87083,87,152,89,43,197,58,298,241
32986,Lavignac,87084,87,10,30,5,65,40,110,40
32987,Limoges,87085,87,18560,28651,22872,38302,23063,84237,47211
32988,Linards,87086,87,225,280,50,340,170,560,505
32989,Lussac-les-Églises,87087,87,132,63,12,215,51,278,195
32990,Magnac-Bourg,87088,87,235,240,75,330,225,630,475
32991,Magnac-Laval,87089,87,325,315,55,580,200,835,640
32992,Mailhac-sur-Benaize,87090,87,76,52,16,108,60,184,128
32993,Maisonnais-sur-Tardoire,87091,87,168,30,25,135,30,190,198
32994,Marval,87092,87,160,70,25,245,40,310,230
32995,Masléon,87093,87,44,59,33,92,27,152,103
32996,Meilhac,87094,87,32,196,24,108,180,312,228
32997,Meuzac,87095,87,140,115,30,261,101,392,255
32998,La Meyze,87096,87,153,165,85,263,150,498,318
32999,Val d'Issoire,87097,87,252,204,76,420,144,640,456
33000,Moissannes,87099,87,32,144,16,120,88,224,176
33001,Montrol-Sénard,87100,87,29,52,17,86,52,155,81
33002,Mortemart,87101,87,15,15,10,50,10,70,30
33003,Nantiat,87103,87,309,300,87,428,281,796,609
33004,Nedde,87104,87,71,60,18,194,60,272,131
33005,Neuvic-Entier,87105,87,119,130,52,385,125,562,249
33006,Nexon,87106,87,455,565,230,756,478,1464,1020
33007,Nieul,87107,87,164,394,68,537,357,962,558
33008,Nouic,87108,87,116,80,20,191,50,261,196
33009,Oradour-Saint-Genest,87109,87,78,55,18,105,64,187,133
33010,Oradour-sur-Glane,87110,87,288,531,192,810,471,1473,819
33011,Oradour-sur-Vayres,87111,87,320,275,140,640,170,950,595
33012,Pageas,87112,87,100,100,25,275,80,380,200
33013,Le Palais-sur-Vienne,87113,87,696,1325,494,2325,1052,3871,2021
33014,Panazol,87114,87,1625,2456,677,3824,1704,6205,4081
33015,Pensol,87115,87,72,32,16,40,20,76,104
33016,Peyrat-de-Bellac,87116,87,230,195,40,416,180,636,425
33017,Peyrat-le-Château,87117,87,192,152,44,297,171,512,344
33018,Peyrilhac,87118,87,99,301,119,402,240,761,400
33019,Pierre-Buffière,87119,87,232,232,97,231,216,544,464
33020,La Porcherie,87120,87,85,116,34,159,79,272,201
33021,Rancon,87121,87,45,90,25,230,100,355,135
33022,Razès,87122,87,152,288,164,368,216,748,440
33023,Rempnat,87123,87,29,4,16,61,12,89,33
33024,Rilhac-Lastours,87124,87,76,72,36,128,68,232,148
33025,Rilhac-Rancon,87125,87,627,1133,211,1585,806,2602,1760
33026,Rochechouart,87126,87,610,705,210,1515,575,2300,1315
33027,La Roche-l'Abeille,87127,87,94,108,57,205,80,342,202
33028,Roussac,87128,87,72,99,15,161,64,240,171
33029,Royères,87129,87,60,207,24,351,160,535,267
33030,Roziers-Saint-Georges,87130,87,40,45,15,50,40,105,85
33031,Saillat-sur-Vienne,87131,87,212,152,56,268,144,468,364
33032,Saint-Amand-le-Petit,87132,87,22,9,10,25,6,41,31
33033,Saint-Amand-Magnazeix,87133,87,95,115,25,220,85,330,210
33034,Sainte-Anne-Saint-Priest,87134,87,21,38,12,63,4,79,59
33035,Saint-Auvent,87135,87,136,192,76,376,176,628,328
33036,Saint-Barbant,87136,87,95,69,5,152,25,182,164
33037,Saint-Bazile,87137,87,30,10,20,56,0,76,40
33038,Saint-Bonnet-Briance,87138,87,80,125,55,190,110,355,205
33039,Saint-Bonnet-de-Bellac,87139,87,92,124,32,164,80,276,216
33040,Saint-Brice-sur-Vienne,87140,87,228,357,94,562,340,996,585
33041,Saint-Cyr,87141,87,81,148,40,248,129,417,229
33042,Saint-Denis-des-Murs,87142,87,39,130,50,195,125,370,169
33043,Saint-Gence,87143,87,125,567,95,731,463,1289,692
33044,Saint-Genest-sur-Roselle,87144,87,35,135,45,140,145,330,170
33045,Saint-Georges-les-Landes,87145,87,36,28,8,112,52,172,64
33046,Saint-Germain-les-Belles,87146,87,244,240,116,336,192,644,484
33047,Saint-Gilles-les-Forêts,87147,87,10,0,0,15,10,25,10
33048,Saint-Hilaire-Bonneval,87148,87,72,237,80,272,267,619,309
33049,Saint-Hilaire-la-Treille,87149,87,95,45,35,145,55,235,140
33050,Saint-Hilaire-les-Places,87150,87,156,173,58,273,175,506,329
33051,Saint-Jean-Ligoure,87151,87,44,124,52,148,132,332,168
33052,Saint-Jouvent,87152,87,144,424,136,520,404,1060,568
33053,Saint-Julien-le-Petit,87153,87,50,45,20,125,35,180,95
33054,Saint-Junien,87154,87,2262,2118,994,3706,1661,6361,4380
33055,Saint-Junien-les-Combes,87155,87,45,42,10,84,10,104,87
33056,Saint-Just-le-Martel,87156,87,216,734,148,887,604,1639,950
33057,Saint-Laurent-les-Églises,87157,87,72,240,60,288,172,520,312
33058,Saint-Laurent-sur-Gorre,87158,87,125,289,97,476,261,834,414
33059,Saint-Léger-la-Montagne,87159,87,80,76,24,84,76,184,156
33060,Saint-Léger-Magnazeix,87160,87,145,50,25,215,45,285,195
33061,Saint-Léonard-de-Noblat,87161,87,931,874,344,1627,643,2614,1805
33062,Sainte-Marie-de-Vaux,87162,87,20,48,8,29,61,98,68
33063,Saint-Martial-sur-Isop,87163,87,8,8,28,84,8,120,16
33064,Saint-Martin-de-Jussac,87164,87,38,184,45,169,150,364,222
33065,Saint-Martin-le-Mault,87165,87,34,21,0,46,8,54,55
33066,Saint-Martin-le-Vieux,87166,87,129,223,38,290,166,494,352
33067,Saint-Martin-Terressus,87167,87,40,144,68,208,116,392,184
33068,Saint-Mathieu,87168,87,214,175,85,455,165,705,389
33069,Saint-Maurice-les-Brousses,87169,87,45,300,65,295,315,675,345
33070,Saint-Méard,87170,87,60,66,20,135,60,215,126
33071,Saint-Ouen-sur-Gartempe,87172,87,45,25,30,120,20,170,70
33072,Saint-Pardoux,87173,87,56,137,48,172,148,368,193
33073,Saint-Paul,87174,87,235,285,80,400,250,730,520
33074,Saint-Priest-Ligoure,87176,87,116,133,42,202,94,338,249
33075,Saint-Priest-sous-Aixe,87177,87,204,384,136,564,364,1064,588
33076,Saint-Priest-Taurion,87178,87,298,610,234,1042,620,1896,908
33077,Saint-Sornin-la-Marche,87179,87,40,45,30,95,30,155,85
33078,Saint-Sornin-Leulac,87180,87,144,110,15,295,100,410,254
33079,Saint-Sulpice-Laurière,87181,87,205,165,65,270,130,465,370
33080,Saint-Sulpice-les-Feuilles,87182,87,314,190,60,470,165,695,504
33081,Saint-Sylvestre,87183,87,95,250,50,310,205,565,345
33082,Saint-Symphorien-sur-Couze,87184,87,65,25,20,85,35,140,90
33083,Saint-Victurnien,87185,87,247,450,116,501,323,940,697
33084,Saint-Vitte-sur-Briance,87186,87,62,78,30,129,55,214,140
33085,Saint-Yrieix-la-Perche,87187,87,1481,1059,495,2766,778,4039,2540
33086,Saint-Yrieix-sous-Aixe,87188,87,50,95,15,150,95,260,145
33087,Les Salles-Lavauguyon,87189,87,48,16,5,69,15,89,64
33088,Sauviat-sur-Vige,87190,87,188,176,76,348,172,596,364
33089,Séreilhac,87191,87,210,500,170,585,445,1200,710
33090,Solignac,87192,87,176,387,87,418,368,873,563
33091,Surdoux,87193,87,4,4,4,20,4,28,8
33092,Sussac,87194,87,66,51,21,121,28,170,117
33093,Tersannes,87195,87,22,20,0,61,9,70,42
33094,Thiat,87196,87,52,0,0,69,15,84,52
33095,Thouron,87197,87,55,135,45,200,95,340,190
33096,Vaulry,87198,87,30,87,13,140,77,230,117
33097,Vayres,87199,87,190,120,40,329,107,476,310
33098,Verneuil-Moustiers,87200,87,31,24,0,48,16,64,55
33099,Verneuil-sur-Vienne,87201,87,442,1171,367,1618,1015,3000,1613
33100,Veyrac,87202,87,129,530,135,753,460,1348,659
33101,Vicq-sur-Breuilh,87203,87,135,331,115,460,256,831,466
33102,Videix,87204,87,55,10,5,115,15,135,65
33103,Le Vigen,87205,87,234,494,86,761,434,1281,728
33104,Villefavard,87206,87,55,15,0,60,10,70,70
33105,Les Ableuvenettes,88001,88,12,12,16,32,4,52,24
33106,Ahéville,88002,88,4,16,0,20,12,32,20
33107,Aingeville,88003,88,10,5,5,25,15,45,15
33108,Ainvelle,88004,88,48,40,8,48,24,80,88
33109,Allarmont,88005,88,19,54,6,99,23,128,73
33110,Ambacourt,88006,88,24,56,36,116,56,208,80
33111,Ameuvelle,88007,88,5,10,0,25,5,30,15
33112,Anglemont,88008,88,16,40,12,60,28,100,56
33113,Anould,88009,88,355,803,285,1295,590,2170,1158
33114,Aouze,88010,88,30,41,12,38,29,79,71
33115,Arches,88011,88,232,333,162,504,304,970,565
33116,Archettes,88012,88,168,240,124,380,200,704,408
33117,Aroffe,88013,88,20,25,5,35,10,50,45
33118,Arrentès-de-Corcieux,88014,88,18,44,6,36,41,83,62
33119,Attignéville,88015,88,23,30,29,81,31,141,53
33120,Attigny,88016,88,45,25,15,115,20,150,70
33121,Aulnois,88017,88,16,44,12,36,44,92,60
33122,Autigny-la-Tour,88019,88,20,40,5,65,35,105,60
33123,Autreville,88020,88,17,39,27,38,20,85,56
33124,Autrey,88021,88,24,97,16,96,52,164,121
33125,Auzainvilliers,88022,88,13,44,16,70,33,119,57
33126,Avillers,88023,88,0,15,15,20,25,60,15
33127,Avrainville,88024,88,6,34,6,25,18,49,40
33128,Avranville,88025,88,10,10,5,30,10,45,20
33129,Aydoilles,88026,88,62,245,101,387,181,669,307
33130,Badménil-aux-Bois,88027,88,15,30,10,45,55,110,45
33131,La Baffe,88028,88,48,197,31,190,125,346,245
33132,Bains-les-Bains,88029,88,244,240,96,416,144,656,484
33133,Bainville-aux-Saules,88030,88,29,30,0,55,30,85,59
33134,Balléville,88031,88,10,10,20,50,10,80,20
33135,Ban-de-Laveline,88032,88,180,270,105,420,275,800,450
33136,Ban-de-Sapt,88033,88,53,106,4,107,64,175,159
33137,Barbey-Seroux,88035,88,8,34,0,39,29,68,42
33138,Barville,88036,88,16,8,12,24,4,40,24
33139,Basse-sur-le-Rupt,88037,88,97,193,60,329,110,499,290
33140,Battexey,88038,88,12,12,0,4,12,16,24
33141,Baudricourt,88039,88,28,72,32,136,36,204,100
33142,Bayecourt,88040,88,30,70,25,80,70,175,100
33143,Bazegney,88041,88,10,20,25,35,15,75,30
33144,Bazien,88042,88,10,15,10,20,20,50,25
33145,Bazoilles-et-Ménil,88043,88,16,20,20,56,20,96,36
33146,Bazoilles-sur-Meuse,88044,88,56,135,41,194,118,353,191
33147,Beaufremont,88045,88,42,15,10,24,15,49,57
33148,Beauménil,88046,88,18,12,7,48,12,67,30
33149,Begnécourt,88047,88,19,42,20,24,30,74,61
33150,Bellefontaine,88048,88,125,265,100,315,210,625,390
33151,Belmont-lès-Darney,88049,88,16,24,0,44,20,64,40
33152,Belmont-sur-Buttant,88050,88,60,76,12,96,40,148,136
33153,Belmont-sur-Vair,88051,88,4,24,24,36,20,80,28
33154,Belrupt,88052,88,25,30,5,30,15,50,55
33155,Belval,88053,88,12,28,20,84,16,120,40
33156,Bertrimoutier,88054,88,50,57,19,105,41,165,107
33157,Bettegney-Saint-Brice,88055,88,12,44,12,36,30,78,56
33158,Bettoncourt,88056,88,6,6,12,24,9,45,12
33159,Le Beulay,88057,88,10,16,10,52,15,77,26
33160,Biécourt,88058,88,12,9,8,40,0,48,21
33161,Biffontaine,88059,88,32,112,12,156,88,256,144
33162,Blémerey,88060,88,4,0,0,8,0,8,4
33163,Bleurville,88061,88,52,84,12,148,56,216,136
33164,Blevaincourt,88062,88,38,32,0,13,12,25,70
33165,Bocquegney,88063,88,12,25,25,40,20,85,37
33166,Bois-de-Champ,88064,88,8,32,4,44,16,64,40
33167,Bonvillet,88065,88,52,64,20,140,60,220,116
33168,Boulaincourt,88066,88,10,20,10,20,10,40,30
33169,La Bourgonce,88068,88,84,252,68,280,228,576,336
33170,Bouxières-aux-Bois,88069,88,20,35,10,40,30,80,55
33171,Bouxurulles,88070,88,10,40,0,43,55,98,50
33172,Bouzemont,88071,88,6,10,3,9,12,24,16
33173,Brantigny,88073,88,26,59,16,45,44,105,85
33174,Brechainville,88074,88,0,9,0,19,12,31,9
33175,La Bresse,88075,88,828,786,280,1561,677,2518,1614
33176,Brouvelieures,88076,88,65,100,60,130,75,265,165
33177,Brû,88077,88,60,170,35,235,90,360,230
33178,Bruyères,88078,88,508,692,276,885,424,1585,1200
33179,Bulgnéville,88079,88,120,410,61,470,351,882,530
33180,Bult,88080,88,24,100,28,76,80,184,124
33181,Bussang,88081,88,248,232,72,509,161,742,480
33182,Celles-sur-Plaine,88082,88,152,204,60,300,144,504,356
33183,Certilleux,88083,88,25,35,5,85,50,140,60
33184,Chamagne,88084,88,39,124,40,156,63,259,163
33185,Champdray,88085,88,45,8,16,65,16,97,53
33186,Champ-le-Duc,88086,88,90,120,21,186,71,278,210
33187,Chantraine,88087,88,445,625,295,1235,585,2115,1070
33188,La Chapelle-aux-Bois,88088,88,70,125,60,283,115,458,195
33189,La Chapelle-devant-Bruyères,88089,88,65,176,20,200,140,360,241
33190,Charmes,88090,88,613,1188,563,1346,755,2664,1801
33191,Charmois-devant-Bruyères,88091,88,40,125,40,130,80,250,165
33192,Charmois-l'Orgueilleux,88092,88,100,145,55,80,165,300,245
33193,Châtas,88093,88,5,5,20,30,0,50,10
33194,Châtel-sur-Moselle,88094,88,188,321,152,542,312,1006,509
33195,Châtenois,88095,88,235,340,200,600,285,1085,575
33196,Châtillon-sur-Saône,88096,88,50,25,5,50,5,60,75
33197,Chauffecourt,88097,88,0,4,0,8,12,20,4
33198,Chaumousey,88098,88,92,216,64,360,152,576,308
33199,Chavelot,88099,88,108,294,113,587,279,979,402
33200,Chef-Haut,88100,88,4,12,4,16,12,32,16
33201,Cheniménil,88101,88,81,261,103,375,219,697,342
33202,Chermisey,88102,88,28,20,12,8,28,48,48
33203,Circourt,88103,88,17,4,0,30,8,38,21
33204,Circourt-sur-Mouzon,88104,88,19,26,18,74,12,104,45
33205,Claudon,88105,88,28,44,28,104,20,152,72
33206,Ban-sur-Meurthe-Clefcy,88106,88,110,225,70,360,185,615,335
33207,Clérey-la-Côte,88107,88,6,0,0,15,3,18,6
33208,Le Clerjus,88108,88,100,110,50,180,100,330,210
33209,Cleurie,88109,88,72,144,28,272,124,424,216
33210,Clézentaine,88110,88,25,55,10,80,40,130,80
33211,Coinches,88111,88,24,82,20,131,57,208,106
33212,Combrimont,88113,88,35,35,10,65,10,85,70
33213,Contrexéville,88114,88,496,686,260,1134,595,1989,1182
33214,Corcieux,88115,88,188,287,173,585,257,1015,475
33215,Cornimont,88116,88,515,681,230,1260,453,1943,1196
33216,Courcelles-sous-Châtenois,88117,88,12,24,16,28,12,56,36
33217,Coussey,88118,88,92,196,56,240,152,448,288
33218,Crainvilliers,88119,88,19,25,16,48,25,89,44
33219,La Croix-aux-Mines,88120,88,85,100,50,175,95,320,185
33220,Damas-aux-Bois,88121,88,52,76,16,64,60,140,128
33221,Damas-et-Bettegney,88122,88,47,90,50,135,50,235,137
33222,Damblain,88123,88,60,55,10,110,40,160,115
33223,Darney,88124,88,119,184,86,320,169,575,303
33224,Darney-aux-Chênes,88125,88,0,16,6,6,15,27,16
33225,Darnieulles,88126,88,136,404,128,520,316,964,540
33226,Deinvillers,88127,88,20,15,5,20,15,40,35
33227,Denipaire,88128,88,25,59,25,114,49,188,84
33228,Derbamont,88129,88,17,44,0,12,34,46,61
33229,Destord,88130,88,8,66,33,75,39,147,74
33230,Deycimont,88131,88,55,110,15,50,95,160,165
33231,Deyvillers,88132,88,139,345,130,549,305,984,484
33232,Dignonville,88133,88,10,45,15,70,35,120,55
33233,Dinozé,88134,88,85,140,30,170,110,310,225
33234,Docelles,88135,88,110,254,80,307,141,528,364
33235,Dogneville,88136,88,158,280,125,678,210,1013,438
33236,Dolaincourt,88137,88,12,20,4,36,12,52,32
33237,Dombasle-devant-Darney,88138,88,0,30,0,60,10,70,30
33238,Dombasle-en-Xaintois,88139,88,20,15,20,50,5,75,35
33239,Dombrot-le-Sec,88140,88,25,84,65,124,84,273,109
33240,Dombrot-sur-Vair,88141,88,28,60,28,76,60,164,88
33241,Domèvre-sur-Avière,88142,88,10,88,38,154,55,247,98
33242,Domèvre-sur-Durbion,88143,88,12,92,28,100,68,196,104
33243,Domèvre-sous-Montfort,88144,88,0,10,0,30,10,40,10
33244,Domfaing,88145,88,25,35,25,120,25,170,60
33245,Domjulien,88146,88,30,39,3,41,31,75,69
33246,Dommartin-aux-Bois,88147,88,62,124,20,135,92,247,186
33247,Dommartin-lès-Remiremont,88148,88,208,465,128,682,354,1164,673
33248,Dommartin-lès-Vallois,88149,88,4,24,8,20,8,36,28
33249,Dommartin-sur-Vraine,88150,88,30,65,20,65,45,130,95
33250,Dompaire,88151,88,125,320,130,293,214,637,445
33251,Dompierre,88152,88,20,84,20,88,56,164,104
33252,Domptail,88153,88,48,103,25,114,29,168,151
33253,Domrémy-la-Pucelle,88154,88,16,16,0,60,36,96,32
33254,Domvallier,88155,88,16,18,13,27,12,52,34
33255,Doncières,88156,88,10,35,25,45,25,95,45
33256,Dounoux,88157,88,125,195,50,330,135,515,320
33257,Éloyes,88158,88,417,780,305,1013,615,1933,1197
33258,Entre-deux-Eaux,88159,88,50,130,35,195,95,325,180
33259,Épinal,88160,88,4346,7183,4137,9476,5288,18901,11529
33260,Escles,88161,88,44,119,8,152,76,236,163
33261,Esley,88162,88,25,34,21,76,16,113,59
33262,Essegney,88163,88,104,180,52,212,136,400,284
33263,Estrennes,88164,88,20,20,5,35,20,60,40
33264,Étival-Clairefontaine,88165,88,275,630,190,950,540,1680,905
33265,Évaux-et-Ménil,88166,88,40,92,44,116,76,236,132
33266,Faucompierre,88167,88,30,60,15,75,60,150,90
33267,Fauconcourt,88168,88,6,18,19,47,12,78,24
33268,Fays,88169,88,45,36,6,70,36,112,81
33269,Ferdrupt,88170,88,91,135,57,241,141,439,226
33270,Fignévelle,88171,88,0,5,10,15,10,35,5
33271,Fiménil,88172,88,9,60,17,66,40,123,69
33272,Florémont,88173,88,43,105,40,209,70,319,148
33273,Fomerey,88174,88,20,40,8,36,31,75,60
33274,Fontenay,88175,88,25,122,55,158,106,319,147
33275,Fontenoy-le-Château,88176,88,106,120,40,215,65,320,226
33276,La Forge,88177,88,85,110,15,210,100,325,195
33277,Les Forges,88178,88,240,440,85,819,355,1259,680
33278,Fouchécourt,88179,88,0,0,10,25,0,35,0
33279,Frain,88180,88,30,25,10,40,20,70,55
33280,Fraize,88181,88,399,597,192,1150,505,1847,996
33281,Frapelle,88182,88,30,50,15,90,15,120,80
33282,Frebécourt,88183,88,35,75,0,145,50,195,110
33283,Fremifontaine,88184,88,35,170,30,132,133,295,205
33284,Frenelle-la-Grande,88185,88,9,23,6,46,23,75,32
33285,Frenelle-la-Petite,88186,88,5,0,10,15,5,30,5
33286,Frénois,88187,88,0,12,8,8,8,24,12
33287,Fresse-sur-Moselle,88188,88,275,315,195,725,265,1185,590
33288,Fréville,88189,88,24,36,16,52,24,92,60
33289,Frizon,88190,88,34,138,34,149,94,277,172
33290,Gelvécourt-et-Adompt,88192,88,15,35,20,10,40,70,50
33291,Gemaingoutte,88193,88,25,15,20,50,10,80,40
33292,Gemmelaincourt,88194,88,22,27,12,39,24,75,49
33293,Gendreville,88195,88,5,35,10,30,30,70,40
33294,Gérardmer,88196,88,1304,1595,685,2997,1328,5010,2899
33295,Gerbamont,88197,88,45,95,50,90,80,220,140
33296,Gerbépal,88198,88,48,163,13,179,138,330,211
33297,Gignéville,88199,88,8,16,8,26,4,38,24
33298,Gigney,88200,88,0,10,0,15,20,35,10
33299,Girancourt,88201,88,69,198,80,308,146,534,267
33300,Gircourt-lès-Viéville,88202,88,20,35,15,70,35,120,55
33301,Girecourt-sur-Durbion,88203,88,24,100,36,120,68,224,124
33302,Girmont-Val-d'Ajol,88205,88,44,60,12,100,16,128,104
33303,Gironcourt-sur-Vraine,88206,88,144,215,94,286,152,532,359
33304,Godoncourt,88208,88,6,24,12,48,13,73,30
33305,Golbey,88209,88,1059,1955,875,2660,1560,5095,3014
33306,Gorhey,88210,88,4,56,12,48,33,93,60
33307,Grand,88212,88,51,54,29,193,24,246,105
33308,La Grande-Fosse,88213,88,8,32,0,56,20,76,40
33309,Grandrupt-de-Bains,88214,88,5,25,0,53,5,58,30
33310,Grandrupt,88215,88,6,10,3,45,0,48,16
33311,Grandvillers,88216,88,60,200,68,272,140,480,260
33312,Granges-Aumontzey,88218,88,360,611,256,911,526,1693,971
33313,Greux,88219,88,35,45,20,55,25,100,80
33314,Grignoncourt,88220,88,0,10,0,15,15,30,10
33315,Gruey-lès-Surance,88221,88,60,30,25,85,40,150,90
33316,Gugnécourt,88222,88,4,48,12,72,40,124,52
33317,Gugney-aux-Aulx,88223,88,16,38,4,44,30,78,54
33318,Hadigny-les-Verrières,88224,88,29,98,30,90,105,225,127
33319,Hadol,88225,88,232,619,270,805,426,1501,851
33320,Hagécourt,88226,88,9,25,6,42,19,67,34
33321,Hagnéville-et-Roncourt,88227,88,13,12,6,27,6,39,25
33322,Haillainville,88228,88,45,45,5,35,30,70,90
33323,Harchéchamp,88229,88,10,10,0,40,10,50,20
33324,Hardancourt,88230,88,10,10,0,5,10,15,20
33325,Haréville,88231,88,28,110,37,117,128,282,138
33326,Harmonville,88232,88,0,80,15,97,55,167,80
33327,Harol,88233,88,68,148,52,208,132,392,216
33328,Harsault,88234,88,57,74,20,130,45,195,131
33329,Hautmougey,88235,88,25,35,10,55,30,95,60
33330,La Haye,88236,88,30,15,5,30,25,60,45
33331,Hennecourt,88237,88,31,101,22,107,52,181,132
33332,Hennezel,88238,88,50,110,15,190,65,270,160
33333,Hergugney,88239,88,28,24,20,36,20,76,52
33334,Herpelmont,88240,88,24,60,24,84,76,184,84
33335,Houécourt,88241,88,49,144,20,144,94,258,193
33336,Houéville,88242,88,0,5,0,20,15,35,5
33337,Housseras,88243,88,55,145,25,165,105,295,200
33338,La Houssière,88244,88,67,154,34,192,95,321,221
33339,Hurbache,88245,88,17,99,12,111,60,183,116
33340,Hymont,88246,88,55,90,10,215,95,320,145
33341,Igney,88247,88,90,290,135,440,220,795,380
33342,Isches,88248,88,29,40,10,60,30,100,69
33343,Jainvillotte,88249,88,20,10,6,27,3,36,30
33344,Jarménil,88250,88,52,112,48,128,88,264,164
33345,Jeanménil,88251,88,88,271,77,425,154,656,359
33346,Jésonville,88252,88,10,25,5,45,30,80,35
33347,Jeuxey,88253,88,68,140,38,303,85,426,208
33348,Jorxey,88254,88,24,24,0,8,32,40,48
33349,Jubainville,88255,88,8,20,12,16,20,48,28
33350,Jussarupt,88256,88,53,42,33,90,30,153,95
33351,Juvaincourt,88257,88,5,55,15,75,40,130,60
33352,Lamarche,88258,88,156,134,69,301,86,456,290
33353,Landaville,88259,88,37,53,19,92,50,161,90
33354,Langley,88260,88,30,50,0,50,35,85,80
33355,Laval-sur-Vologne,88261,88,60,184,60,204,132,396,244
33356,Laveline-devant-Bruyères,88262,88,76,144,32,256,128,416,220
33357,Laveline-du-Houx,88263,88,32,68,20,76,52,148,100
33358,Légéville-et-Bonfays,88264,88,0,20,0,25,10,35,20
33359,Lemmecourt,88265,88,5,0,5,10,0,15,5
33360,Lépanges-sur-Vologne,88266,88,120,240,108,260,184,552,360
33361,Lerrain,88267,88,56,156,52,120,96,268,212
33362,Lesseux,88268,88,20,60,8,60,28,96,80
33363,Liézey,88269,88,16,58,14,94,50,158,74
33364,Liffol-le-Grand,88270,88,394,439,176,721,356,1253,833
33365,Lignéville,88271,88,20,85,45,120,40,205,105
33366,Lironcourt,88272,88,12,4,8,32,8,48,16
33367,Longchamp,88273,88,28,132,40,152,112,304,160
33368,Longchamp-sous-Châtenois,88274,88,20,0,10,20,10,40,20
33369,Lubine,88275,88,45,43,12,38,32,82,88
33370,Lusse,88276,88,80,65,35,165,70,270,145
33371,Luvigny,88277,88,8,36,20,32,16,68,44
33372,Maconcourt,88278,88,24,12,4,32,8,44,36
33373,Madecourt,88279,88,6,6,3,18,6,27,12
33374,Madegney,88280,88,9,13,3,15,22,40,22
33375,Madonne-et-Lamerey,88281,88,41,84,41,77,71,189,125
33376,Malaincourt,88283,88,9,22,15,6,18,39,31
33377,Mandray,88284,88,35,135,60,245,115,420,170
33378,Mandres-sur-Vair,88285,88,30,95,25,140,80,245,125
33379,Marainville-sur-Madon,88286,88,5,20,20,30,20,70,25
33380,Marey,88287,88,10,20,0,35,15,50,30
33381,Maroncourt,88288,88,0,0,0,4,0,4,0
33382,Martigny-les-Bains,88289,88,123,185,50,333,120,503,308
33383,Martigny-les-Gerbonvaux,88290,88,5,15,0,61,15,76,20
33384,Martinvelle,88291,88,16,4,12,72,8,92,20
33385,Mattaincourt,88292,88,88,121,37,270,90,397,209
33386,Maxey-sur-Meuse,88293,88,45,30,20,105,40,165,75
33387,Mazeley,88294,88,45,45,30,90,50,170,90
33388,Mazirot,88295,88,25,65,5,85,50,140,90
33389,Médonville,88296,88,12,16,13,16,8,37,28
33390,Méménil,88297,88,6,30,3,41,35,79,36
33391,Ménarmont,88298,88,16,12,16,25,4,45,28
33392,Ménil-en-Xaintois,88299,88,20,35,15,40,51,106,55
33393,Ménil-de-Senones,88300,88,20,25,30,60,10,100,45
33394,Ménil-sur-Belvitte,88301,88,40,96,20,88,72,180,136
33395,Le Ménil,88302,88,140,205,50,500,195,745,345
33396,Midrevaux,88303,88,21,53,16,83,29,128,74
33397,Mirecourt,88304,88,662,1101,588,1789,817,3194,1763
33398,Moncel-sur-Vair,88305,88,30,56,29,68,12,109,86
33399,Le Mont,88306,88,10,3,3,18,6,27,13
33400,Mont-lès-Lamarche,88307,88,25,25,0,30,20,50,50
33401,Mont-lès-Neufchâteau,88308,88,24,84,40,100,64,204,108
33402,Monthureux-le-Sec,88309,88,15,45,0,65,40,105,60
33403,Monthureux-sur-Saône,88310,88,163,135,40,289,120,449,298
33404,Montmotier,88311,88,15,10,10,10,0,20,25
33405,Morelmaison,88312,88,65,50,10,45,30,85,115
33406,Moriville,88313,88,43,96,40,93,86,219,139
33407,Morizécourt,88314,88,35,20,5,35,15,55,55
33408,Mortagne,88315,88,28,48,16,48,28,92,76
33409,Morville,88316,88,10,30,0,15,10,25,40
33410,Moussey,88317,88,65,150,74,245,105,424,215
33411,Moyemont,88318,88,25,55,35,70,30,135,80
33412,Moyenmoutier,88319,88,397,790,292,1157,620,2069,1187
33413,Nayemont-les-Fosses,88320,88,128,196,10,307,147,464,324
33414,Neufchâteau,88321,88,1064,1173,738,2192,1010,3940,2237
33415,La Neuveville-devant-Lépanges,88322,88,36,160,24,132,144,300,196
33416,La Neuveville-sous-Châtenois,88324,88,40,94,43,98,56,197,134
33417,La Neuveville-sous-Montfort,88325,88,8,44,16,64,44,124,52
33418,Neuvillers-sur-Fave,88326,88,45,95,20,115,65,200,140
33419,Nomexy,88327,88,340,520,175,705,375,1255,860
33420,Nompatelize,88328,88,55,128,34,211,59,304,183
33421,Nonville,88330,88,25,50,15,45,50,110,75
33422,Nonzeville,88331,88,0,10,0,25,10,35,10
33423,Norroy,88332,88,20,45,30,90,40,160,65
33424,Nossoncourt,88333,88,12,28,12,16,24,52,40
33425,Oëlleville,88334,88,43,48,34,81,46,161,91
33426,Offroicourt,88335,88,16,34,3,36,30,69,50
33427,Ollainville,88336,88,0,25,10,25,10,45,25
33428,Ortoncourt,88338,88,8,28,4,32,12,48,36
33429,Padoux,88340,88,50,150,40,170,95,305,200
33430,Pair-et-Grandrupt,88341,88,45,129,36,232,85,353,174
33431,Pallegney,88342,88,4,52,20,64,48,132,56
33432,Parey-sous-Montfort,88343,88,30,30,15,40,35,90,60
33433,Pargny-sous-Mureau,88344,88,9,37,6,49,31,86,46
33434,La Petite-Fosse,88345,88,6,19,3,24,13,40,25
33435,La Petite-Raon,88346,88,120,180,65,290,115,470,300
33436,Pierrefitte,88347,88,12,28,8,52,20,80,40
33437,Pierrepont-sur-l'Arentèle,88348,88,40,40,15,30,30,75,80
33438,Plainfaing,88349,88,232,376,117,560,325,1002,608
33439,Pleuvezain,88350,88,15,15,0,20,15,35,30
33440,Plombières-les-Bains,88351,88,226,378,125,670,262,1057,604
33441,Pompierre,88352,88,35,60,30,55,60,145,95
33442,Pont-lès-Bonfays,88353,88,12,24,8,32,16,56,36
33443,Pont-sur-Madon,88354,88,8,44,20,44,44,108,52
33444,Portieux,88355,88,185,275,118,220,210,548,460
33445,Les Poulières,88356,88,20,71,15,55,65,135,91
33446,Poussay,88357,88,69,136,53,258,113,424,205
33447,Pouxeux,88358,88,245,510,160,595,455,1210,755
33448,Prey,88359,88,4,20,4,32,36,72,24
33449,Provenchères-lès-Darney,88360,88,15,35,0,65,35,100,50
33450,Provenchères-et-Colroy,88361,88,227,342,79,439,276,794,569
33451,Le Puid,88362,88,20,15,5,25,25,55,35
33452,Punerot,88363,88,20,55,5,40,33,78,75
33453,Puzieux,88364,88,6,43,9,32,35,76,49
33454,Racécourt,88365,88,9,36,0,51,36,87,45
33455,Rainville,88366,88,55,60,19,85,49,153,115
33456,Rambervillers,88367,88,837,1269,643,1704,769,3116,2106
33457,Ramecourt,88368,88,34,26,30,46,13,89,60
33458,Ramonchamp,88369,88,189,572,135,693,422,1250,761
33459,Rancourt,88370,88,0,9,16,38,4,58,9
33460,Raon-aux-Bois,88371,88,95,332,75,465,270,810,427
33461,Raon-l'Étape,88372,88,960,1445,595,2115,1105,3815,2405
33462,Raon-sur-Plaine,88373,88,15,39,3,49,36,88,54
33463,Rapey,88374,88,0,5,5,5,5,15,5
33464,Raves,88375,88,50,86,25,145,96,266,136
33465,Rebeuville,88376,88,25,60,30,145,30,205,85
33466,Regnévelle,88377,88,23,20,3,51,9,63,43
33467,Regney,88378,88,5,25,15,20,20,55,30
33468,Rehaincourt,88379,88,48,92,32,124,52,208,140
33469,Rehaupal,88380,88,30,48,12,85,24,121,78
33470,Relanges,88381,88,25,30,20,70,50,140,55
33471,Remicourt,88382,88,11,32,0,30,10,40,43
33472,Remiremont,88383,88,1221,1540,850,2375,1367,4592,2761
33473,Remoncourt,88385,88,64,148,52,192,124,368,212
33474,Remomeix,88386,88,47,94,60,199,45,304,141
33475,Removille,88387,88,16,58,12,62,21,95,74
33476,Renauvoid,88388,88,25,35,0,45,20,65,60
33477,Repel,88389,88,32,4,8,20,8,36,36
33478,Robécourt,88390,88,15,25,5,55,15,75,40
33479,Rochesson,88391,88,65,195,35,260,160,455,260
33480,Rocourt,88392,88,15,5,0,10,0,10,20
33481,Rollainville,88393,88,20,60,12,112,50,174,80
33482,Romain-aux-Bois,88394,88,16,0,4,8,0,12,16
33483,Romont,88395,88,45,97,30,117,52,199,142
33484,Les Rouges-Eaux,88398,88,20,16,8,16,12,36,36
33485,Le Roulier,88399,88,20,55,5,60,60,125,75
33486,Rouvres-en-Xaintois,88400,88,60,60,5,125,35,165,120
33487,Rouvres-la-Chétive,88401,88,40,95,40,190,90,320,135
33488,Roville-aux-Chênes,88402,88,50,60,25,80,15,120,110
33489,Rozerotte,88403,88,24,28,16,72,32,120,52
33490,Rozières-sur-Mouzon,88404,88,25,10,0,25,10,35,35
33491,Rugney,88406,88,0,43,12,32,28,72,43
33492,Ruppes,88407,88,12,14,13,63,4,80,26
33493,Rupt-sur-Moselle,88408,88,508,724,334,1168,600,2102,1232
33494,Saint-Amé,88409,88,324,511,134,708,433,1275,835
33495,Sainte-Barbe,88410,88,25,90,40,85,45,170,115
33496,Saint-Baslemont,88411,88,4,20,12,36,8,56,24
33497,Saint-Benoît-la-Chipotte,88412,88,90,115,55,95,85,235,205
33498,Saint-Dié-des-Vosges,88413,88,3062,4605,2202,6444,3165,11811,7667
33499,Saint-Étienne-lès-Remiremont,88415,88,538,827,450,1254,626,2330,1365
33500,Saint-Genest,88416,88,4,12,0,44,12,56,16
33501,Saint-Gorgon,88417,88,16,136,28,120,108,256,152
33502,Sainte-Hélène,88418,88,60,160,48,144,88,280,220
33503,Saint-Jean-d'Ormont,88419,88,16,28,6,49,12,67,44
33504,Saint-Julien,88421,88,20,16,10,35,27,72,36
33505,Saint-Léonard,88423,88,214,329,108,363,238,709,543
33506,Sainte-Marguerite,88424,88,486,510,155,803,374,1332,996
33507,Saint-Maurice-sur-Mortagne,88425,88,14,33,6,43,32,81,47
33508,Saint-Maurice-sur-Moselle,88426,88,220,295,100,578,204,882,515
33509,Saint-Menge,88427,88,35,35,5,55,10,70,70
33510,Saint-Michel-sur-Meurthe,88428,88,225,361,175,778,330,1283,586
33511,Saint-Nabord,88429,88,560,974,280,1409,755,2444,1534
33512,Saint-Ouen-lès-Parey,88430,88,55,140,40,160,110,310,195
33513,Saint-Paul,88431,88,12,35,25,24,25,74,47
33514,Saint-Pierremont,88432,88,12,36,8,72,24,104,48
33515,Saint-Prancher,88433,88,0,8,13,28,8,49,8
33516,Saint-Remimont,88434,88,4,72,12,84,72,168,76
33517,Saint-Remy,88435,88,64,168,48,168,92,308,232
33518,Saint-Stail,88436,88,8,4,8,37,4,49,12
33519,Saint-Vallier,88437,88,5,30,0,35,20,55,35
33520,La Salle,88438,88,130,90,55,50,75,180,220
33521,Sanchey,88439,88,72,268,56,320,180,556,340
33522,Sandaucourt,88440,88,24,30,0,54,38,92,54
33523,Sans-Vallois,88441,88,10,25,20,40,25,85,35
33524,Sapois,88442,88,66,155,34,212,121,367,221
33525,Sartes,88443,88,16,20,8,36,24,68,36
33526,Le Saulcy,88444,88,32,69,29,105,35,169,101
33527,Saulcy-sur-Meurthe,88445,88,295,536,209,769,480,1458,831
33528,Saulxures-lès-Bulgnéville,88446,88,15,60,30,95,55,180,75
33529,Saulxures-sur-Moselotte,88447,88,555,534,191,771,448,1410,1089
33530,Sauville,88448,88,45,30,5,80,15,100,75
33531,Savigny,88449,88,8,44,16,68,48,132,52
33532,Senaide,88450,88,28,20,16,59,12,87,48
33533,Senones,88451,88,410,415,235,840,315,1390,825
33534,Senonges,88452,88,24,4,24,48,12,84,28
33535,Seraumont,88453,88,10,35,0,10,15,25,45
33536,Sercoeur,88454,88,10,60,45,80,45,170,70
33537,Serécourt,88455,88,25,10,15,41,0,56,35
33538,Serocourt,88456,88,25,20,0,35,15,50,45
33539,Sionne,88457,88,23,41,17,41,9,67,64
33540,Socourt,88458,88,40,68,20,92,48,160,108
33541,Soncourt,88459,88,15,10,0,10,15,25,25
33542,Soulosse-sous-Saint-Élophe,88460,88,100,160,36,200,136,372,260
33543,Suriauville,88461,88,48,53,4,42,40,86,101
33544,Le Syndicat,88462,88,172,468,224,696,380,1300,640
33545,Taintrux,88463,88,200,380,75,640,250,965,580
33546,Tendon,88464,88,40,145,35,235,70,340,185
33547,Capavenir Vosges,88465,88,1104,2015,1039,2873,1646,5558,3119
33548,They-sous-Montfort,88466,88,30,35,5,50,15,70,65
33549,Thiéfosse,88467,88,84,124,60,248,108,416,208
33550,Le Thillot,88468,88,557,677,333,1300,483,2116,1234
33551,Thiraucourt,88469,88,25,30,0,20,25,45,55
33552,Le Tholy,88470,88,230,330,110,625,270,1005,560
33553,Les Thons,88471,88,45,15,5,35,10,50,60
33554,Thuillières,88472,88,25,35,0,50,15,65,60
33555,Tignécourt,88473,88,5,15,5,70,5,80,20
33556,Tilleux,88474,88,10,30,0,20,15,35,40
33557,Tollaincourt,88475,88,27,29,0,25,20,45,56
33558,Totainville,88476,88,8,32,16,24,36,76,40
33559,Trampot,88477,88,30,0,5,50,5,60,30
33560,Tranqueville-Graux,88478,88,12,24,12,20,12,44,36
33561,Trémonzey,88479,88,20,45,8,91,33,132,65
33562,Ubexy,88480,88,10,50,30,45,35,110,60
33563,Uriménil,88481,88,92,307,139,441,260,840,399
33564,Urville,88482,88,0,10,5,30,10,45,10
33565,Uxegney,88483,88,255,620,145,820,450,1415,875
33566,Uzemain,88484,88,144,263,90,414,184,688,407
33567,La Vacheresse-et-la-Rouillie,88485,88,28,40,12,24,32,68,68
33568,Vagney,88486,88,558,838,401,1422,662,2485,1396
33569,Le Val-d'Ajol,88487,88,719,742,291,1403,625,2319,1461
33570,Valfroicourt,88488,88,36,56,20,92,40,152,92
33571,Valleroy-aux-Saules,88489,88,30,60,20,120,35,175,90
33572,Valleroy-le-Sec,88490,88,22,26,20,45,39,104,48
33573,Les Vallois,88491,88,8,40,4,36,28,68,48
33574,Le Valtin,88492,88,16,5,5,30,5,40,21
33575,Varmonzey,88493,88,0,12,0,8,8,16,12
33576,Vaubexy,88494,88,40,25,5,20,30,55,65
33577,Vaudéville,88495,88,10,25,40,85,5,130,35
33578,Vaudoncourt,88496,88,16,40,16,48,48,112,56
33579,Vaxoncourt,88497,88,30,156,51,120,134,305,186
33580,Vecoux,88498,88,59,171,70,380,142,592,230
33581,Velotte-et-Tatignécourt,88499,88,28,32,16,32,32,80,60
33582,Ventron,88500,88,130,150,94,379,75,548,280
33583,Le Vermont,88501,88,16,8,0,44,8,52,24
33584,Vervezelle,88502,88,10,31,9,59,12,80,41
33585,Vexaincourt,88503,88,20,45,5,65,30,100,65
33586,Vicherey,88504,88,16,32,12,72,8,92,48
33587,Vienville,88505,88,4,24,4,56,24,84,28
33588,Vieux-Moulin,88506,88,60,76,32,104,68,204,136
33589,Villers,88507,88,15,35,15,125,20,160,50
33590,Ville-sur-Illon,88508,88,45,120,50,135,100,285,165
33591,Villoncourt,88509,88,5,25,20,45,25,90,30
33592,Villotte,88510,88,5,25,15,80,40,135,30
33593,Villouxel,88511,88,23,7,6,22,3,31,30
33594,Viménil,88512,88,17,49,44,72,34,150,66
33595,Vincey,88513,88,275,505,250,715,430,1395,780
33596,Viocourt,88514,88,16,42,8,28,38,74,58
33597,Vioménil,88515,88,24,28,16,60,20,96,52
33598,Vittel,88516,88,965,920,380,1968,833,3181,1885
33599,Viviers-le-Gras,88517,88,24,38,17,82,17,116,62
33600,Viviers-lès-Offroicourt,88518,88,0,8,0,8,8,16,8
33601,La Voivre,88519,88,74,164,16,287,132,435,238
33602,Les Voivres,88520,88,30,80,20,125,45,190,110
33603,Vomécourt,88521,88,24,76,48,72,64,184,100
33604,Vomécourt-sur-Madon,88522,88,3,6,6,28,6,40,9
33605,Vouxey,88523,88,5,40,5,55,50,110,45
33606,Vrécourt,88524,88,55,120,10,85,110,205,175
33607,Vroville,88525,88,12,28,12,60,24,96,40
33608,Wisembach,88526,88,29,110,35,110,120,265,139
33609,Xaffévillers,88527,88,20,30,45,45,15,105,50
33610,Xamontarupt,88528,88,16,48,12,60,36,108,64
33611,Xaronval,88529,88,12,32,24,4,24,52,44
33612,Xertigny,88530,88,358,638,230,908,443,1581,996
33613,Xonrupt-Longemer,88531,88,225,331,135,627,235,997,556
33614,Zincourt,88532,88,0,40,4,36,20,60,40
33615,Accolay,89001,89,60,80,35,175,60,270,140
33616,Aigremont,89002,89,4,26,8,21,17,46,30
33617,Aillant-sur-Tholon,89003,89,262,262,65,450,173,688,524
33618,Aisy-sur-Armançon,89004,89,50,45,15,84,54,153,95
33619,Ancy-le-Franc,89005,89,155,165,35,353,105,493,320
33620,Ancy-le-Libre,89006,89,25,40,15,95,15,125,65
33621,Andryes,89007,89,100,96,25,166,50,241,196
33622,Angely,89008,89,20,30,5,65,30,100,50
33623,Annay-la-Côte,89009,89,44,72,16,144,60,220,116
33624,Annay-sur-Serein,89010,89,76,36,20,72,28,120,112
33625,Annéot,89011,89,6,39,6,35,32,73,45
33626,Annoux,89012,89,12,8,8,52,4,64,20
33627,Appoigny,89013,89,295,682,327,1122,482,1931,977
33628,Arces-Dilo,89014,89,116,97,44,188,58,290,213
33629,Arcy-sur-Cure,89015,89,72,108,36,192,92,320,180
33630,Argentenay,89016,89,13,9,9,22,9,40,22
33631,Argenteuil-sur-Armançon,89017,89,55,35,10,89,25,124,90
33632,Armeau,89018,89,84,200,56,240,172,468,284
33633,Arthonnay,89019,89,36,36,4,60,36,100,72
33634,Asnières-sous-Bois,89020,89,25,35,0,55,20,75,60
33635,Asquins,89021,89,46,46,15,116,31,162,92
33636,Athie,89022,89,3,22,9,64,22,95,25
33637,Augy,89023,89,125,247,67,339,175,581,372
33638,Auxerre,89024,89,4550,7817,4079,10544,5834,20457,12367
33639,Avallon,89025,89,1121,1396,802,2134,1077,4013,2517
33640,Bagneaux,89027,89,29,60,15,73,53,141,89
33641,Baon,89028,89,9,30,0,10,35,45,39
33642,Bassou,89029,89,76,240,112,224,216,552,316
33643,Bazarnes,89030,89,35,90,55,149,79,283,125
33644,Beaumont,89031,89,47,176,34,177,142,353,223
33645,Beauvilliers,89032,89,32,16,8,28,4,40,48
33646,Beauvoir,89033,89,48,111,9,122,82,213,159
33647,Beine,89034,89,20,124,111,180,85,376,144
33648,Bellechaume,89035,89,73,102,27,105,79,211,175
33649,La Belliole,89036,89,35,50,5,110,50,165,85
33650,Béon,89037,89,65,130,40,160,115,315,195
33651,Bernouil,89038,89,10,35,15,40,20,75,45
33652,Béru,89039,89,15,13,9,18,6,33,28
33653,Bessy-sur-Cure,89040,89,47,31,0,58,16,74,78
33654,Beugnon,89041,89,32,80,24,132,72,228,112
33655,Bierry-les-Belles-Fontaines,89042,89,40,55,10,85,25,120,95
33656,Blacy,89043,89,16,15,15,21,14,50,31
33657,Blannay,89044,89,20,20,5,40,30,75,40
33658,Bleigny-le-Carreau,89045,89,50,65,0,120,70,190,115
33659,Bléneau,89046,89,323,218,127,533,155,815,541
33660,Boeurs-en-Othe,89048,89,68,56,12,132,56,200,124
33661,Bois-d'Arcy,89049,89,5,5,0,15,0,15,10
33662,Bonnard,89050,89,125,196,140,261,180,581,321
33663,Les Bordes,89051,89,107,126,25,137,109,271,233
33664,Branches,89053,89,36,128,60,128,124,312,164
33665,Brannay,89054,89,100,216,56,236,176,468,316
33666,Brienon-sur-Armançon,89055,89,237,761,277,984,489,1750,998
33667,Brion,89056,89,54,120,42,286,47,375,174
33668,Brosses,89057,89,36,60,8,116,72,196,96
33669,Bussières,89058,89,25,20,0,60,20,80,45
33670,Bussy-en-Othe,89059,89,95,165,45,287,120,452,260
33671,Bussy-le-Repos,89060,89,50,115,45,135,95,275,165
33672,Butteaux,89061,89,16,70,25,82,61,168,86
33673,Carisey,89062,89,35,95,25,95,45,165,130
33674,La Celle-Saint-Cyr,89063,89,110,185,80,350,110,540,295
33675,Censy,89064,89,16,16,0,4,12,16,32
33676,Cérilly,89065,89,16,0,0,0,8,8,16
33677,Cerisiers,89066,89,193,215,128,312,160,600,408
33678,Cézy,89067,89,153,213,102,354,185,641,366
33679,Chablis,89068,89,324,470,174,716,412,1302,794
33680,Chailley,89069,89,68,112,68,200,104,372,180
33681,Chamoux,89071,89,25,9,0,36,4,40,34
33682,Champcevrais,89072,89,53,30,20,83,26,129,83
33683,Champignelles,89073,89,235,205,40,330,205,575,440
33684,Champigny,89074,89,221,645,145,689,525,1359,866
33685,Champlay,89075,89,75,170,65,290,120,475,245
33686,Champlost,89076,89,71,196,39,297,155,491,267
33687,Champs-sur-Yonne,89077,89,170,272,130,604,206,940,442
33688,Champvallon,89078,89,64,173,48,236,144,428,237
33689,Chamvres,89079,89,90,150,55,250,120,425,240
33690,La Chapelle-sur-Oreuse,89080,89,34,144,30,154,135,319,178
33691,La Chapelle-Vaupelteigne,89081,89,15,10,25,25,5,55,25
33692,Charbuy,89083,89,174,465,70,784,349,1203,639
33693,Charentenay,89084,89,35,70,45,75,75,195,105
33694,Charmoy,89085,89,215,270,100,330,215,645,485
33695,Charny Orée de Puisaye,89086,89,955,961,314,1881,832,3027,1916
33696,Chassignelles,89087,89,59,75,30,109,50,189,134
33697,Chassy,89088,89,70,110,65,125,85,275,180
33698,Chastellux-sur-Cure,89089,89,30,10,10,60,10,80,40
33699,Châtel-Censoir,89091,89,95,115,60,210,95,365,210
33700,Châtel-Gérard,89092,89,67,25,15,105,10,130,92
33701,Chaumont,89093,89,65,185,30,235,150,415,250
33702,Chaumot,89094,89,73,194,80,287,110,477,267
33703,Chemilly-sur-Serein,89095,89,10,20,33,65,20,118,30
33704,Chemilly-sur-Yonne,89096,89,80,240,65,305,215,585,320
33705,Cheney,89098,89,15,25,36,96,25,157,40
33706,Cheny,89099,89,260,570,232,888,426,1546,830
33707,Chéroy,89100,89,280,377,137,454,265,856,657
33708,Chéu,89101,89,56,152,40,132,156,328,208
33709,Chevannes,89102,89,225,506,165,936,373,1474,731
33710,Chichée,89104,89,40,55,45,105,70,220,95
33711,Chichery,89105,89,30,119,33,158,75,266,149
33712,Chitry,89108,89,60,85,15,105,85,205,145
33713,Cisery,89109,89,5,5,10,20,5,35,10
33714,Les Clérimois,89111,89,50,88,0,95,63,158,138
33715,Collan,89112,89,16,34,24,55,25,104,50
33716,Collemiers,89113,89,56,175,51,154,137,342,231
33717,Compigny,89115,89,8,70,26,58,25,109,78
33718,Cornant,89116,89,64,80,28,104,76,208,144
33719,Coulangeron,89117,89,20,68,12,60,48,120,88
33720,Coulanges-la-Vineuse,89118,89,75,202,68,201,183,452,277
33721,Coulanges-sur-Yonne,89119,89,124,105,35,170,65,270,229
33722,Coulours,89120,89,45,25,10,30,40,80,70
33723,Courgenay,89122,89,104,140,60,196,72,328,244
33724,Courgis,89123,89,28,44,32,92,52,176,72
33725,Courlon-sur-Yonne,89124,89,99,276,109,405,195,709,375
33726,Courson-les-Carrières,89125,89,129,180,58,240,145,443,309
33727,Courtoin,89126,89,16,4,0,4,8,12,20
33728,Courtois-sur-Yonne,89127,89,79,166,33,210,128,371,245
33729,Coutarnoux,89128,89,4,36,24,48,24,96,40
33730,Crain,89129,89,70,85,25,143,65,233,155
33731,Cravant,89130,89,132,216,68,216,200,484,348
33732,Cruzy-le-Châtel,89131,89,48,44,44,116,40,200,92
33733,Cry,89132,89,55,40,5,45,30,80,95
33734,Cudot,89133,89,28,53,26,119,61,206,81
33735,Cussy-les-Forges,89134,89,65,75,30,100,55,185,140
33736,Cuy,89136,89,53,248,53,253,196,502,301
33737,Dannemoine,89137,89,48,96,52,172,92,316,144
33738,Diges,89139,89,159,252,38,402,210,650,411
33739,Dissangis,89141,89,20,44,20,32,28,80,64
33740,Dixmont,89142,89,119,206,50,321,119,490,325
33741,Dollot,89143,89,40,74,33,156,40,229,114
33742,Domats,89144,89,71,199,61,344,158,563,270
33743,Domecy-sur-Cure,89145,89,60,105,30,145,60,235,165
33744,Domecy-sur-le-Vault,89146,89,5,33,21,36,10,67,38
33745,Dracy,89147,89,35,40,20,95,45,160,75
33746,Druyes-les-Belles-Fontaines,89148,89,55,65,20,90,55,165,120
33747,Dyé,89149,89,12,48,4,80,30,114,60
33748,Égleny,89150,89,30,125,20,148,90,258,155
33749,Égriselles-le-Bocage,89151,89,213,289,99,421,192,712,502
33750,Épineau-les-Voves,89152,89,101,167,52,217,121,390,268
33751,Épineuil,89153,89,85,105,65,240,95,400,190
33752,Escamps,89154,89,68,288,76,236,240,552,356
33753,Escolives-Sainte-Camille,89155,89,42,174,61,215,144,420,216
33754,Esnon,89156,89,45,104,22,79,79,180,149
33755,Étais-la-Sauvin,89158,89,110,110,25,225,100,350,220
33756,Étaule,89159,89,25,70,30,208,50,288,95
33757,Étigny,89160,89,103,150,52,242,147,441,253
33758,Étivey,89161,89,29,23,15,77,17,109,52
33759,Évry,89162,89,30,105,40,145,60,245,135
33760,La Ferté-Loupière,89163,89,96,91,21,184,52,257,187
33761,Festigny,89164,89,24,20,8,16,20,44,44
33762,Flacy,89165,89,15,10,5,50,25,80,25
33763,Fleury-la-Vallée,89167,89,145,295,80,365,235,680,440
33764,Fleys,89168,89,5,40,15,78,45,138,45
33765,Flogny-la-Chapelle,89169,89,135,223,87,361,156,604,358
33766,Foissy-lès-Vézelay,89170,89,15,20,10,55,20,85,35
33767,Foissy-sur-Vanne,89171,89,44,105,20,95,45,160,149
33768,Fontaine-la-Gaillarde,89172,89,60,104,48,196,84,328,164
33769,Fontaines,89173,89,43,52,76,186,50,312,95
33770,Fontenailles,89174,89,15,10,5,30,0,35,25
33771,Fontenay-près-Chablis,89175,89,22,44,4,43,16,63,66
33772,Fontenay-près-Vézelay,89176,89,25,35,10,45,15,70,60
33773,Fontenay-sous-Fouronnes,89177,89,32,12,4,8,12,24,44
33774,Fontenoy,89179,89,74,35,20,105,45,170,109
33775,Fouchères,89180,89,48,96,24,160,80,264,144
33776,Fournaudin,89181,89,30,21,7,47,9,63,51
33777,Fouronnes,89182,89,20,49,0,67,20,87,69
33778,Fresnes,89183,89,20,0,10,30,0,40,20
33779,Fulvy,89184,89,20,32,6,44,18,68,52
33780,Germigny,89186,89,75,100,50,230,85,365,175
33781,Gigny,89187,89,17,16,0,43,12,55,33
33782,Girolles,89188,89,15,34,12,66,28,106,49
33783,Gisy-les-Nobles,89189,89,64,164,24,224,104,352,228
33784,Givry,89190,89,20,25,5,85,40,130,45
33785,Gland,89191,89,9,6,0,18,3,21,15
33786,Grimault,89194,89,35,40,5,30,30,65,75
33787,Gron,89195,89,144,320,116,432,212,760,464
33788,Valravillon,89196,89,214,490,158,406,361,925,704
33789,Guillon,89197,89,45,92,35,165,72,272,137
33790,Gurgy,89198,89,172,436,132,608,368,1108,608
33791,Gy-l'Évêque,89199,89,39,88,36,169,62,267,127
33792,Hauterive,89200,89,40,85,60,135,75,270,125
33793,Héry,89201,89,215,415,160,645,350,1155,630
33794,Irancy,89202,89,54,45,35,100,35,170,99
33795,Island,89203,89,42,22,9,70,12,91,64
33796,L'Isle-sur-Serein,89204,89,90,110,45,180,120,345,200
33797,Jaulges,89205,89,32,120,24,144,136,304,152
33798,Joigny,89206,89,1392,2450,987,2799,1452,5238,3842
33799,Jouancy,89207,89,6,3,0,9,3,12,9
33800,Joux-la-Ville,89208,89,72,160,60,176,180,416,232
33801,Jouy,89209,89,60,160,35,80,155,270,220
33802,Jully,89210,89,25,40,10,50,34,94,65
33803,Junay,89211,89,14,11,3,46,9,58,25
33804,Jussy,89212,89,55,78,12,129,71,212,133
33805,Lailly,89214,89,25,50,10,55,35,100,75
33806,Lain,89215,89,20,40,4,72,40,116,60
33807,Lainsecq,89216,89,50,57,23,93,29,145,107
33808,Lalande,89217,89,10,55,5,49,30,84,65
33809,Laroche-Saint-Cydroine,89218,89,156,217,137,506,173,816,373
33810,Lasson,89219,89,8,30,4,74,13,91,38
33811,Lavau,89220,89,60,75,10,155,60,225,135
33812,Leugny,89221,89,80,90,35,100,50,185,170
33813,Levis,89222,89,31,57,6,61,39,106,88
33814,Lézinnes,89223,89,140,126,45,301,103,449,266
33815,Lichères-près-Aigremont,89224,89,15,35,20,55,35,110,50
33816,Lichères-sur-Yonne,89225,89,18,5,0,29,5,34,23
33817,Lignorelles,89226,89,34,39,23,49,22,94,73
33818,Ligny-le-Châtel,89227,89,170,290,90,410,240,740,460
33819,Lindry,89228,89,95,409,71,433,317,821,504
33820,Lixy,89229,89,40,105,5,150,105,260,145
33821,Looze,89230,89,35,130,30,160,85,275,165
33822,Lucy-le-Bois,89232,89,24,47,16,127,41,184,71
33823,Lucy-sur-Cure,89233,89,25,48,21,63,32,116,73
33824,Lucy-sur-Yonne,89234,89,23,20,5,88,10,103,43
33825,Magny,89235,89,140,180,64,328,144,536,320
33826,Maillot,89236,89,116,220,93,463,131,687,336
33827,Mailly-la-Ville,89237,89,85,60,60,205,85,350,145
33828,Mailly-le-Château,89238,89,103,68,28,142,66,236,171
33829,Malay-le-Grand,89239,89,224,284,83,666,219,968,508
33830,Malay-le-Petit,89240,89,24,104,20,140,84,244,128
33831,Maligny,89242,89,98,193,48,231,165,444,291
33832,Marmeaux,89244,89,8,21,0,25,12,37,29
33833,Marsangy,89245,89,70,189,42,232,163,437,259
33834,Massangis,89246,89,116,30,30,95,40,165,146
33835,Mélisey,89247,89,40,60,15,120,30,165,100
33836,Menades,89248,89,10,15,20,15,15,50,25
33837,Mercy,89249,89,20,16,8,20,24,52,36
33838,Méré,89250,89,16,44,0,44,52,96,60
33839,Merry-la-Vallée,89251,89,85,86,25,125,55,205,171
33840,Merry-Sec,89252,89,20,44,4,60,36,100,64
33841,Merry-sur-Yonne,89253,89,40,45,10,65,40,115,85
33842,Mézilles,89254,89,96,95,25,206,75,306,191
33843,Michery,89255,89,132,220,39,344,174,557,352
33844,Migé,89256,89,64,100,40,156,80,276,164
33845,Migennes,89257,89,1214,1701,727,1989,1049,3765,2915
33846,Môlay,89259,89,20,15,0,30,25,55,35
33847,Molesmes,89260,89,16,60,12,64,32,108,76
33848,Molinons,89261,89,36,72,20,76,64,160,108
33849,Molosmes,89262,89,35,38,3,50,31,84,73
33850,Monéteau,89263,89,546,776,290,1537,642,2469,1322
33851,Montacher-Villegardin,89264,89,125,195,55,255,150,460,320
33852,Montigny-la-Resle,89265,89,35,150,35,229,145,409,185
33853,Montillot,89266,89,65,45,10,115,35,160,110
33854,Montréal,89267,89,32,24,12,76,28,116,56
33855,Mont-Saint-Sulpice,89268,89,71,210,54,226,176,456,281
33856,Mouffy,89270,89,24,44,12,28,28,68,68
33857,Moulins-en-Tonnerrois,89271,89,16,12,12,26,12,50,28
33858,Moulins-sur-Ouanne,89272,89,15,80,5,125,65,195,95
33859,Moutiers-en-Puisaye,89273,89,69,45,16,88,31,135,114
33860,Nailly,89274,89,148,295,105,472,223,800,443
33861,Neuvy-Sautour,89276,89,140,160,60,367,175,602,300
33862,Nitry,89277,89,60,105,30,110,85,225,165
33863,Noé,89278,89,38,138,53,161,104,318,176
33864,Noyers,89279,89,132,106,20,208,100,328,238
33865,Nuits,89280,89,45,105,57,69,83,209,150
33866,Les Ormes,89281,89,38,74,12,87,74,173,112
33867,Ormoy,89282,89,61,139,57,237,145,439,200
33868,Ouanne,89283,89,89,99,53,254,93,400,188
33869,Pacy-sur-Armançon,89284,89,50,55,0,60,30,90,105
33870,Pailly,89285,89,12,65,20,86,31,137,77
33871,Parly,89286,89,76,212,52,288,172,512,288
33872,Paron,89287,89,531,1269,486,1603,839,2928,1800
33873,Paroy-en-Othe,89288,89,26,46,20,90,20,130,72
33874,Paroy-sur-Tholon,89289,89,19,67,18,131,32,181,86
33875,Pasilly,89290,89,12,16,0,12,16,28,28
33876,Passy,89291,89,32,74,25,86,69,180,106
33877,Percey,89292,89,44,56,12,73,35,120,100
33878,Perrigny,89295,89,176,262,57,454,191,702,438
33879,Perrigny-sur-Armançon,89296,89,16,32,8,56,12,76,48
33880,Pierre-Perthuis,89297,89,25,40,20,40,10,70,65
33881,Piffonds,89298,89,68,137,62,180,108,350,205
33882,Pimelles,89299,89,0,20,15,20,10,45,20
33883,Pisy,89300,89,6,9,0,23,15,38,15
33884,Plessis-Saint-Jean,89302,89,22,42,0,96,26,122,64
33885,Poilly-sur-Serein,89303,89,65,87,0,95,68,163,152
33886,Poilly-sur-Tholon,89304,89,90,195,10,235,145,390,285
33887,Pontaubert,89306,89,50,80,35,165,55,255,130
33888,Pontigny,89307,89,95,125,95,285,145,525,220
33889,Pont-sur-Vanne,89308,89,35,27,3,57,28,88,62
33890,Pont-sur-Yonne,89309,89,457,732,386,1193,465,2044,1189
33891,La Postolle,89310,89,29,26,10,27,15,52,55
33892,Pourrain,89311,89,150,331,85,570,215,870,481
33893,Précy-le-Sec,89312,89,35,71,10,60,50,120,106
33894,Précy-sur-Vrin,89313,89,65,120,15,175,80,270,185
33895,Prégilbert,89314,89,6,38,18,83,27,128,44
33896,Préhy,89315,89,30,35,10,30,40,80,65
33897,Provency,89316,89,24,40,8,85,40,133,64
33898,Quarré-les-Tombes,89318,89,151,136,35,216,136,387,287
33899,Quenne,89319,89,45,124,15,176,115,306,169
33900,Quincerot,89320,89,18,13,0,18,3,21,31
33901,Ravières,89321,89,115,138,78,216,120,414,253
33902,Roffey,89323,89,24,20,16,72,8,96,44
33903,Rogny-les-Sept-Écluses,89324,89,147,129,45,289,86,420,276
33904,Ronchères,89325,89,35,10,10,35,5,50,45
33905,Rosoy,89326,89,58,266,106,371,222,699,324
33906,Rousson,89327,89,60,115,20,145,85,250,175
33907,Rouvray,89328,89,28,100,52,140,84,276,128
33908,Rugny,89329,89,12,13,3,32,9,44,25
33909,Sainpuits,89331,89,53,66,6,95,52,153,119
33910,Saint-Agnan,89332,89,50,289,47,296,177,520,339
33911,Saint-André-en-Terre-Plaine,89333,89,29,22,15,41,21,77,51
33912,Le Val d'Ocre,89334,89,125,137,56,148,96,300,262
33913,Saint-Aubin-sur-Yonne,89335,89,30,80,40,180,70,290,110
33914,Saint-Brancher,89336,89,50,80,20,110,55,185,130
33915,Saint-Bris-le-Vineux,89337,89,113,188,73,365,173,611,301
33916,Saint-Clément,89338,89,422,542,155,1092,413,1660,964
33917,Sainte-Colombe,89339,89,10,60,10,60,60,130,70
33918,Sainte-Colombe-sur-Loing,89340,89,40,24,16,84,40,140,64
33919,Saint-Cyr-les-Colons,89341,89,36,104,36,148,124,308,140
33920,Saint-Denis-lès-Sens,89342,89,109,220,75,189,130,394,329
33921,Saint-Fargeau,89344,89,270,310,110,635,275,1020,580
33922,Saint-Florentin,89345,89,799,1002,522,1464,635,2621,1801
33923,Saint-Georges-sur-Baulche,89346,89,795,576,211,1172,392,1775,1371
33924,Saint-Germain-des-Champs,89347,89,55,75,30,135,65,230,130
33925,Saint-Julien-du-Sault,89348,89,327,599,195,768,410,1373,926
33926,Saint-Léger-Vauban,89349,89,55,65,20,115,35,170,120
33927,Saint-Loup-d'Ordon,89350,89,21,64,24,69,49,142,85
33928,Sainte-Magnance,89351,89,80,110,40,160,75,275,190
33929,Saint-Martin-des-Champs,89352,89,48,60,32,88,60,180,108
33930,Saint-Martin-d'Ordon,89353,89,48,125,20,120,96,236,173
33931,Saint-Martin-du-Tertre,89354,89,195,385,135,578,275,988,580
33932,Saint-Martin-sur-Armançon,89355,89,19,16,0,59,14,73,35
33933,Saint-Maurice-aux-Riches-Hommes,89359,89,41,68,6,100,83,189,109
33934,Saint-Maurice-le-Vieil,89360,89,43,82,0,113,96,209,125
33935,Saint-Maurice-Thizouaille,89361,89,15,90,5,85,64,154,105
33936,Saint-Moré,89362,89,32,23,7,68,19,94,55
33937,Sainte-Pallaye,89363,89,5,45,0,40,20,60,50
33938,Saint-Père,89364,89,79,45,15,115,55,185,124
33939,Saint-Privé,89365,89,104,96,44,220,80,344,200
33940,Saints-en-Puisaye,89367,89,136,116,24,224,80,328,252
33941,Saint-Sauveur-en-Puisaye,89368,89,200,105,50,385,55,490,305
33942,Saint-Sérotin,89369,89,75,147,50,117,117,284,222
33943,Saint-Valérien,89370,89,245,420,175,455,285,915,665
33944,Sainte-Vertu,89371,89,20,15,0,40,15,55,35
33945,Saligny,89373,89,29,139,80,252,117,449,168
33946,Sambourg,89374,89,3,33,6,12,24,42,36
33947,Santigny,89375,89,48,20,0,25,10,35,68
33948,Sarry,89376,89,25,40,10,55,35,100,65
33949,Sauvigny-le-Beuréal,89377,89,17,8,4,17,12,33,25
33950,Sauvigny-le-Bois,89378,89,125,140,75,220,165,460,265
33951,Savigny-en-Terre-Plaine,89379,89,20,34,16,25,30,71,54
33952,Savigny-sur-Clairis,89380,89,75,81,25,92,64,181,156
33953,Sceaux,89381,89,16,35,16,36,20,72,51
33954,Seignelay,89382,89,208,416,120,500,340,960,624
33955,Sementron,89383,89,19,20,3,31,16,50,39
33956,Senan,89384,89,57,188,72,284,136,492,245
33957,Sennevoy-le-Bas,89385,89,15,10,0,60,10,70,25
33958,Sennevoy-le-Haut,89386,89,28,13,0,33,16,49,41
33959,Sens,89387,89,3828,5824,3046,7657,4171,14874,9652
33960,Sépeaux-Saint Romain,89388,89,78,134,50,209,96,355,212
33961,Serbonnes,89390,89,64,161,40,132,144,316,225
33962,Sergines,89391,89,132,356,76,382,288,746,488
33963,Sermizelles,89392,89,55,35,20,95,50,165,90
33964,Serrigny,89393,89,25,25,0,40,20,60,50
33965,Sery,89394,89,16,28,16,36,12,64,44
33966,Les Sièges,89395,89,39,113,52,108,81,241,152
33967,Sommecaise,89397,89,52,63,24,148,54,226,115
33968,Sormery,89398,89,75,65,10,160,45,215,140
33969,Soucy,89399,89,221,371,108,492,303,903,592
33970,Sougères-en-Puisaye,89400,89,73,49,9,110,47,166,122
33971,Soumaintrain,89402,89,25,38,18,75,29,122,63
33972,Stigny,89403,89,12,40,4,48,12,64,52
33973,Subligny,89404,89,39,110,29,181,86,296,149
33974,Taingy,89405,89,48,80,8,108,72,188,128
33975,Talcy,89406,89,10,16,5,37,10,52,26
33976,Tanlay,89407,89,155,212,98,394,138,630,367
33977,Tannerre-en-Puisaye,89408,89,50,60,15,100,60,175,110
33978,Tharoiseau,89409,89,0,15,0,25,20,45,15
33979,Tharot,89410,89,8,17,0,41,8,49,25
33980,Les Vallées de la Vanne,89411,89,127,282,103,304,218,625,409
33981,Thizy,89412,89,15,50,10,40,30,80,65
33982,Thorey,89413,89,5,0,0,5,20,25,5
33983,Thorigny-sur-Oreuse,89414,89,256,348,100,476,320,896,604
33984,Thory,89415,89,20,65,4,52,68,124,85
33985,Thury,89416,89,91,81,42,147,39,228,172
33986,Tissey,89417,89,15,35,15,30,20,65,50
33987,Tonnerre,89418,89,573,1054,504,1529,782,2815,1627
33988,Toucy,89419,89,449,613,180,932,455,1567,1062
33989,Treigny,89420,89,156,141,35,372,118,525,297
33990,Trévilly,89421,89,9,20,0,30,20,50,29
33991,Trichey,89422,89,4,8,0,8,12,20,12
33992,Tronchoy,89423,89,44,8,8,60,0,68,52
33993,Trucy-sur-Yonne,89424,89,30,40,15,30,35,80,70
33994,Turny,89425,89,79,125,40,307,75,422,204
33995,Val-de-Mercy,89426,89,40,100,28,116,92,236,140
33996,Vallan,89427,89,101,160,45,167,147,359,261
33997,Vallery,89428,89,50,165,60,195,90,345,215
33998,Varennes,89430,89,26,79,25,83,60,168,105
33999,Vassy-sous-Pisy,89431,89,10,10,5,40,15,60,20
34000,Vaudeurs,89432,89,80,145,60,150,80,290,225
34001,Vault-de-Lugny,89433,89,56,64,20,108,68,196,120
34002,Vaumort,89434,89,20,95,45,135,50,230,115
34003,Venizy,89436,89,100,276,96,284,188,568,376
34004,Venouse,89437,89,55,65,6,95,51,152,120
34005,Venoy,89438,89,170,374,101,580,342,1023,544
34006,Vergigny,89439,89,225,327,140,515,230,885,552
34007,Verlin,89440,89,48,100,24,136,104,264,148
34008,Vermenton,89441,89,252,292,112,436,224,772,544
34009,Vernoy,89442,89,29,59,12,45,56,113,88
34010,Véron,89443,89,251,497,122,575,425,1122,748
34011,Vézannes,89445,89,20,0,0,20,0,20,20
34012,Vézelay,89446,89,30,55,10,170,25,205,85
34013,Vézinnes,89447,89,20,20,15,81,15,111,40
34014,Vignes,89448,89,6,18,0,31,15,46,24
34015,Villeblevin,89449,89,154,484,134,658,302,1094,638
34016,Villebougis,89450,89,127,161,21,180,92,293,288
34017,Villechétive,89451,89,15,50,25,90,55,170,65
34018,Villecien,89452,89,70,95,25,120,80,225,165
34019,Villefargeau,89453,89,122,263,62,335,190,587,385
34020,Villemanoche,89456,89,88,176,72,184,140,396,264
34021,Villenavotte,89458,89,16,45,0,75,30,105,61
34022,Villeneuve-la-Dondagre,89459,89,24,76,20,104,52,176,100
34023,Villeneuve-la-Guyard,89460,89,373,922,276,984,614,1874,1295
34024,Villeneuve-l'Archevêque,89461,89,248,308,112,324,172,608,556
34025,Villeneuve-les-Genêts,89462,89,65,55,15,110,35,160,120
34026,Villeneuve-Saint-Salves,89463,89,20,81,20,80,56,156,101
34027,Villeneuve-sur-Yonne,89464,89,872,1142,422,1695,880,2997,2014
34028,Villeperrot,89465,89,32,76,16,112,92,220,108
34029,Villeroy,89466,89,32,126,24,122,113,259,158
34030,Villethierry,89467,89,53,247,80,260,148,488,300
34031,Villevallier,89468,89,24,80,43,151,70,264,104
34032,Perceneige,89469,89,125,230,95,320,200,615,355
34033,Villiers-les-Hauts,89470,89,15,20,10,56,15,81,35
34034,Villiers-Louis,89471,89,35,110,27,156,81,264,145
34035,Villiers-Saint-Benoît,89472,89,124,84,60,136,96,292,208
34036,Villiers-sur-Tholon,89473,89,60,90,70,164,100,334,150
34037,Villiers-Vineux,89474,89,60,104,28,52,68,148,164
34038,Villon,89475,89,16,13,8,28,16,52,29
34039,Villy,89477,89,23,6,9,21,15,45,29
34040,Vincelles,89478,89,120,216,96,336,184,616,336
34041,Vincelottes,89479,89,45,35,45,114,40,199,80
34042,Vinneuf,89480,89,152,388,92,500,240,832,540
34043,Vireaux,89481,89,10,65,10,25,35,70,75
34044,Viviers,89482,89,20,30,10,30,40,80,50
34045,Voisines,89483,89,73,123,18,152,86,256,196
34046,Volgré,89484,89,48,80,20,144,64,228,128
34047,Voutenay-sur-Cure,89485,89,20,65,20,65,50,135,85
34048,Yrouerre,89486,89,25,10,20,80,15,115,35
34049,Andelnans,90001,90,192,308,92,384,260,736,500
34050,Angeot,90002,90,47,75,12,87,71,170,122
34051,Anjoutey,90003,90,58,144,41,202,115,358,202
34052,Argiésans,90004,90,20,98,38,168,73,279,118
34053,Auxelles-Bas,90005,90,30,110,15,195,100,310,140
34054,Auxelles-Haut,90006,90,45,65,0,130,45,175,110
34055,Banvillars,90007,90,38,79,12,92,44,148,117
34056,Bavilliers,90008,90,432,1076,582,1485,747,2814,1508
34057,Beaucourt,90009,90,614,1244,614,1470,924,3008,1858
34058,Belfort,90010,90,5594,11857,8270,12871,9557,30698,17451
34059,Bermont,90011,90,30,103,40,113,90,243,133
34060,Bessoncourt,90012,90,107,326,85,312,268,665,433
34061,Bethonvilliers,90013,90,15,100,15,80,65,160,115
34062,Boron,90014,90,25,121,53,153,61,267,146
34063,Botans,90015,90,41,46,20,120,35,175,87
34064,Bourg-sous-Châtelet,90016,90,9,16,3,51,10,64,25
34065,Bourogne,90017,90,151,356,133,486,278,897,507
34066,Brebotte,90018,90,16,116,48,88,96,232,132
34067,Bretagne,90019,90,65,80,10,60,55,125,145
34068,Buc,90020,90,35,50,30,151,35,216,85
34069,Charmois,90021,90,16,72,20,84,88,192,88
34070,Châtenois-les-Forges,90022,90,413,610,249,915,452,1616,1023
34071,Chaux,90023,90,78,208,88,340,175,603,286
34072,Chavanatte,90024,90,10,55,0,55,35,90,65
34073,Chavannes-les-Grands,90025,90,52,60,40,96,60,196,112
34074,Chèvremont,90026,90,150,425,155,544,335,1034,575
34075,Courcelles,90027,90,32,40,20,20,24,64,72
34076,Courtelevant,90028,90,50,115,35,150,75,260,165
34077,Cravanche,90029,90,185,551,136,695,293,1124,736
34078,Croix,90030,90,20,45,10,65,30,105,65
34079,Cunelières,90031,90,24,87,12,99,69,180,111
34080,Danjoutin,90032,90,546,952,387,1031,633,2051,1498
34081,Delle,90033,90,672,1347,809,1788,1056,3653,2019
34082,Denney,90034,90,72,212,64,288,128,480,284
34083,Dorans,90035,90,75,185,55,230,145,430,260
34084,Eguenigue,90036,90,52,43,7,63,40,110,95
34085,Éloie,90037,90,70,240,95,420,165,680,310
34086,Essert,90039,90,513,716,299,1135,473,1907,1229
34087,Étueffont,90041,90,169,326,83,492,281,856,495
34088,Évette-Salbert,90042,90,295,460,125,855,350,1330,755
34089,Faverois,90043,90,38,144,25,177,128,330,182
34090,Felon,90044,90,15,53,9,84,48,141,68
34091,Fêche-l'Église,90045,90,96,196,72,280,152,504,292
34092,Florimont,90046,90,24,100,56,180,84,320,124
34093,Fontaine,90047,90,35,158,30,179,124,333,193
34094,Fontenelle,90048,90,25,16,5,53,21,79,41
34095,Foussemagne,90049,90,39,336,34,196,237,467,375
34096,Frais,90050,90,20,50,0,95,50,145,70
34097,Froidefontaine,90051,90,31,92,67,121,97,285,123
34098,Giromagny,90052,90,403,657,320,1030,546,1896,1060
34099,Grandvillars,90053,90,375,689,325,885,618,1828,1064
34100,Grosmagny,90054,90,63,123,42,215,59,316,186
34101,Grosne,90055,90,35,75,20,105,75,200,110
34102,Joncherey,90056,90,272,268,96,452,200,748,540
34103,Lachapelle-sous-Chaux,90057,90,68,176,32,284,136,452,244
34104,Lachapelle-sous-Rougemont,90058,90,36,174,68,124,178,370,210
34105,Lacollonge,90059,90,45,60,10,70,45,125,105
34106,Lagrange,90060,90,8,25,12,45,32,89,33
34107,Lamadeleine-Val-des-Anges,90061,90,5,5,0,20,0,20,10
34108,Larivière,90062,90,36,90,12,96,58,166,126
34109,Lebetain,90063,90,43,82,46,154,53,253,125
34110,Lepuix-Neuf,90064,90,20,80,15,90,95,200,100
34111,Lepuix,90065,90,159,265,25,393,229,647,424
34112,Leval,90066,90,40,53,16,82,33,131,93
34113,Menoncourt,90067,90,20,110,40,155,95,290,130
34114,Meroux,90068,90,89,198,39,263,204,506,287
34115,Méziré,90069,90,147,333,146,483,200,829,480
34116,Montbouton,90070,90,40,65,65,175,55,295,105
34117,Montreux-Château,90071,90,141,306,134,251,271,656,447
34118,Morvillars,90072,90,112,342,112,371,243,726,454
34119,Moval,90073,90,36,112,68,136,72,276,148
34120,Novillard,90074,90,15,80,40,115,60,215,95
34121,Offemont,90075,90,430,1014,387,1052,761,2200,1444
34122,Pérouse,90076,90,114,281,88,388,207,683,395
34123,Petit-Croix,90077,90,39,57,10,97,53,160,96
34124,Petitefontaine,90078,90,4,52,16,52,52,120,56
34125,Petitmagny,90079,90,64,40,28,108,32,168,104
34126,Phaffans,90080,90,35,115,45,155,85,285,150
34127,Réchésy,90081,90,88,200,96,252,176,524,288
34128,Autrechêne,90082,90,18,80,9,95,41,145,98
34129,Recouvrance,90083,90,12,21,13,21,25,59,33
34130,Reppe,90084,90,57,81,8,105,34,147,138
34131,Riervescemont,90085,90,0,42,7,22,30,59,42
34132,Romagny-sous-Rougemont,90086,90,21,49,0,69,52,121,70
34133,Roppe,90087,90,97,241,67,356,153,576,338
34134,Rougegoutte,90088,90,201,236,40,375,135,550,437
34135,Rougemont-le-Château,90089,90,146,311,155,330,307,792,457
34136,Saint-Dizier-l'Évêque,90090,90,28,120,48,164,76,288,148
34137,Saint-Germain-le-Châtelet,90091,90,55,155,45,245,125,415,210
34138,Sermamagny,90093,90,155,165,56,309,113,478,320
34139,Sevenans,90094,90,55,251,110,175,85,370,306
34140,Suarce,90095,90,32,132,28,144,104,276,164
34141,Thiancourt,90096,90,32,68,20,68,88,176,100
34142,Trévenans,90097,90,175,264,115,494,145,754,439
34143,Urcerey,90098,90,47,12,13,78,20,111,59
34144,Valdoie,90099,90,698,1265,656,1633,917,3206,1963
34145,Vauthiermont,90100,90,24,52,24,80,44,148,76
34146,Vellescot,90101,90,12,84,20,68,76,164,96
34147,Vescemont,90102,90,90,205,34,277,170,481,295
34148,Vétrigne,90103,90,80,156,44,192,148,384,236
34149,Vézelois,90104,90,147,205,91,309,140,540,352
34150,Villars-le-Sec,90105,90,0,40,34,36,45,115,40
34151,Abbéville-la-Rivière,91001,91,10,92,20,133,49,202,102
34152,Angerville,91016,91,448,1276,320,1142,865,2327,1724
34153,Angervilliers,91017,91,118,489,149,404,329,882,607
34154,Arpajon,91021,91,1041,2501,1755,2603,2279,6637,3542
34155,Arrancourt,91022,91,8,44,4,62,13,79,52
34156,Athis-Mons,91027,91,2764,8266,3996,8724,6917,19637,11030
34157,Authon-la-Plaine,91035,91,25,95,21,110,73,204,120
34158,Auvernaux,91037,91,24,72,48,128,68,244,96
34159,Auvers-Saint-Georges,91038,91,83,375,80,431,223,734,458
34160,Avrainville,91041,91,37,269,61,213,250,524,306
34161,Ballainvilliers,91044,91,251,1238,432,1184,953,2569,1489
34162,Ballancourt-sur-Essonne,91045,91,775,1865,835,2543,1394,4772,2640
34163,Baulne,91047,91,133,319,124,396,262,782,452
34164,Bièvres,91064,91,471,1130,440,1394,813,2647,1601
34165,Blandy,91067,91,15,30,10,35,30,75,45
34166,Boigneville,91069,91,44,84,42,144,26,212,128
34167,Bois-Herpin,91075,91,10,15,0,25,10,35,25
34168,Boissy-la-Rivière,91079,91,56,146,52,212,92,356,202
34169,Boissy-le-Cutté,91080,91,90,374,121,325,295,741,464
34170,Boissy-le-Sec,91081,91,50,215,70,215,135,420,265
34171,Boissy-sous-Saint-Yon,91085,91,324,962,378,1214,802,2394,1286
34172,Bondoufle,91086,91,690,2475,876,2978,1818,5672,3165
34173,Boullay-les-Troux,91093,91,51,151,35,243,87,365,202
34174,Bouray-sur-Juine,91095,91,148,507,259,778,443,1480,655
34175,Boussy-Saint-Antoine,91097,91,505,1893,734,2098,1574,4406,2398
34176,Boutervilliers,91098,91,12,119,41,122,115,278,131
34177,Boutigny-sur-Essonne,91099,91,353,706,292,1017,497,1806,1059
34178,Bouville,91100,91,65,200,45,213,155,413,265
34179,Brétigny-sur-Orge,91103,91,2294,6918,3973,6050,5762,15785,9212
34180,Breuillet,91105,91,848,2387,719,2556,1742,5017,3235
34181,Breux-Jouy,91106,91,144,280,148,472,200,820,424
34182,Brières-les-Scellés,91109,91,124,335,114,331,263,708,459
34183,Briis-sous-Forges,91111,91,293,989,272,1026,745,2043,1282
34184,Brouy,91112,91,20,32,8,52,16,76,52
34185,Brunoy,91114,91,2781,6853,2915,8126,4865,15906,9634
34186,Bruyères-le-Châtel,91115,91,330,967,320,1000,705,2025,1297
34187,Buno-Bonnevaux,91121,91,30,106,60,212,55,327,136
34188,Bures-sur-Yvette,91122,91,1145,2320,980,3116,1446,5542,3465
34189,Cerny,91129,91,345,811,284,1052,690,2026,1156
34190,Chalo-Saint-Mars,91130,91,96,336,84,408,244,736,432
34191,Chalou-Moulineux,91131,91,26,118,29,138,76,243,144
34192,Chamarande,91132,91,152,288,152,348,184,684,440
34193,Champcueil,91135,91,131,736,239,796,454,1489,867
34194,Champlan,91136,91,190,720,332,726,633,1691,910
34195,Champmotteux,91137,91,15,100,30,150,55,235,115
34196,Chatignonville,91145,91,4,12,4,24,4,32,16
34197,Chauffour-lès-Étréchy,91148,91,8,44,0,32,48,80,52
34198,Cheptainville,91156,91,148,581,184,508,482,1174,729
34199,Chevannes,91159,91,80,516,192,568,396,1156,596
34200,Chilly-Mazarin,91161,91,1628,5321,2706,5111,4701,12518,6949
34201,Corbeil-Essonnes,91174,91,3541,13811,8410,11792,10549,30751,17352
34202,Corbreuse,91175,91,144,476,176,536,364,1076,620
34203,Le Coudray-Montceaux,91179,91,364,1381,503,1297,1114,2914,1745
34204,Courances,91180,91,18,86,24,140,51,215,104
34205,Courcouronnes,91182,91,808,4066,1795,3569,2758,8122,4874
34206,Courdimanche-sur-Essonne,91184,91,35,65,10,129,30,169,100
34207,Courson-Monteloup,91186,91,20,124,68,239,83,390,144
34208,Crosne,91191,91,751,2509,870,2688,2055,5613,3260
34209,Dannemois,91195,91,110,180,40,330,165,535,290
34210,D'Huison-Longueville,91198,91,189,388,150,433,328,911,577
34211,Dourdan,91200,91,1088,2863,1180,2972,2021,6173,3951
34212,Draveil,91201,91,2932,7854,3100,8826,5351,17277,10786
34213,Écharcon,91204,91,48,190,43,296,146,485,238
34214,Égly,91207,91,451,1651,602,1617,1197,3416,2102
34215,Épinay-sous-Sénart,91215,91,801,4142,1640,3229,2531,7400,4943
34216,Épinay-sur-Orge,91216,91,1152,2440,1270,3107,1872,6249,3592
34217,Estouches,91222,91,15,58,35,60,63,158,73
34218,Étampes,91223,91,1981,6864,3361,6269,4942,14572,8845
34219,Étiolles,91225,91,264,771,360,1207,562,2129,1035
34220,Étréchy,91226,91,1003,1401,655,2152,1101,3908,2404
34221,Évry,91228,91,2335,16223,8768,12581,11502,32851,18558
34222,La Ferté-Alais,91232,91,300,1065,427,1181,858,2466,1365
34223,Fleury-Mérogis,91235,91,124,1856,732,1191,1244,3167,1980
34224,Fontaine-la-Rivière,91240,91,4,44,64,80,44,188,48
34225,Fontenay-lès-Briis,91243,91,144,582,170,571,426,1167,726
34226,Fontenay-le-Vicomte,91244,91,108,311,158,472,168,798,419
34227,La Forêt-le-Roi,91247,91,47,149,29,134,104,267,196
34228,La Forêt-Sainte-Croix,91248,91,20,52,8,32,48,88,72
34229,Forges-les-Bains,91249,91,260,1043,395,1262,780,2437,1303
34230,Gif-sur-Yvette,91272,91,2353,5454,1976,6723,3612,12311,7807
34231,Gironville-sur-Essonne,91273,91,55,255,90,255,140,485,310
34232,Gometz-la-Ville,91274,91,91,385,163,445,294,902,476
34233,Gometz-le-Châtel,91275,91,300,735,215,750,565,1530,1035
34234,Les Granges-le-Roi,91284,91,154,360,80,354,235,669,514
34235,Grigny,91286,91,1252,10502,4075,6141,5879,16095,11754
34236,Guibeville,91292,91,10,185,100,320,100,520,195
34237,Guigneville-sur-Essonne,91293,91,95,290,55,313,195,563,385
34238,Guillerval,91294,91,122,227,46,243,121,410,349
34239,Igny,91312,91,1230,2721,1027,3169,1795,5991,3951
34240,Itteville,91315,91,450,2012,639,2012,1617,4268,2462
34241,Janville-sur-Juine,91318,91,196,478,193,609,372,1174,674
34242,Janvry,91319,91,69,165,45,218,125,388,234
34243,Juvisy-sur-Orge,91326,91,1712,3825,2515,3989,3839,10343,5537
34244,Lardy,91330,91,535,1463,480,1847,1076,3403,1998
34245,Leudeville,91332,91,64,423,164,455,286,905,487
34246,Leuville-sur-Orge,91333,91,175,1117,505,1448,826,2779,1292
34247,Limours,91338,91,793,1632,727,2239,1244,4210,2425
34248,Linas,91339,91,475,1801,728,1985,1422,4135,2276
34249,Lisses,91340,91,372,2137,854,2567,1622,5043,2509
34250,Longjumeau,91345,91,2050,5873,2827,6155,4503,13485,7923
34251,Longpont-sur-Orge,91347,91,539,1560,670,2080,1375,4125,2099
34252,Maisse,91359,91,321,688,204,849,489,1542,1009
34253,Marcoussis,91363,91,778,2155,924,2447,1442,4813,2933
34254,Marolles-en-Beauce,91374,91,16,60,20,68,56,144,76
34255,Marolles-en-Hurepoix,91376,91,519,1366,503,1626,1029,3158,1885
34256,Massy,91377,91,4166,12500,7504,11667,11333,30504,16666
34257,Mauchamps,91378,91,12,81,13,69,66,148,93
34258,Mennecy,91386,91,1241,3658,1505,4391,2594,8490,4899
34259,Méréville,91390,91,340,754,224,1112,655,1991,1094
34260,Mérobert,91393,91,17,199,39,163,152,354,216
34261,Mespuits,91399,91,16,66,8,55,31,94,82
34262,Milly-la-Forêt,91405,91,694,1062,395,1563,925,2883,1756
34263,Moigny-sur-École,91408,91,95,315,95,520,250,865,410
34264,Les Molières,91411,91,124,565,112,683,399,1194,689
34265,Mondeville,91412,91,74,154,50,263,119,432,228
34266,Monnerville,91414,91,28,100,48,124,88,260,128
34267,Montgeron,91421,91,2619,5840,2769,7242,4216,14227,8459
34268,Montlhéry,91425,91,611,1974,1012,2191,1594,4797,2585
34269,Morangis,91432,91,1369,3220,1509,3838,2439,7786,4589
34270,Morigny-Champigny,91433,91,585,1020,425,1521,731,2677,1605
34271,Morsang-sur-Orge,91434,91,2118,5957,2216,6409,4475,13100,8075
34272,Morsang-sur-Seine,91435,91,48,99,39,202,89,330,147
34273,Nainville-les-Roches,91441,91,40,85,50,214,95,359,125
34274,La Norville,91457,91,395,1125,295,1485,815,2595,1520
34275,Nozay,91458,91,278,1418,505,1484,1081,3070,1696
34276,Ollainville,91461,91,438,1324,384,1196,1082,2662,1762
34277,Oncy-sur-École,91463,91,136,252,72,376,180,628,388
34278,Ormoy,91468,91,104,601,157,537,484,1178,705
34279,Ormoy-la-Rivière,91469,91,95,248,90,373,140,603,343
34280,Orsay,91471,91,2045,3699,2138,4765,2641,9544,5744
34281,Orveau,91473,91,4,53,13,59,55,127,57
34282,Palaiseau,91477,91,3330,7731,4113,9361,6256,19730,11061
34283,Paray-Vieille-Poste,91479,91,1029,1796,819,2355,1248,4422,2825
34284,Pecqueuse,91482,91,45,136,50,247,100,397,181
34285,Le Plessis-Pâté,91494,91,268,1076,377,1353,845,2575,1344
34286,Plessis-Saint-Benoist,91495,91,17,95,33,62,67,162,112
34287,Prunay-sur-Essonne,91507,91,25,60,28,114,30,172,85
34288,Puiselet-le-Marais,91508,91,15,67,16,92,42,150,82
34289,Pussay,91511,91,213,588,138,616,451,1205,801
34290,Quincy-sous-Sénart,91514,91,876,2149,1273,2520,1480,5273,3025
34291,Richarville,91519,91,29,83,25,136,62,223,112
34292,Ris-Orangis,91521,91,2547,7950,3267,7291,5787,16345,10497
34293,Roinville,91525,91,99,339,155,388,219,762,438
34294,Roinvilliers,91526,91,0,12,16,48,16,80,12
34295,Saclas,91533,91,135,471,148,622,379,1149,606
34296,Saclay,91534,91,283,1192,326,1066,864,2256,1475
34297,Saint-Aubin,91538,91,32,156,49,258,132,439,188
34298,Saint-Chéron,91540,91,597,1277,540,1472,996,3008,1874
34299,Saint-Cyr-la-Rivière,91544,91,38,135,57,138,101,296,173
34300,Saint-Cyr-sous-Dourdan,91546,91,60,275,80,402,190,672,335
34301,Saint-Escobille,91547,91,28,155,65,105,105,275,183
34302,Sainte-Geneviève-des-Bois,91549,91,3947,9270,4353,10844,6799,21996,13217
34303,Saint-Germain-lès-Arpajon,91552,91,658,2972,1098,2774,1972,5844,3630
34304,Saint-Germain-lès-Corbeil,91553,91,722,1939,690,2553,1397,4640,2661
34305,Saint-Hilaire,91556,91,20,103,12,136,86,234,123
34306,Saint-Jean-de-Beauregard,91560,91,24,104,32,88,92,212,128
34307,Saint-Maurice-Montcouronne,91568,91,77,431,134,578,282,994,508
34308,Saint-Michel-sur-Orge,91570,91,2058,5295,2579,5688,4120,12387,7353
34309,Saint-Pierre-du-Perray,91573,91,622,3158,1265,2389,2399,6053,3780
34310,Saintry-sur-Seine,91577,91,610,1447,523,1780,1020,3323,2057
34311,Saint-Sulpice-de-Favières,91578,91,16,76,32,132,60,224,92
34312,Saint-Vrain,91579,91,280,720,299,939,638,1876,1000
34313,Saint-Yon,91581,91,44,220,80,332,212,624,264
34314,Saulx-les-Chartreux,91587,91,486,1324,500,1551,1111,3162,1810
34315,Savigny-sur-Orge,91589,91,4161,9092,4621,11506,7221,23348,13253
34316,Sermaise,91593,91,164,432,108,616,332,1056,596
34317,Soisy-sur-École,91599,91,219,264,112,483,214,809,483
34318,Soisy-sur-Seine,91600,91,826,1498,673,2600,1073,4346,2324
34319,Souzy-la-Briche,91602,91,15,131,35,86,75,196,146
34320,Congerville-Thionville,91613,91,3,64,22,68,46,136,67
34321,Tigery,91617,91,65,1113,308,775,955,2038,1178
34322,Torfou,91619,91,20,80,15,70,70,155,100
34323,Valpuiseaux,91629,91,45,150,45,260,95,400,195
34324,Le Val-Saint-Germain,91630,91,95,339,86,546,268,900,434
34325,Varennes-Jarcy,91631,91,183,576,196,889,350,1435,759
34326,Vaugrigneuse,91634,91,105,315,175,375,225,775,420
34327,Vauhallan,91635,91,258,444,165,728,264,1157,702
34328,Vayres-sur-Essonne,91639,91,76,220,68,344,164,576,296
34329,Verrières-le-Buisson,91645,91,2069,4126,1293,5376,2427,9096,6195
34330,Vert-le-Grand,91648,91,225,672,253,623,503,1379,897
34331,Vert-le-Petit,91649,91,135,800,265,1000,595,1860,935
34332,Videlles,91654,91,47,107,34,239,103,376,154
34333,Vigneux-sur-Seine,91657,91,2835,9378,4110,8187,6267,18564,12213
34334,Villabé,91659,91,292,1485,623,1775,1037,3435,1777
34335,Villebon-sur-Yvette,91661,91,1015,2404,1422,3293,2115,6830,3419
34336,Villeconin,91662,91,68,168,39,277,136,452,236
34337,La Ville-du-Bois,91665,91,332,2087,894,2264,1481,4639,2419
34338,Villejust,91666,91,80,668,202,752,487,1441,748
34339,Villemoisson-sur-Orge,91667,91,672,1557,799,2390,1205,4394,2229
34340,Villeneuve-sur-Auvers,91671,91,86,137,30,169,133,332,223
34341,Villiers-le-Bâcle,91679,91,85,339,99,384,242,725,424
34342,Villiers-sur-Orge,91685,91,408,1252,398,1371,852,2621,1660
34343,Viry-Châtillon,91687,91,3149,8634,4154,8587,6451,19192,11783
34344,Wissous,91689,91,630,2035,1131,2117,1742,4990,2665
34345,Yerres,91691,91,3071,7383,3117,9007,6017,18141,10454
34346,Les Ulis,91692,91,1359,7490,3111,6616,5317,15044,8849
34347,Antony,92002,92,7469,14844,7609,18151,12255,38015,22313
34348,Asnières-sur-Seine,92004,92,6605,22341,12604,22054,22036,56694,28946
34349,Bagneux,92007,92,3599,10242,5259,10845,8100,24204,13841
34350,Bois-Colombes,92009,92,2688,7450,3493,8010,6517,18020,10138
34351,Boulogne-Billancourt,92012,92,12617,25405,17638,31312,27987,76937,38022
34352,Bourg-la-Reine,92014,92,2573,4657,2841,5688,3768,12297,7230
34353,Châtenay-Malabry,92019,92,2919,8166,4015,8991,6984,19990,11085
34354,Châtillon,92020,92,2955,9229,5177,10111,9094,24382,12184
34355,Chaville,92022,92,2170,4774,2403,5646,4146,12195,6944
34356,Clamart,92023,92,5795,13146,6384,15805,10167,32356,18941
34357,Clichy,92024,92,3826,14589,9339,14870,15837,40046,18415
34358,Colombes,92025,92,6649,23340,10400,23384,19039,52823,29989
34359,Courbevoie,92026,92,7109,20671,12145,22296,21476,55917,27780
34360,Fontenay-aux-Roses,92032,92,2567,5785,2663,6710,4687,14060,8352
34361,Garches,92033,92,2133,4707,1594,5326,3494,10414,6840
34362,La Garenne-Colombes,92035,92,2377,7261,3900,8094,7181,19175,9638
34363,Gennevilliers,92036,92,3294,12100,5911,11362,9216,26489,15394
34364,Issy-les-Moulineaux,92040,92,5291,15772,10023,17740,17177,44940,21063
34365,Levallois-Perret,92044,92,5877,15512,10024,16927,16627,43578,21389
34366,Malakoff,92046,92,2729,7068,4540,8855,6950,20345,9797
34367,Marnes-la-Coquette,92047,92,185,493,139,538,268,945,678
34368,Meudon,92048,92,5516,11488,4872,13094,9755,27721,17004
34369,Montrouge,92049,92,4704,10236,8023,12726,12477,33226,14940
34370,Nanterre,92050,92,5679,25853,13240,24172,19931,57343,31532
34371,Neuilly-sur-Seine,92051,92,9347,14085,7203,19084,11309,37596,23432
34372,Le Plessis-Robinson,92060,92,2452,7626,3265,8052,7251,18568,10078
34373,Puteaux,92062,92,3551,10433,6827,11565,11819,30211,13984
34374,Rueil-Malmaison,92063,92,7903,21283,8685,23452,16877,49014,29186
34375,Saint-Cloud,92064,92,3751,7325,3176,8655,5840,17671,11076
34376,Sceaux,92071,92,2787,4781,2206,5738,3383,11327,7568
34377,Sèvres,92072,92,2432,5992,2479,6914,4784,14177,8424
34378,Suresnes,92073,92,3977,12532,6206,12585,12419,31210,16509
34379,Vanves,92075,92,2906,6265,3971,8006,6124,18101,9171
34380,Vaucresson,92076,92,1135,2262,703,3100,1398,5201,3397
34381,Ville-d'Avray,92077,92,1384,3215,947,3552,2186,6685,4599
34382,Villeneuve-la-Garenne,92078,92,1869,7590,3410,6583,5143,15136,9459
34383,Aubervilliers,93001,93,4662,22109,12676,19143,18955,50774,26771
34384,Aulnay-sous-Bois,93005,93,6779,24990,11038,22299,15690,49027,31769
34385,Bagnolet,93006,93,2514,9643,4701,10071,8186,22958,12157
34386,Le Blanc-Mesnil,93007,93,4142,16922,7233,14452,11022,32707,21064
34387,Bobigny,93008,93,3030,15537,7610,12620,10411,30641,18567
34388,Bondy,93010,93,3793,15829,7022,14073,11140,32235,19622
34389,Le Bourget,93013,93,1083,4337,2361,3729,3830,9920,5420
34390,Clichy-sous-Bois,93014,93,1444,11268,4170,6744,6071,16985,12712
34391,Coubron,93015,93,460,1187,518,1438,892,2848,1647
34392,La Courneuve,93027,93,2394,12341,6494,10130,8807,25431,14735
34393,Drancy,93029,93,5897,19281,9915,18635,14268,42818,25178
34394,Dugny,93030,93,602,3440,1550,2454,2279,6283,4042
34395,Épinay-sur-Seine,93031,93,3785,16959,8741,13848,11354,33943,20744
34396,Gagny,93032,93,3787,11081,4573,11204,8038,23815,14868
34397,Gournay-sur-Marne,93033,93,684,1589,938,2401,1119,4458,2273
34398,L'Île-Saint-Denis,93039,93,453,2201,1003,1870,1636,4509,2654
34399,Les Lilas,93045,93,2317,5622,2712,6405,5528,14645,7939
34400,Livry-Gargan,93046,93,4244,11484,5692,12313,9352,27357,15728
34401,Montfermeil,93047,93,2061,7706,3156,7183,5001,15340,9767
34402,Montreuil,93048,93,8109,27067,13501,27715,24916,66132,35176
34403,Neuilly-Plaisance,93049,93,1591,5452,2769,6195,4583,13547,7043
34404,Neuilly-sur-Marne,93050,93,2166,10013,4624,9545,7724,21893,12179
34405,Noisy-le-Grand,93051,93,4689,17273,9612,18205,14127,41944,21962
34406,Noisy-le-Sec,93053,93,2886,12802,5406,11037,9489,25932,15688
34407,Pantin,93055,93,3893,14301,7765,14457,13624,35846,18194
34408,Les Pavillons-sous-Bois,93057,93,1837,6351,3430,5935,5253,14618,8188
34409,Pierrefitte-sur-Seine,93059,93,1746,9494,4107,7218,5895,17220,11240
34410,Le Pré-Saint-Gervais,93061,93,1111,4322,2128,4954,4666,11748,5433
34411,Le Raincy,93062,93,1635,3409,1945,4468,2824,9237,5044
34412,Romainville,93063,93,2201,7009,2982,7442,5478,15902,9210
34413,Rosny-sous-Bois,93064,93,3667,12106,5934,11679,9985,27598,15773
34414,Saint-Denis,93066,93,6152,32476,16657,25474,26831,68962,38628
34415,Saint-Ouen,93070,93,2970,11760,7984,11724,12274,31982,14730
34416,Sevran,93071,93,3124,15845,6823,12901,9915,29639,18969
34417,Stains,93072,93,2277,12291,5360,9596,7863,22819,14568
34418,Tremblay-en-France,93073,93,2814,10069,4318,10311,6706,21335,12883
34419,Vaujours,93074,93,505,1785,1021,1683,1576,4280,2290
34420,Villemomble,93077,93,2806,7695,3933,8107,6277,18317,10501
34421,Villepinte,93078,93,2025,11016,4929,9447,7059,21435,13041
34422,Villetaneuse,93079,93,768,4104,1818,3104,2573,7495,4872
34423,Ablon-sur-Seine,94001,94,556,1441,758,1340,1252,3350,1997
34424,Alfortville,94002,94,3875,11427,6609,11393,11213,29215,15302
34425,Arcueil,94003,94,1802,5360,3043,5952,4539,13534,7162
34426,Boissy-Saint-Léger,94004,94,1029,4495,2255,4724,3056,10035,5524
34427,Bonneuil-sur-Marne,94011,94,1510,4961,2219,4603,3081,9903,6471
34428,Bry-sur-Marne,94015,94,1638,4207,1868,5221,3151,10240,5845
34429,Cachan,94016,94,2809,6998,4888,7472,5830,18190,9807
34430,Champigny-sur-Marne,94017,94,6643,21582,9350,21977,15735,47062,28225
34431,Charenton-le-Pont,94018,94,2975,7708,4177,8542,7209,19928,10683
34432,Chennevières-sur-Marne,94019,94,1790,4820,2247,5474,3588,11309,6610
34433,Chevilly-Larue,94021,94,1720,4906,2482,5630,3986,12098,6626
34434,Choisy-le-Roi,94022,94,3272,11847,6093,11241,10432,27766,15119
34435,Créteil,94028,94,7532,24919,13237,25095,18976,57308,32451
34436,Fontenay-sous-Bois,94033,94,4708,14034,6195,15609,11908,33712,18742
34437,Fresnes,94034,94,2294,6559,3118,6313,5472,14903,8853
34438,Gentilly,94037,94,1319,3852,2500,4607,3818,10925,5171
34439,L'Haÿ-les-Roses,94038,94,3755,7881,3466,9039,5854,18359,11636
34440,Ivry-sur-Seine,94041,94,4638,14038,9786,16156,13417,39359,18676
34441,Joinville-le-Pont,94042,94,2206,4245,1972,5716,3974,11662,6451
34442,Le Kremlin-Bicêtre,94043,94,1819,6060,4268,6720,6167,17155,7879
34443,Limeil-Brévannes,94044,94,1441,7244,3533,5841,5815,15189,8685
34444,Maisons-Alfort,94046,94,6245,12083,8318,15442,12007,35767,18328
34445,Mandres-les-Roses,94047,94,326,1141,391,1482,737,2610,1467
34446,Marolles-en-Brie,94048,94,253,1342,432,1872,837,3141,1595
34447,Nogent-sur-Marne,94052,94,3692,7190,3684,9456,6894,20034,10882
34448,Noiseau,94053,94,421,1163,556,1506,917,2979,1584
34449,Orly,94054,94,1917,6832,3022,5849,4772,13643,8749
34450,Ormesson-sur-Marne,94055,94,1302,2436,822,3584,1795,6201,3738
34451,Périgny,94056,94,244,705,250,766,539,1555,949
34452,Le Perreux-sur-Marne,94058,94,3913,7892,3863,10341,7295,21499,11805
34453,Le Plessis-Trévise,94059,94,2020,5021,2037,5707,4381,12125,7041
34454,La Queue-en-Brie,94060,94,737,3570,1287,3438,2688,7413,4307
34455,Rungis,94065,94,415,1355,660,2075,1000,3735,1770
34456,Saint-Mandé,94067,94,2567,5277,2780,6441,4853,14074,7844
34457,Saint-Maur-des-Fossés,94068,94,10130,17318,8866,23180,14781,46827,27448
34458,Saint-Maurice,94069,94,1134,3546,1910,4074,3438,9422,4680
34459,Santeny,94070,94,360,955,322,1249,636,2207,1315
34460,Sucy-en-Brie,94071,94,2811,6510,2808,8626,4698,16132,9321
34461,Thiais,94073,94,2788,6859,3716,8661,5796,18173,9647
34462,Valenton,94074,94,782,4122,1936,3538,2676,8150,4904
34463,Villecresnes,94075,94,1062,2367,1048,3318,1705,6071,3429
34464,Villejuif,94076,94,4957,14713,9069,15534,12106,36709,19670
34465,Villeneuve-le-Roi,94077,94,2079,5307,2706,5797,3878,12381,7386
34466,Villeneuve-Saint-Georges,94078,94,2166,9557,5081,8342,6715,20138,11723
34467,Villiers-sur-Marne,94079,94,2474,7334,3474,8222,5970,17666,9808
34468,Vincennes,94080,94,5641,10057,7346,13296,12385,33027,15698
34469,Vitry-sur-Seine,94081,94,7904,24874,12657,24915,19418,56990,32778
34470,Ableiges,95002,95,98,294,107,314,222,643,392
34471,Aincourt,95008,95,55,232,95,300,152,547,287
34472,Ambleville,95011,95,40,75,30,156,80,266,115
34473,Amenucourt,95012,95,20,45,17,50,39,106,65
34474,Andilly,95014,95,198,600,229,820,403,1452,798
34475,Argenteuil,95018,95,8009,31421,14955,28490,23878,67323,39430
34476,Arnouville,95019,95,1271,4145,1796,4098,2715,8609,5416
34477,Arronville,95023,95,35,170,99,251,135,485,205
34478,Arthies,95024,95,5,100,25,90,60,175,105
34479,Asnières-sur-Oise,95026,95,185,718,216,975,459,1650,903
34480,Attainville,95028,95,82,454,152,512,352,1016,536
34481,Auvers-sur-Oise,95039,95,754,1675,755,2476,1253,4484,2429
34482,Avernes,95040,95,85,205,45,310,155,510,290
34483,Baillet-en-France,95042,95,217,527,243,719,338,1300,744
34484,Banthelu,95046,95,0,65,15,40,45,100,65
34485,Beauchamp,95051,95,1240,1951,839,2826,1469,5134,3191
34486,Beaumont-sur-Oise,95052,95,690,2502,1547,2477,2123,6147,3192
34487,Le Bellay-en-Vexin,95054,95,10,80,20,85,40,145,90
34488,Bellefontaine,95055,95,24,118,33,111,91,235,142
34489,Belloy-en-France,95056,95,152,643,222,502,571,1295,795
34490,Bernes-sur-Oise,95058,95,206,684,265,795,452,1512,890
34491,Berville,95059,95,16,72,40,128,80,248,88
34492,Bessancourt,95060,95,649,1586,608,2293,1275,4176,2235
34493,Béthemont-la-Forêt,95061,95,32,92,44,156,100,300,124
34494,Bezons,95063,95,2244,7984,3429,8044,6232,17705,10228
34495,Boisemont,95074,95,65,190,80,325,110,515,255
34496,Boissy-l'Aillerie,95078,95,100,510,235,630,350,1215,610
34497,Bonneuil-en-France,95088,95,45,259,155,210,214,579,304
34498,Bouffémont,95091,95,457,1800,552,1854,1193,3599,2257
34499,Bouqueval,95094,95,15,90,35,119,60,214,105
34500,Bray-et-Lû,95101,95,44,292,84,248,204,536,336
34501,Bréançon,95102,95,26,71,16,146,85,247,97
34502,Brignancourt,95110,95,19,36,6,65,30,101,55
34503,Bruyères-sur-Oise,95116,95,195,1278,475,1160,929,2564,1473
34504,Buhy,95119,95,31,102,21,58,94,173,133
34505,Butry-sur-Oise,95120,95,135,707,211,699,425,1335,842
34506,Cergy,95127,95,2343,18655,12368,14329,14319,41016,20998
34507,Champagne-sur-Oise,95134,95,380,1341,529,1548,920,2997,1721
34508,La Chapelle-en-Vexin,95139,95,15,100,20,105,70,195,115
34509,Charmont,95141,95,0,4,12,4,4,20,4
34510,Chars,95142,95,144,584,278,528,470,1276,728
34511,Châtenay-en-France,95144,95,0,25,9,18,21,48,25
34512,Chaumontel,95149,95,273,842,299,1263,611,2173,1115
34513,Chaussy,95150,95,40,170,40,200,136,376,210
34514,Chauvry,95151,95,32,84,4,76,88,168,116
34515,Chennevières-lès-Louvres,95154,95,3,91,39,56,74,169,94
34516,Chérence,95157,95,16,23,3,68,15,86,39
34517,Cléry-en-Vexin,95166,95,20,125,50,115,100,265,145
34518,Commeny,95169,95,20,119,48,145,85,278,139
34519,Condécourt,95170,95,56,120,88,196,112,396,176
34520,Cormeilles-en-Parisis,95176,95,1908,6279,2745,6995,5157,14897,8187
34521,Cormeilles-en-Vexin,95177,95,72,391,102,349,280,731,463
34522,Courcelles-sur-Viosne,95181,95,35,80,10,70,85,165,115
34523,Courdimanche,95183,95,184,2056,924,1908,1522,4354,2240
34524,Deuil-la-Barre,95197,95,2082,5540,2887,6563,4750,14200,7622
34525,Domont,95199,95,1414,4084,1861,4566,3055,9482,5498
34526,Eaubonne,95203,95,2952,6222,2728,7107,4745,14580,9174
34527,Écouen,95205,95,491,2071,986,2079,1567,4632,2562
34528,Enghien-les-Bains,95210,95,1737,2372,1426,3358,2133,6917,4109
34529,Ennery,95211,95,211,490,275,754,384,1413,701
34530,Épiais-lès-Louvres,95212,95,8,24,16,28,36,80,32
34531,Épiais-Rhus,95213,95,40,145,25,290,115,430,185
34532,Épinay-Champlâtreux,95214,95,5,15,5,25,10,40,20
34533,Éragny,95218,95,1064,4860,1965,4780,3564,10309,5924
34534,Ermont,95219,95,2968,7480,3680,8387,5902,17969,10448
34535,Ézanville,95229,95,897,2605,1174,2883,1853,5910,3502
34536,Fontenay-en-Parisis,95241,95,100,484,205,615,363,1183,584
34537,Fosses,95250,95,810,2765,1111,2892,1913,5916,3575
34538,Franconville,95252,95,2838,8968,4696,9421,7637,21754,11806
34539,Frémainville,95253,95,35,105,55,180,80,315,140
34540,Frémécourt,95254,95,20,116,72,207,75,354,136
34541,Frépillon,95256,95,241,941,287,900,677,1864,1182
34542,La Frette-sur-Seine,95257,95,511,1169,443,1656,741,2840,1680
34543,Frouville,95258,95,45,80,39,125,75,239,125
34544,Gadancourt,95259,95,9,16,3,31,3,37,25
34545,Garges-lès-Gonesse,95268,95,2338,14372,5854,10178,8716,24748,16710
34546,Genainville,95270,95,85,145,45,205,90,340,230
34547,Génicourt,95271,95,50,95,28,199,75,302,145
34548,Gonesse,95277,95,1731,7824,3745,6735,5174,15654,9555
34549,Goussainville,95280,95,1948,10349,4204,8454,6360,19018,12297
34550,Gouzangrez,95282,95,20,40,5,70,30,105,60
34551,Grisy-les-Plâtres,95287,95,38,123,74,257,104,435,161
34552,Groslay,95288,95,700,2400,1040,2415,1680,5135,3100
34553,Guiry-en-Vexin,95295,95,16,28,24,72,32,128,44
34554,Haravilliers,95298,95,20,140,75,210,95,380,160
34555,Haute-Isle,95301,95,38,58,12,96,41,149,96
34556,Le Heaulme,95303,95,20,24,40,84,24,148,44
34557,Hédouville,95304,95,22,39,20,108,38,166,61
34558,Herblay,95306,95,2247,7734,3097,7995,5741,16833,9981
34559,Hérouville,95308,95,35,180,45,245,105,395,215
34560,Hodent,95309,95,30,75,25,75,25,125,105
34561,L'Isle-Adam,95313,95,1614,2611,1424,3942,1994,7360,4225
34562,Jagny-sous-Bois,95316,95,35,72,12,65,53,130,107
34563,Jouy-le-Moutier,95323,95,547,4802,1918,5046,3402,10366,5349
34564,Labbeville,95328,95,60,173,83,143,157,383,233
34565,Lassy,95331,95,5,45,30,60,20,110,50
34566,Livilliers,95341,95,25,70,60,135,50,245,95
34567,Longuesse,95348,95,42,99,67,217,66,350,141
34568,Louvres,95351,95,755,2932,1337,2828,2037,6202,3687
34569,Luzarches,95352,95,406,1123,482,1402,835,2719,1529
34570,Maffliers,95353,95,45,544,215,478,449,1142,589
34571,Magny-en-Vexin,95355,95,485,1476,724,1752,1029,3505,1961
34572,Mareil-en-France,95365,95,80,210,79,179,165,423,290
34573,Margency,95369,95,222,639,357,1047,522,1926,861
34574,Marines,95370,95,208,964,384,952,768,2104,1172
34575,Marly-la-Ville,95371,95,366,1506,658,1852,1117,3627,1872
34576,Maudétour-en-Vexin,95379,95,20,45,20,75,40,135,65
34577,Menouville,95387,95,6,12,12,48,0,60,18
34578,Menucourt,95388,95,410,1469,549,1576,1130,3255,1879
34579,Mériel,95392,95,415,1266,514,1678,943,3135,1681
34580,Méry-sur-Oise,95394,95,605,2657,1174,2823,1877,5874,3262
34581,Le Mesnil-Aubry,95395,95,40,230,130,345,190,665,270
34582,Moisselles,95409,95,61,394,203,316,352,871,455
34583,Montgeroult,95422,95,52,92,36,144,64,244,144
34584,Montigny-lès-Cormeilles,95424,95,1169,6651,2706,5376,4539,12621,7820
34585,Montlignon,95426,95,264,748,264,892,480,1636,1012
34586,Montmagny,95427,95,723,4152,1906,3984,2661,8551,4875
34587,Montmorency,95428,95,2270,5059,2255,6357,4035,12647,7329
34588,Montreuil-sur-Epte,95429,95,65,100,40,145,55,240,165
34589,Montsoult,95430,95,355,864,360,1220,587,2167,1219
34590,Mours,95436,95,105,333,134,540,294,968,438
34591,Moussy,95438,95,5,50,15,30,30,75,55
34592,Nerville-la-Forêt,95445,95,70,135,35,250,130,415,205
34593,Nesles-la-Vallée,95446,95,110,449,178,613,353,1144,559
34594,Neuilly-en-Vexin,95447,95,19,32,3,68,30,101,51
34595,Neuville-sur-Oise,95450,95,100,408,489,626,298,1413,508
34596,Nointel,95452,95,79,173,63,334,148,545,252
34597,Noisy-sur-Oise,95456,95,28,177,57,237,121,415,205
34598,Nucourt,95459,95,65,185,70,260,145,475,250
34599,Omerville,95462,95,18,80,21,86,42,149,98
34600,Osny,95476,95,1332,4552,1866,4842,3054,9762,5884
34601,Parmain,95480,95,418,1580,556,1773,1113,3442,1998
34602,Le Perchay,95483,95,28,156,68,188,116,372,184
34603,Persan,95487,95,786,3824,1593,3075,2679,7347,4610
34604,Pierrelaye,95488,95,674,1991,1016,2376,1416,4808,2665
34605,Piscop,95489,95,33,164,105,218,129,452,197
34606,Le Plessis-Bouchard,95491,95,860,2083,766,2417,1754,4937,2943
34607,Le Plessis-Gassot,95492,95,0,9,0,26,20,46,9
34608,Le Plessis-Luzarches,95493,95,8,28,32,52,24,108,36
34609,Pontoise,95500,95,2224,7738,4756,7823,6173,18752,9962
34610,Presles,95504,95,362,805,318,1465,622,2405,1167
34611,Puiseux-en-France,95509,95,270,983,290,1032,684,2006,1253
34612,Puiseux-Pontoise,95510,95,10,118,37,115,73,225,128
34613,La Roche-Guyon,95523,95,30,58,38,143,52,233,88
34614,Roissy-en-France,95527,95,105,597,531,859,643,2033,702
34615,Ronquerolles,95529,95,47,186,113,299,147,559,233
34616,Sagy,95535,95,135,291,85,385,201,671,426
34617,Saint-Brice-sous-Forêt,95539,95,1059,4586,1782,3981,3131,8894,5645
34618,Saint-Clair-sur-Epte,95541,95,24,357,72,212,208,492,381
34619,Saint-Cyr-en-Arthies,95543,95,20,72,4,96,40,140,92
34620,Saint-Gervais,95554,95,109,237,75,345,182,602,346
34621,Saint-Gratien,95555,95,2365,5345,2443,6273,4276,12992,7710
34622,Saint-Leu-la-Forêt,95563,95,1582,3691,1718,5025,2752,9495,5273
34623,Saint-Martin-du-Tertre,95566,95,177,756,254,707,543,1504,933
34624,Saint-Ouen-l'Aumône,95572,95,1474,6720,3576,6215,5429,15220,8194
34625,Saint-Prix,95574,95,835,1710,720,2560,1100,4380,2545
34626,Saint-Witz,95580,95,103,739,216,949,431,1596,842
34627,Sannois,95582,95,2252,7310,3286,7790,5644,16720,9562
34628,Santeuil,95584,95,52,148,68,232,152,452,200
34629,Sarcelles,95585,95,3910,18850,8368,14472,10552,33392,22760
34630,Seraincourt,95592,95,105,290,163,511,215,889,395
34631,Seugy,95594,95,80,215,115,410,175,700,295
34632,Soisy-sous-Montmorency,95598,95,2146,4596,2089,5570,3556,11215,6742
34633,Survilliers,95604,95,220,1170,535,1069,1062,2666,1390
34634,Taverny,95607,95,2499,6954,2893,7430,5528,15851,9453
34635,Théméricourt,95610,95,40,68,20,88,56,164,108
34636,Theuville,95611,95,0,9,0,15,3,18,9
34637,Le Thillay,95612,95,333,1135,591,1219,802,2612,1468
34638,Us,95625,95,124,325,110,519,225,854,449
34639,Vallangoujard,95627,95,8,212,48,236,144,428,220
34640,Valmondois,95628,95,110,254,90,432,221,743,364
34641,Vaudherland,95633,95,8,24,24,4,12,40,32
34642,Vauréal,95637,95,356,4762,2412,4978,3246,10636,5118
34643,Vémars,95641,95,163,572,280,679,596,1555,735
34644,Vétheuil,95651,95,170,180,84,249,150,483,350
34645,Viarmes,95652,95,600,1226,530,1730,984,3244,1826
34646,Vienne-en-Arthies,95656,95,45,120,10,185,70,265,165
34647,Vigny,95658,95,105,328,68,319,223,610,433
34648,Villaines-sous-Bois,95660,95,44,164,60,276,148,484,208
34649,Villeron,95675,95,25,195,125,263,155,543,220
34650,Villers-en-Arthies,95676,95,45,155,25,149,120,294,200
34651,Villiers-Adam,95678,95,119,197,68,260,160,488,316
34652,Villiers-le-Bel,95680,95,1640,8982,3851,6642,5787,16280,10622
34653,Villiers-le-Sec,95682,95,10,64,13,70,49,132,74
34654,Wy-dit-Joli-Village,95690,95,29,52,38,108,67,213,81
34655,Montreuil,28267,28,27,3,0,35,6,41,30
34656,Morainville,28268,28,4,4,0,8,8,16,8
34657,Morancez,28269,28,205,395,126,648,252,1026,600
34658,Moriers,28270,28,4,45,21,50,62,133,49
34659,Morvilliers,28271,28,20,45,25,35,25,85,65
34660,Mottereau,28272,28,5,47,0,59,54,113,52
34661,Moulhard,28273,28,16,23,27,38,29,94,39
34662,Moutiers,28274,28,12,76,24,68,76,168,88
34663,Néron,28275,28,40,180,45,255,120,420,220
34664,Neuvy-en-Beauce,28276,28,30,80,10,73,40,123,110
34665,Neuvy-en-Dunois,28277,28,60,65,25,130,25,180,125
34666,Nogent-le-Phaye,28278,28,131,302,115,408,204,727,433
34667,Nogent-le-Roi,28279,28,462,1042,363,1232,874,2469,1504
34668,Nogent-le-Rotrou,28280,28,1972,1958,926,3284,1431,5641,3930
34669,Nogent-sur-Eure,28281,28,60,135,15,180,100,295,195
34670,Nonvilliers-Grandhoux,28282,28,76,100,44,112,108,264,176
34671,Nottonville,28283,28,30,90,15,115,75,205,120
34672,Oinville-Saint-Liphard,28284,28,24,38,34,104,29,167,62
34673,Oinville-sous-Auneau,28285,28,19,87,19,94,80,193,106
34674,Ollé,28286,28,20,161,45,189,152,386,181
34675,Orgères-en-Beauce,28287,28,123,267,88,286,167,541,390
34676,Ormoy,28289,28,0,55,45,78,55,178,55
34677,Orrouer,28290,28,5,110,0,95,110,205,115
34678,Ouarville,28291,28,64,128,41,159,68,268,192
34679,Ouerre,28292,28,49,192,38,248,143,429,241
34680,Oulins,28293,28,60,340,134,358,265,757,400
34681,Oysonville,28294,28,42,115,25,172,94,291,157
34682,Ozoir-le-Breuil,28295,28,55,130,15,115,110,240,185
34683,Péronville,28296,28,25,46,26,114,28,168,71
34684,Pierres,28298,28,435,645,210,1030,465,1705,1080
34685,Les Pinthières,28299,28,15,40,20,45,35,100,55
34686,Poinville,28300,28,4,40,8,44,26,78,44
34687,Poisvilliers,28301,28,5,160,45,110,125,280,165
34688,Pontgouin,28302,28,120,260,99,303,229,631,380
34689,Poupry,28303,28,25,31,0,35,17,52,56
34690,Prasville,28304,28,35,134,40,125,91,256,169
34691,Pré-Saint-Évroult,28305,28,26,57,30,82,58,170,83
34692,Pré-Saint-Martin,28306,28,24,34,4,54,38,96,58
34693,Prudemanche,28308,28,8,61,4,63,62,129,69
34694,Prunay-le-Gillon,28309,28,85,260,119,355,247,721,345
34695,La Puisaye,28310,28,36,84,24,112,44,180,120
34696,Le Puiset,28311,28,38,103,30,139,77,246,141
34697,Puiseux,28312,28,12,42,12,49,32,93,54
34698,Réclainville,28313,28,10,60,15,80,35,130,70
34699,Les Ressuintes,28314,28,5,66,5,50,20,75,71
34700,Revercourt,28315,28,0,6,0,3,9,12,6
34701,Rohaire,28316,28,20,40,10,55,30,95,60
34702,Roinville,28317,28,24,142,58,151,106,315,166
34703,Romilly-sur-Aigre,28318,28,80,110,30,150,70,250,190
34704,Rouvray-Saint-Denis,28319,28,25,125,45,130,100,275,150
34705,Rouvres,28321,28,63,197,56,255,169,480,260
34706,Rueil-la-Gadelière,28322,28,40,139,30,167,127,324,179
34707,Saint-Ange-et-Torçay,28323,28,13,75,16,80,63,159,88
34708,Saint-Arnoult-des-Bois,28324,28,64,265,44,258,199,501,329
34709,Saint-Aubin-des-Bois,28325,28,81,251,58,347,161,566,332
34710,Saint-Avit-les-Guespières,28326,28,52,109,12,108,100,220,161
34711,Saint-Bomer,28327,28,10,60,15,65,50,130,70
34712,Saint-Christophe,28329,28,8,36,12,92,8,112,44
34713,Saint-Cloud-en-Dunois,28330,28,20,95,15,90,35,140,115
34714,Saint-Denis-d'Authou,28331,28,76,120,24,188,80,292,196
34715,Sainte-Gemme-Moronval,28332,28,85,350,70,392,185,647,435
34716,Saint-Denis-des-Puits,28333,28,20,35,20,55,15,90,55
34717,Saint-Denis-les-Ponts,28334,28,317,306,117,597,284,998,623
34718,Saint-Éliph,28335,28,100,254,64,345,174,583,354
34719,Saint-Éman,28336,28,10,20,15,50,10,75,30
34720,Saint-Georges-sur-Eure,28337,28,269,529,192,1032,427,1651,798
34721,Saint-Germain-le-Gaillard,28339,28,18,100,50,115,65,230,118
34722,Saint-Hilaire-sur-Yerre,28340,28,82,120,60,204,80,344,202
34723,Saint-Jean-de-Rebervilliers,28341,28,28,72,28,72,36,136,100
34724,Saint-Jean-Pierre-Fixte,28342,28,40,40,0,130,45,175,80
34725,Saint-Laurent-la-Gâtine,28343,28,40,100,32,188,96,316,140
34726,Saint-Léger-des-Aubées,28344,28,16,44,36,116,48,200,60
34727,Saint-Lubin-de-Cravant,28346,28,0,23,0,18,17,35,23
34728,Saint-Lubin-de-la-Haye,28347,28,56,276,45,354,191,590,332
34729,Saint-Lubin-des-Joncherets,28348,28,476,1105,280,1276,732,2288,1581
34730,Saint-Lucien,28349,28,42,40,17,69,50,136,82
34731,Saint-Luperce,28350,28,93,203,58,328,124,510,296
34732,Saint-Maixme-Hauterive,28351,28,37,110,33,130,75,238,147
34733,Saint-Martin-de-Nigelles,28352,28,94,431,75,520,373,968,525
34734,Saint-Maur-sur-le-Loir,28353,28,36,120,32,168,72,272,156
34735,Saint-Maurice-Saint-Germain,28354,28,39,90,40,78,64,182,129
34736,Saint-Ouen-Marchefroy,28355,28,34,65,3,94,55,152,99
34737,Saint-Pellerin,28356,28,55,48,28,100,60,188,103
34738,Saint-Piat,28357,28,155,215,50,439,184,673,370
34739,Saint-Prest,28358,28,280,465,95,880,285,1260,745
34740,Saint-Rémy-sur-Avre,28359,28,311,1131,343,1168,807,2318,1442
34741,Saint-Sauveur-Marville,28360,28,65,235,110,310,160,580,300
34742,Saint-Victor-de-Buthon,28362,28,85,124,25,151,79,255,209
34743,Sainville,28363,28,104,301,80,288,217,585,405
34744,Sancheville,28364,28,132,204,48,260,176,484,336
34745,Sandarville,28365,28,28,105,40,133,76,249,133
34746,Santeuil,28366,28,12,111,18,84,77,179,123
34747,Santilly,28367,28,55,70,35,95,85,215,125
34748,La Saucelle,28368,28,12,60,8,88,32,128,72
34749,Saulnières,28369,28,48,214,44,180,156,380,262
34750,Saumeray,28370,28,46,84,34,151,101,286,130
34751,Saussay,28371,28,96,308,64,376,212,652,404
34752,Senantes,28372,28,75,121,25,270,80,375,196
34753,Senonches,28373,28,640,635,195,1025,420,1640,1275
34754,Serazereux,28374,28,20,181,52,168,148,368,201
34755,Serville,28375,28,8,61,52,147,45,244,69
34756,Soizé,28376,28,5,80,40,110,70,220,85
34757,Sorel-Moussel,28377,28,186,427,99,608,342,1049,613
34758,Souancé-au-Perche,28378,28,80,105,60,170,105,335,185
34759,Soulaires,28379,28,56,104,24,156,88,268,160
34760,Sours,28380,28,117,494,195,618,384,1197,611
34761,Terminiers,28382,28,108,244,89,236,176,501,352
34762,Theuville,28383,28,59,200,55,215,144,414,259
34763,Le Thieulin,28385,28,20,134,39,122,97,258,154
34764,Thimert-Gâtelles,28386,28,120,384,136,312,296,744,504
34765,Thiron-Gardais,28387,28,166,238,63,288,151,502,404
34766,Thivars,28388,28,220,228,54,298,265,617,448
34767,Thiville,28389,28,35,85,25,145,60,230,120
34768,Tillay-le-Péneux,28390,28,29,93,15,109,54,178,122
34769,Toury,28391,28,376,687,312,760,484,1556,1063
34770,Trancrainville,28392,28,15,45,5,75,30,110,60
34771,Tremblay-les-Villages,28393,28,198,712,165,623,588,1376,910
34772,Tréon,28394,28,70,375,100,575,255,930,445
34773,Trizay-Coutretot-Saint-Serge,28395,28,30,90,30,209,95,334,120
34774,Trizay-lès-Bonneval,28396,28,36,92,32,104,72,208,128
34775,Umpeau,28397,28,48,115,20,135,85,240,163
34776,Unverre,28398,28,166,304,90,418,227,735,470
34777,Varize,28400,28,26,59,3,35,50,88,85
34778,Vaupillon,28401,28,58,106,16,118,89,223,164
34779,Ver-lès-Chartres,28403,28,80,190,55,315,140,510,270
34780,Vernouillet,28404,28,1383,3634,1347,3421,2250,7018,5017
34781,Vert-en-Drouais,28405,28,115,277,90,443,192,725,392
34782,Eole-en-Beauce,28406,28,120,266,64,333,192,589,386
34783,Vichères,28407,28,28,92,12,128,64,204,120
34784,Vierville,28408,28,0,39,29,34,20,83,39
34785,Vieuvicq,28409,28,33,128,17,150,84,251,161
34786,Villampuy,28410,28,32,84,20,96,92,208,116
34787,Villars,28411,28,8,58,23,30,34,87,66
34788,Villeau,28412,28,8,68,16,40,68,124,76
34789,Villebon,28414,28,4,13,8,25,8,41,17
34790,Villemeux-sur-Eure,28415,28,223,462,115,500,310,925,685
34791,Villiers-le-Morhier,28417,28,150,370,80,510,220,810,520
34792,Villiers-Saint-Orien,28418,28,29,26,12,61,12,85,55
34793,Vitray-en-Beauce,28419,28,40,120,40,95,55,190,160
34794,Voise,28421,28,15,75,60,85,55,200,90
34795,Les Villages Vovéens,28422,28,475,999,457,1106,761,2324,1474
34796,Yermenonville,28423,28,44,135,33,196,116,345,179
34797,Yèvres,28424,28,354,357,95,632,236,963,711
34798,Ymeray,28425,28,39,160,65,240,125,430,199
34799,Ymonville,28426,28,64,112,44,180,104,328,176
34800,Argol,29001,29,121,230,118,328,204,650,351
34801,Arzano,29002,29,155,240,120,610,190,920,395
34802,Audierne,29003,29,983,502,208,1399,420,2027,1485
34803,Bannalec,29004,29,787,1364,430,1822,1094,3346,2151
34804,Baye,29005,29,110,266,38,413,235,686,376
34805,Bénodet,29006,29,800,535,135,1367,492,1994,1335
34806,Berrien,29007,29,168,200,108,328,164,600,368
34807,Beuzec-Cap-Sizun,29008,29,140,190,75,407,175,657,330
34808,Bodilis,29010,29,136,388,156,392,328,876,524
34809,Bohars,29011,29,329,781,236,1223,492,1951,1110
34810,Bolazec,29012,29,36,26,26,57,25,108,62
34811,Botmeur,29013,29,55,40,15,40,50,105,95
34812,Botsorhel,29014,29,60,100,35,175,55,265,160
34813,Bourg-Blanc,29015,29,255,994,262,979,745,1986,1249
34814,Brasparts,29016,29,172,244,84,368,172,624,416
34815,Brélès,29017,29,40,220,98,319,200,617,260
34816,Brennilis,29018,29,81,80,35,125,70,230,161
34817,Brest,29019,29,15082,30107,26610,36457,25960,89027,45189
34818,Briec,29020,29,525,1514,480,1588,1252,3320,2039
34819,Brignogan-Plages,29021,29,201,80,25,324,51,400,281
34820,Camaret-sur-Mer,29022,29,578,394,139,1049,359,1547,972
34821,Carantec,29023,29,775,510,165,1270,385,1820,1285
34822,Carhaix-Plouguer,29024,29,1482,1260,619,2434,996,4049,2742
34823,Cast,29025,29,254,461,116,444,367,927,715
34824,Châteaulin,29026,29,645,1197,444,1665,912,3021,1842
34825,Châteauneuf-du-Faou,29027,29,670,830,255,1340,480,2075,1500
34826,Cléden-Cap-Sizun,29028,29,233,150,30,373,130,533,383
34827,Cléden-Poher,29029,29,167,242,56,380,193,629,409
34828,Cléder,29030,29,555,868,235,1346,706,2287,1423
34829,Clohars-Carnoët,29031,29,850,806,273,1517,698,2488,1656
34830,Clohars-Fouesnant,29032,29,317,518,163,702,315,1180,835
34831,Le Cloître-Pleyben,29033,29,145,110,80,170,45,295,255
34832,Le Cloître-Saint-Thégonnec,29034,29,50,200,45,230,125,400,250
34833,Coat-Méal,29035,29,47,336,124,311,213,648,383
34834,Collorec,29036,29,116,100,50,245,105,400,216
34835,Combrit,29037,29,580,819,223,1498,659,2380,1399
34836,Commana,29038,29,139,265,75,359,234,668,404
34837,Concarneau,29039,29,3520,3717,1334,7147,2978,11459,7237
34838,Le Conquet,29040,29,440,515,105,1080,415,1600,955
34839,Coray,29041,29,284,436,140,552,416,1108,720
34840,Crozon,29042,29,1371,1400,607,2801,1088,4496,2771
34841,Daoulas,29043,29,266,427,135,479,334,948,693
34842,Dinéault,29044,29,190,330,110,505,230,845,520
34843,Dirinon,29045,29,226,616,128,758,497,1383,842
34844,Douarnenez,29046,29,2813,2585,1167,5195,2235,8597,5398
34845,Le Drennec,29047,29,200,558,140,452,438,1030,758
34846,Edern,29048,29,200,620,210,780,405,1395,820
34847,Elliant,29049,29,385,807,227,897,752,1876,1192
34848,Ergué-Gabéric,29051,29,783,1925,494,3025,1486,5005,2708
34849,Le Faou,29053,29,250,405,180,520,295,995,655
34850,La Feuillée,29054,29,63,116,54,272,66,392,179
34851,Le Folgoët,29055,29,426,705,239,1189,502,1930,1131
34852,La Forest-Landerneau,29056,29,142,512,44,574,458,1076,654
34853,La Forêt-Fouesnant,29057,29,521,631,188,1389,490,2067,1152
34854,Fouesnant,29058,29,1825,1740,738,3677,1274,5689,3565
34855,Garlan,29059,29,120,310,105,225,260,590,430
34856,Gouesnach,29060,29,333,685,185,956,561,1702,1018
34857,Gouesnou,29061,29,556,1490,426,2278,984,3688,2046
34858,Gouézec,29062,29,125,240,120,440,185,745,365
34859,Goulien,29063,29,107,81,9,82,88,179,188
34860,Goulven,29064,29,76,84,36,176,64,276,160
34861,Gourlizon,29065,29,70,225,85,370,145,600,295
34862,Guengat,29066,29,170,445,155,575,385,1115,615
34863,Guerlesquin,29067,29,205,305,100,455,209,764,510
34864,Guiclan,29068,29,232,662,236,652,598,1486,894
34865,Guilers,29069,29,1045,2010,625,2680,1230,4535,3055
34866,Guiler-sur-Goyen,29070,29,68,148,64,152,112,328,216
34867,Guilligomarc'h,29071,29,89,204,32,238,117,387,293
34868,Guilvinec,29072,29,872,415,160,1014,298,1472,1287
34869,Guimaëc,29073,29,196,180,64,369,132,565,376
34870,Guimiliau,29074,29,70,320,80,350,195,625,390
34871,Guipavas,29075,29,1608,3658,1171,4750,2530,8451,5266
34872,Guipronvel,29076,29,50,220,50,281,174,505,270
34873,Guissény,29077,29,415,475,65,695,330,1090,890
34874,Hanvec,29078,29,224,537,88,645,429,1162,761
34875,Henvic,29079,29,206,309,62,441,225,728,515
34876,Hôpital-Camfrout,29080,29,270,635,90,720,480,1290,905
34877,Huelgoat,29081,29,358,205,56,542,144,742,563
34878,Île-de-Batz,29082,29,125,75,25,205,30,260,200
34879,Île-de-Sein,29083,29,90,35,0,95,25,120,125
34880,Île-Molène,29084,29,5,20,5,95,25,125,25
34881,Île-Tudy,29085,29,162,86,73,238,105,416,248
34882,Irvillac,29086,29,145,447,105,408,306,819,592
34883,Le Juch,29087,29,76,200,24,280,156,460,276
34884,Kergloff,29089,29,106,229,67,314,159,540,335
34885,Kerlaz,29090,29,104,188,68,320,164,552,292
34886,Kerlouan,29091,29,432,400,126,825,411,1362,832
34887,Kernilis,29093,29,140,462,160,345,343,848,602
34888,Kernouës,29094,29,84,208,68,236,132,436,292
34889,Kersaint-Plabennec,29095,29,76,436,140,356,340,836,512
34890,Lampaul-Guimiliau,29097,29,253,520,145,755,410,1310,773
34891,Lampaul-Plouarzel,29098,29,369,522,79,733,440,1252,891
34892,Lampaul-Ploudalmézeau,29099,29,75,275,45,234,204,483,350
34893,Lanarvily,29100,29,40,155,65,90,105,260,195
34894,Landéda,29101,29,566,828,220,1327,497,2044,1394
34895,Landeleau,29102,29,160,205,80,375,115,570,365
34896,Landerneau,29103,29,1926,3609,1723,4556,2889,9168,5535
34897,Landévennec,29104,29,50,70,25,155,40,220,120
34898,Landivisiau,29105,29,1070,2269,979,2581,1801,5361,3339
34899,Landrévarzec,29106,29,134,560,145,592,395,1132,694
34900,Landudal,29107,29,125,225,70,259,185,514,350
34901,Landudec,29108,29,138,328,117,398,265,780,466
34902,Landunvez,29109,29,216,272,112,649,216,977,488
34903,Langolen,29110,29,85,240,55,280,220,555,325
34904,Lanhouarneau,29111,29,158,387,172,258,309,739,545
34905,Lanildut,29112,29,148,199,32,362,140,534,347
34906,Lanmeur,29113,29,345,440,125,639,359,1123,785
34907,Lannéanou,29114,29,45,75,15,150,100,265,120
34908,Lannédern,29115,29,40,55,25,105,40,170,95
34909,Lanneuffret,29116,29,15,20,35,45,30,110,35
34910,Lannilis,29117,29,607,1539,463,1541,1086,3090,2146
34911,Lanrivoaré,29119,29,118,390,84,547,240,871,508
34912,Lanvéoc,29120,29,255,469,110,611,364,1085,724
34913,Laz,29122,29,75,155,65,250,110,425,230
34914,Lennon,29123,29,92,244,80,180,225,485,336
34915,Lesneven,29124,29,900,1715,709,2077,1248,4034,2615
34916,Leuhan,29125,29,120,152,68,264,168,500,272
34917,Loc-Brévalaire,29126,29,15,45,10,62,26,98,60
34918,Loc-Eguiner,29128,29,29,99,34,103,74,211,128
34919,Locmaria-Berrien,29129,29,33,38,9,80,44,133,71
34920,Locmaria-Plouzané,29130,29,430,1388,358,1735,937,3030,1818
34921,Locmélar,29131,29,55,130,40,133,105,278,185
34922,Locquénolé,29132,29,110,150,60,330,125,515,260
34923,Locquirec,29133,29,296,232,72,564,200,836,528
34924,Locronan,29134,29,108,204,32,348,132,512,312
34925,Loctudy,29135,29,884,704,160,1592,526,2278,1588
34926,Locunolé,29136,29,94,315,95,384,247,726,409
34927,Logonna-Daoulas,29137,29,224,536,136,756,444,1336,760
34928,Lopérec,29139,29,88,176,72,292,136,500,264
34929,Loperhet,29140,29,340,1010,175,1222,719,2116,1350
34930,Loqueffret,29141,29,80,66,20,110,70,200,146
34931,Lothey,29142,29,60,100,68,152,76,296,160
34932,Mahalon,29143,29,114,214,90,315,218,623,328
34933,La Martyre,29144,29,49,243,73,193,152,418,292
34934,Confort-Meilars,29145,29,110,235,35,294,200,529,345
34935,Melgven,29146,29,534,792,203,1155,675,2033,1326
34936,Mellac,29147,29,286,739,245,1015,613,1873,1025
34937,Mespaul,29148,29,99,269,57,211,235,503,368
34938,Milizac,29149,29,284,1018,341,1097,710,2148,1302
34939,Moëlan-sur-Mer,29150,29,1479,1209,416,2846,844,4106,2688
34940,Morlaix,29151,29,1848,3064,1702,4788,2533,9023,4912
34941,Motreff,29152,29,96,144,50,249,96,395,240
34942,Névez,29153,29,689,420,145,1087,305,1537,1109
34943,Ouessant,29155,29,220,95,70,340,90,500,315
34944,Pencran,29156,29,95,605,135,580,411,1126,700
34945,Penmarch,29158,29,1129,901,399,2204,711,3314,2030
34946,Peumerit,29159,29,110,185,35,275,170,480,295
34947,Plabennec,29160,29,852,2339,646,2542,1591,4779,3191
34948,Pleuven,29161,29,367,594,165,1064,513,1742,961
34949,Pleyben,29162,29,459,995,250,1224,657,2131,1454
34950,Pleyber-Christ,29163,29,410,715,245,990,590,1825,1125
34951,Plobannalec-Lesconil,29165,29,646,616,226,1314,522,2062,1262
34952,Ploéven,29166,29,72,144,20,168,108,296,216
34953,Plogastel-Saint-Germain,29167,29,212,500,132,556,424,1112,712
34954,Plogoff,29168,29,353,130,42,549,100,691,483
34955,Plogonnec,29169,29,383,677,222,1115,552,1889,1060
34956,Plomelin,29170,29,451,989,201,1543,742,2486,1440
34957,Plomeur,29171,29,500,905,255,1485,645,2385,1405
34958,Plomodiern,29172,29,371,437,85,755,384,1224,808
34959,Plonéis,29173,29,159,665,193,646,514,1353,824
34960,Plonéour-Lanvern,29174,29,844,1488,327,1945,1191,3463,2332
34961,Plonévez-du-Faou,29175,29,382,392,140,846,271,1257,774
34962,Plonévez-Porzay,29176,29,269,375,94,580,357,1031,644
34963,Plouarzel,29177,29,390,1065,220,1265,765,2250,1455
34964,Ploudalmézeau,29178,29,836,1581,412,2039,1161,3612,2417
34965,Ploudaniel,29179,29,340,988,292,1225,745,2262,1328
34966,Ploudiry,29180,29,83,287,56,207,238,501,370
34967,Plouédern,29181,29,305,730,295,895,545,1735,1035
34968,Plouégat-Guérand,29182,29,220,303,50,285,200,535,523
34969,Plouégat-Moysan,29183,29,71,180,56,184,152,392,251
34970,Plouénan,29184,29,398,543,238,816,449,1503,941
34971,Plouescat,29185,29,682,673,200,1237,512,1949,1355
34972,Plouezoc'h,29186,29,260,319,86,573,281,940,579
34973,Plougar,29187,29,105,225,70,255,140,465,330
34974,Plougasnou,29188,29,780,448,147,1376,294,1817,1228
34975,Plougastel-Daoulas,29189,29,1561,3281,925,4712,2285,7922,4842
34976,Plougonvelin,29190,29,464,948,256,1596,629,2481,1412
34977,Plougonven,29191,29,437,735,273,1105,569,1947,1172
34978,Plougoulm,29192,29,211,365,157,675,266,1098,576
34979,Plougourvest,29193,29,87,357,113,414,218,745,444
34980,Plouguerneau,29195,29,1062,1498,480,2143,1121,3744,2560
34981,Plouguin,29196,29,176,584,176,708,456,1340,760
34982,Plouhinec,29197,29,1003,610,196,1627,475,2298,1613
34983,Plouider,29198,29,270,481,160,643,348,1151,751
34984,Plouigneau,29199,29,613,1237,365,1680,894,2939,1850
34985,Ploumoguer,29201,29,156,556,176,648,416,1240,712
34986,Plounéour-Ménez,29202,29,135,326,115,425,245,785,461
34987,Plounéour-Trez,29203,29,246,247,60,453,180,693,493
34988,Plounéventer,29204,29,192,584,268,537,535,1340,776
34989,Plounévézel,29205,29,140,365,95,365,265,725,505
34990,Plounévez-Lochrist,29206,29,387,564,185,713,442,1340,951
34991,Plourin-lès-Morlaix,29207,29,710,884,366,1500,678,2544,1594
34992,Plourin,29208,29,192,390,136,280,244,660,582
34993,Plouvien,29209,29,290,1087,329,1121,809,2259,1377
34994,Plouvorn,29210,29,365,815,258,845,504,1607,1180
34995,Plouyé,29211,29,118,149,43,229,97,369,267
34996,Plouzané,29212,29,1335,3326,1095,3865,2288,7248,4661
34997,Plouzévédé,29213,29,240,519,212,412,408,1032,759
34998,Plovan,29214,29,147,108,27,229,106,362,255
34999,Plozévet,29215,29,613,516,176,1215,444,1835,1129
35000,Pluguffan,29216,29,415,946,363,1391,712,2466,1361
35001,Pont-Aven,29217,29,615,450,150,1090,415,1655,1065
35002,Pont-Croix,29218,29,297,235,78,464,231,773,532
35003,Le Ponthou,29219,29,12,56,4,24,44,72,68
35004,Pont-l'Abbé,29220,29,1354,1596,811,2869,1144,4824,2950
35005,Porspoder,29221,29,290,333,46,717,252,1015,623
35006,Port-Launay,29222,29,65,60,55,165,50,270,125
35007,Pouldergat,29224,29,156,288,42,434,223,699,444
35008,Pouldreuzic,29225,29,296,467,146,621,410,1177,763
35009,Poullan-sur-Mer,29226,29,230,305,105,605,270,980,535
35010,Poullaouen,29227,29,270,220,124,488,195,807,490
35011,Primelin,29228,29,210,99,29,324,60,413,309
35012,Quéménéven,29229,29,185,300,90,324,240,654,485
35013,Querrien,29230,29,230,365,132,687,219,1038,595
35014,Quimper,29232,29,7786,13605,8017,20711,11094,39822,21391
35015,Quimperlé,29233,29,1545,2745,1204,3705,2270,7179,4290
35016,Rédené,29234,29,294,783,197,884,630,1711,1077
35017,Le Relecq-Kerhuon,29235,29,1385,2837,962,3775,2070,6807,4222
35018,Riec-sur-Bélon,29236,29,796,806,261,1538,618,2417,1602
35019,La Roche-Maurice,29237,29,128,483,196,534,364,1094,611
35020,Roscanvel,29238,29,174,147,35,346,139,520,321
35021,Roscoff,29239,29,636,503,224,1213,417,1854,1139
35022,Rosnoën,29240,29,156,244,64,268,212,544,400
35023,Rosporden,29241,29,1057,1832,603,2251,1414,4268,2889
35024,Saint-Coulitz,29243,29,48,105,32,107,77,216,153
35025,Saint-Derrien,29244,29,50,270,105,180,210,495,320
35026,Saint-Divy,29245,29,107,429,76,531,298,905,536
35027,Saint-Eloy,29246,29,9,47,9,54,48,111,56
35028,Saint-Évarzec,29247,29,430,919,214,1281,693,2188,1349
35029,Saint-Frégant,29248,29,30,230,80,239,190,509,260
35030,Saint-Goazec,29249,29,140,120,60,260,132,452,260
35031,Saint-Hernin,29250,29,130,160,60,274,125,459,290
35032,Saint-Jean-du-Doigt,29251,29,94,110,72,218,61,351,204
35033,Saint-Jean-Trolimon,29252,29,100,228,54,331,210,595,328
35034,Saint-Martin-des-Champs,29254,29,839,950,340,1617,737,2694,1789
35035,Saint-Méen,29255,29,35,305,54,255,230,539,340
35036,Saint-Nic,29256,29,147,146,33,252,124,409,293
35037,Saint-Pabu,29257,29,236,547,103,693,433,1229,783
35038,Saint-Pol-de-Léon,29259,29,1132,1115,487,2586,958,4031,2247
35039,Saint-Renan,29260,29,711,2130,919,2335,1577,4831,2841
35040,Saint-Rivoal,29261,29,12,32,20,76,12,108,44
35041,Saint-Sauveur,29262,29,56,241,64,200,216,480,297
35042,Saint-Ségal,29263,29,71,293,68,299,235,602,364
35043,Saint-Servais,29264,29,70,282,75,155,224,454,352
35044,Sainte-Sève,29265,29,88,265,75,334,220,629,353
35045,Saint-Thégonnec Loc-Eguiner,29266,29,326,787,342,919,509,1770,1113
35046,Saint-Thois,29267,29,108,172,64,216,144,424,280
35047,Saint-Thonan,29268,29,75,516,166,449,380,995,591
35048,Saint-Thurien,29269,29,125,265,55,355,205,615,390
35049,Saint-Urbain,29270,29,84,483,96,531,425,1052,567
35050,Saint-Vougay,29271,29,135,225,100,235,190,525,360
35051,Saint-Yvi,29272,29,337,780,233,901,664,1798,1117
35052,Santec,29273,29,350,433,155,875,416,1446,783
35053,Scaër,29274,29,677,1154,311,2203,822,3336,1831
35054,Scrignac,29275,29,167,104,42,334,87,463,271
35055,Sibiril,29276,29,200,290,140,450,160,750,490
35056,Sizun,29277,29,215,620,200,705,415,1320,835
35057,Spézet,29278,29,428,380,49,612,325,986,808
35058,Taulé,29279,29,410,660,240,982,514,1736,1070
35059,Telgruc-sur-Mer,29280,29,365,459,128,724,435,1287,824
35060,Tourch,29281,29,120,254,124,355,180,659,374
35061,Trébabu,29282,29,29,86,9,103,62,174,115
35062,Treffiagat,29284,29,520,440,155,970,285,1410,960
35063,Tréflaouénan,29285,29,75,110,40,189,85,314,185
35064,Tréflévénez,29286,29,40,75,10,85,50,145,115
35065,Tréflez,29287,29,144,208,88,300,172,560,352
35066,Trégarantec,29288,29,21,161,33,140,140,313,182
35067,Trégarvan,29289,29,32,16,12,76,4,92,48
35068,Tréglonou,29290,29,52,158,71,169,112,352,210
35069,Trégourez,29291,29,132,240,124,336,164,624,372
35070,Tréguennec,29292,29,61,52,9,86,55,150,113
35071,Trégunc,29293,29,1253,1368,487,2817,1054,4358,2621
35072,Le Tréhou,29294,29,61,193,50,174,102,326,254
35073,Trémaouézan,29295,29,33,162,26,127,161,314,195
35074,Tréméoc,29296,29,79,350,51,561,211,823,429
35075,Tréméven,29297,29,347,523,146,781,430,1357,870
35076,Tréogat,29298,29,68,148,32,200,104,336,216
35077,Tréouergat,29299,29,16,83,13,108,72,193,99
35078,Le Trévoux,29300,29,163,445,135,439,339,913,608
35079,Trézilidé,29301,29,32,102,44,65,60,169,134
35080,Pont-de-Buis-lès-Quimerch,29302,29,331,939,373,1225,859,2457,1270
35081,Afa,20001,2A,333,626,309,1042,577,1928,959
35082,Ajaccio,20004,2A,9954,14415,7934,21145,13523,42602,24369
35083,Alata,20006,2A,314,678,231,1182,595,2008,992
35084,Albitreccia,20008,2A,245,245,129,611,246,986,490
35085,Altagène,20011,2A,4,1,0,10,0,10,5
35086,Ambiegna,20014,2A,19,9,7,22,11,40,28
35087,Appietto,20017,2A,191,373,116,597,314,1027,564
35088,Arbellara,20018,2A,18,34,8,46,36,90,52
35089,Arbori,20019,2A,21,2,3,22,8,33,23
35090,Argiusta-Moriccio,20021,2A,33,7,7,22,7,36,40
35091,Arro,20022,2A,24,8,12,35,9,56,32
35092,Aullène,20024,2A,30,23,11,84,36,131,53
35093,Azilone-Ampaza,20026,2A,24,40,15,49,28,92,64
35094,Azzana,20027,2A,2,0,0,6,0,6,2
35095,Balogna,20028,2A,19,9,2,24,7,33,28
35096,Bastelica,20031,2A,102,57,41,153,50,244,159
35097,Bastelicaccia,20032,2A,438,839,391,1368,756,2515,1277
35098,Belvédère-Campomoro,20035,2A,25,25,14,59,30,103,50
35099,Bilia,20038,2A,10,7,0,17,10,27,17
35100,Bocognano,20040,2A,63,58,27,111,52,190,121
35101,Bonifacio,20041,2A,372,623,291,986,574,1851,995
35102,Calcatoggio,20048,2A,87,90,45,226,83,354,177
35103,Campo,20056,2A,17,17,8,34,19,61,34
35104,Cannelle,20060,2A,4,2,0,7,2,9,6
35105,Carbini,20061,2A,34,6,9,42,9,60,40
35106,Carbuccia,20062,2A,38,50,29,97,43,169,88
35107,Cardo-Torgia,20064,2A,8,0,6,16,3,25,8
35108,Cargèse,20065,2A,226,215,134,471,217,822,441
35109,Cargiaca,20066,2A,7,0,0,11,0,11,7
35110,Casaglione,20070,2A,82,57,27,146,58,231,139
35111,Casalabriva,20071,2A,28,25,3,33,24,60,53
35112,Cauro,20085,2A,178,270,129,458,219,806,448
35113,Ciamannacce,20089,2A,51,1,11,45,24,80,52
35114,Coggia,20090,2A,199,82,53,304,99,456,281
35115,Cognocoli-Monticchi,20091,2A,30,6,6,33,8,47,36
35116,Conca,20092,2A,200,176,108,419,207,734,376
35117,Corrano,20094,2A,30,10,4,19,9,32,40
35118,Coti-Chiavari,20098,2A,151,99,41,329,123,493,250
35119,Cozzano,20099,2A,75,46,20,80,49,149,121
35120,Cristinacce,20100,2A,22,4,3,21,6,30,26
35121,Cuttoli-Corticchiato,20103,2A,188,420,166,678,328,1172,608
35122,Eccica-Suarella,20104,2A,114,240,69,359,196,624,354
35123,Evisa,20108,2A,50,30,10,81,31,122,80
35124,Figari,20114,2A,186,338,117,490,307,914,524
35125,Foce,20115,2A,6,19,3,32,15,50,25
35126,Forciolo,20117,2A,22,9,1,24,10,35,31
35127,Fozzano,20118,2A,19,17,5,54,20,79,36
35128,Frasseto,20119,2A,52,9,8,45,8,61,61
35129,Giuncheto,20127,2A,6,8,1,12,6,19,14
35130,Granace,20128,2A,14,9,0,10,4,14,23
35131,Grossa,20129,2A,12,8,1,15,7,23,20
35132,Grosseto-Prugna,20130,2A,405,489,312,1089,572,1973,894
35133,Guagno,20131,2A,42,4,5,21,1,27,46
35134,Guargualé,20132,2A,18,6,0,19,10,29,24
35135,Guitera-les-Bains,20133,2A,26,21,13,64,24,101,47
35136,Lecci,20139,2A,163,341,186,433,342,961,504
35137,Letia,20141,2A,30,5,11,56,11,78,35
35138,Levie,20142,2A,120,87,42,210,82,334,207
35139,Lopigna,20144,2A,36,6,4,45,8,57,42
35140,Loreto-di-Tallano,20146,2A,16,5,2,19,8,29,21
35141,Marignana,20154,2A,15,7,0,24,9,33,22
35142,Mela,20158,2A,5,0,0,1,0,1,5
35143,Moca-Croce,20160,2A,80,35,14,64,39,117,115
35144,Monacia-d'Aullène,20163,2A,95,77,27,120,70,217,172
35145,Murzo,20174,2A,9,7,1,14,3,18,16
35146,Ocana,20181,2A,67,109,48,180,87,315,176
35147,Olivese,20186,2A,48,20,4,59,14,77,68
35148,Olmeto,20189,2A,227,216,109,451,210,770,443
35149,Olmiccia,20191,2A,10,6,3,18,5,26,16
35150,Orto,20196,2A,30,1,4,20,3,27,31
35151,Osani,20197,2A,15,14,5,43,22,70,29
35152,Ota,20198,2A,99,74,47,230,84,361,173
35153,Palneca,20200,2A,45,21,12,68,17,97,66
35154,Partinello,20203,2A,42,5,3,41,9,53,47
35155,Pastricciola,20204,2A,21,9,6,42,19,67,30
35156,Peri,20209,2A,225,415,159,600,387,1146,640
35157,Petreto-Bicchisano,20211,2A,157,100,27,194,75,296,257
35158,Piana,20212,2A,85,57,15,150,58,223,142
35159,Pianotolli-Caldarello,20215,2A,198,162,87,316,171,574,360
35160,Pietrosella,20228,2A,274,272,120,463,238,821,546
35161,Pila-Canale,20232,2A,74,42,20,111,41,172,116
35162,Poggiolo,20240,2A,10,1,6,12,0,18,11
35163,Porto-Vecchio,20247,2A,1298,2874,1346,3344,2603,7293,4172
35164,Propriano,20249,2A,515,707,433,1253,680,2366,1222
35165,Quasquara,20253,2A,20,5,3,25,0,28,25
35166,Quenza,20254,2A,41,25,17,80,28,125,66
35167,Renno,20258,2A,18,8,2,23,9,34,26
35168,Rezza,20259,2A,13,2,2,29,6,37,15
35169,Rosazia,20262,2A,16,6,3,18,7,28,22
35170,Salice,20266,2A,38,4,10,33,3,46,42
35171,Sampolo,20268,2A,14,4,4,26,10,40,18
35172,Sari-Solenzara,20269,2A,234,266,140,469,227,836,500
35173,Sari-d'Orcino,20270,2A,43,32,20,93,36,149,75
35174,Sarrola-Carcopino,20271,2A,193,491,273,727,487,1487,684
35175,Sartène,20272,2A,585,653,305,1091,594,1990,1238
35176,Serra-di-Ferro,20276,2A,98,74,33,177,92,302,172
35177,Serra-di-Scopamène,20278,2A,18,19,9,43,15,67,37
35178,Serriera,20279,2A,17,6,1,22,7,30,23
35179,Soccia,20282,2A,69,9,11,37,19,67,78
35180,Sollacaro,20284,2A,83,47,35,138,44,217,130
35181,Sorbollano,20285,2A,19,0,1,11,0,12,19
35182,Sotta,20288,2A,169,241,92,407,200,699,410
35183,Sant'Andréa-d'Orcino,20295,2A,3,12,3,30,5,38,15
35184,San-Gavino-di-Carbini,20300,2A,128,251,97,369,219,685,379
35185,Sainte-Lucie-de-Tallano,20308,2A,122,68,24,170,58,252,190
35186,Santa-Maria-Figaniella,20310,2A,8,9,1,6,5,12,17
35187,Santa-Maria-Siché,20312,2A,76,85,29,153,96,278,161
35188,Tasso,20322,2A,13,9,1,15,5,21,22
35189,Tavaco,20323,2A,36,73,49,111,75,235,109
35190,Tavera,20324,2A,66,61,39,142,77,258,127
35191,Tolla,20326,2A,11,5,3,36,4,43,16
35192,Ucciani,20330,2A,76,103,44,159,86,289,179
35193,Urbalacone,20331,2A,24,7,4,19,15,38,31
35194,Valle-di-Mezzana,20336,2A,38,100,35,106,81,222,138
35195,Vero,20345,2A,78,120,53,159,96,308,198
35196,Vico,20348,2A,152,131,58,289,111,458,283
35197,Viggianello,20349,2A,57,141,48,186,113,347,198
35198,Villanova,20351,2A,21,46,19,115,52,186,67
35199,Zérubia,20357,2A,2,9,7,12,6,25,11
35200,Zévaco,20358,2A,16,6,3,25,9,37,22
35201,Zicavo,20359,2A,32,15,2,67,13,82,47
35202,Zigliara,20360,2A,42,6,8,56,18,82,48
35203,Zonza,20362,2A,340,632,226,834,556,1616,972
35204,Zoza,20363,2A,9,0,0,4,1,5,9
35205,Aghione,20002,2B,27,49,19,86,47,152,76
35206,Aiti,20003,2B,9,3,1,17,4,22,12
35207,Alando,20005,2B,5,13,0,9,4,13,18
35208,Albertacce,20007,2B,62,20,18,81,15,114,82
35209,Aléria,20009,2B,260,432,258,721,387,1366,692
35210,Algajola,20010,2B,43,53,18,86,48,152,96
35211,Altiani,20012,2B,17,6,0,17,7,24,23
35212,Alzi,20013,2B,2,0,0,0,0,0,2
35213,Ampriani,20015,2B,1,0,0,2,0,2,1
35214,Antisanti,20016,2B,100,46,41,174,68,283,146
35215,Aregno,20020,2B,118,83,48,216,135,399,201
35216,Asco,20023,2B,32,17,7,44,22,73,49
35217,Avapessa,20025,2B,12,13,6,39,15,60,25
35218,Barbaggio,20029,2B,14,66,26,84,55,165,80
35219,Barrettali,20030,2B,40,12,3,70,6,79,52
35220,Bastia,20033,2B,6121,9409,4978,13140,8899,27017,15530
35221,Belgodère,20034,2B,86,106,50,191,118,359,192
35222,Bigorno,20036,2B,26,4,5,34,9,48,30
35223,Biguglia,20037,2B,639,1852,949,2495,1834,5278,2491
35224,Bisinchi,20039,2B,42,20,15,71,32,118,62
35225,Borgo,20042,2B,606,2031,865,2467,1749,5081,2637
35226,Brando,20043,2B,299,266,115,706,243,1064,565
35227,Bustanico,20045,2B,17,3,2,27,10,39,20
35228,Cagnano,20046,2B,58,15,19,63,15,97,73
35229,Calacuccia,20047,2B,77,32,26,106,42,174,109
35230,Calenzana,20049,2B,309,542,194,744,490,1428,851
35231,Calvi,20050,2B,555,1168,502,1420,1084,3006,1723
35232,Cambia,20051,2B,14,12,13,32,18,63,26
35233,Campana,20052,2B,3,0,0,0,0,0,3
35234,Campi,20053,2B,2,0,0,0,0,0,2
35235,Campile,20054,2B,21,9,5,46,11,62,30
35236,Campitello,20055,2B,33,16,5,51,12,68,49
35237,Canale-di-Verde,20057,2B,73,41,23,143,48,214,114
35238,Canari,20058,2B,63,15,4,88,23,115,78
35239,Canavaggia,20059,2B,17,4,1,9,3,13,21
35240,Carcheto-Brustico,20063,2B,0,1,0,0,1,1,1
35241,Carpineto,20067,2B,9,1,0,19,1,20,10
35242,Carticasi,20068,2B,8,1,0,1,0,1,9
35243,Casabianca,20069,2B,19,17,7,39,8,54,36
35244,Casalta,20072,2B,17,5,3,17,8,28,22
35245,Casamaccioli,20073,2B,20,1,0,12,1,13,21
35246,Casanova,20074,2B,20,67,25,95,55,175,87
35247,Casevecchie,20075,2B,21,5,2,28,7,37,26
35248,Castellare-di-Casinca,20077,2B,109,131,53,186,122,361,240
35249,Castellare-di-Mercurio,20078,2B,6,6,2,13,5,20,12
35250,Castello-di-Rostino,20079,2B,53,75,18,115,69,202,128
35251,Castifao,20080,2B,38,21,9,73,19,101,59
35252,Castiglione,20081,2B,15,1,2,18,2,22,16
35253,Castineta,20082,2B,11,4,1,23,2,26,15
35254,Castirla,20083,2B,33,30,20,54,30,104,63
35255,Cateri,20084,2B,26,36,24,79,46,149,62
35256,Centuri,20086,2B,41,31,22,79,40,141,72
35257,Cervione,20087,2B,287,306,165,640,320,1125,593
35258,Chiatra,20088,2B,24,18,7,46,16,69,42
35259,Corbara,20093,2B,180,182,80,374,157,611,362
35260,Corscia,20095,2B,42,5,13,60,13,86,47
35261,Corte,20096,2B,748,1463,1412,1603,1052,4067,2211
35262,Costa,20097,2B,11,7,9,28,10,47,18
35263,Croce,20101,2B,6,4,0,8,2,10,10
35264,Crocicchia,20102,2B,5,1,0,8,1,9,6
35265,Erbajolo,20105,2B,15,4,0,17,3,20,19
35266,Erone,20106,2B,2,3,1,2,2,5,5
35267,Ersa,20107,2B,50,13,7,64,18,89,63
35268,Farinole,20109,2B,32,10,9,39,11,59,42
35269,Favalello,20110,2B,2,10,0,9,10,19,12
35270,Felce,20111,2B,11,0,0,7,0,7,11
35271,Feliceto,20112,2B,15,38,7,35,25,67,53
35272,Ficaja,20113,2B,23,2,1,26,2,29,25
35273,Focicchia,20116,2B,10,4,1,8,2,11,14
35274,Furiani,20120,2B,493,1274,612,1944,1262,3818,1767
35275,Galéria,20121,2B,45,33,10,110,38,158,78
35276,Gavignano,20122,2B,5,0,0,11,0,11,5
35277,Ghisonaccia,20123,2B,606,797,426,1289,796,2511,1403
35278,Ghisoni,20124,2B,62,7,3,57,5,65,69
35279,Giocatojo,20125,2B,20,4,4,13,5,22,24
35280,Giuncaggio,20126,2B,9,8,2,19,13,34,17
35281,L'Ile-Rousse,20134,2B,497,701,360,1032,613,2005,1198
35282,Isolaccio-di-Fiumorbo,20135,2B,106,24,24,129,35,188,130
35283,Lama,20136,2B,45,18,16,69,13,98,63
35284,Lano,20137,2B,7,1,1,16,1,18,8
35285,Lavatoggio,20138,2B,14,17,11,17,16,44,31
35286,Lento,20140,2B,41,10,2,43,8,53,51
35287,Linguizzetta,20143,2B,166,198,114,407,214,735,364
35288,Loreto-di-Casinca,20145,2B,27,27,6,50,15,71,54
35289,Lozzi,20147,2B,38,17,7,37,23,67,55
35290,Lucciana,20148,2B,483,1259,690,1537,1166,3393,1742
35291,Lugo-di-Nazza,20149,2B,18,12,8,27,13,48,30
35292,Lumio,20150,2B,195,200,79,381,189,649,395
35293,Luri,20152,2B,161,144,74,279,120,473,305
35294,Manso,20153,2B,21,13,12,50,12,74,34
35295,Matra,20155,2B,17,0,0,22,1,23,17
35296,Mausoléo,20156,2B,4,3,0,10,0,10,7
35297,Mazzola,20157,2B,10,0,2,14,0,16,10
35298,Meria,20159,2B,35,12,8,34,13,55,47
35299,Moïta,20161,2B,23,5,5,37,9,51,28
35300,Moltifao,20162,2B,150,105,58,250,121,429,255
35301,Monacia-d'Orezza,20164,2B,0,0,1,5,0,6,0
35302,Moncale,20165,2B,44,50,9,59,43,111,94
35303,Monte,20166,2B,49,155,45,226,125,396,204
35304,Montegrosso,20167,2B,108,70,25,173,55,253,178
35305,Monticello,20168,2B,295,371,128,634,327,1089,666
35306,Morosaglia,20169,2B,184,240,135,384,215,734,424
35307,Morsiglia,20170,2B,22,21,11,53,26,90,43
35308,Muracciole,20171,2B,13,4,5,10,6,21,17
35309,Murato,20172,2B,113,84,57,235,110,402,197
35310,Muro,20173,2B,40,21,9,44,20,73,61
35311,Nessa,20175,2B,16,8,1,17,5,23,24
35312,Nocario,20176,2B,4,4,0,11,1,12,8
35313,Noceta,20177,2B,12,6,4,22,10,36,18
35314,Nonza,20178,2B,23,7,10,22,11,43,30
35315,Novale,20179,2B,1,3,1,6,0,7,4
35316,Novella,20180,2B,30,4,4,33,12,49,34
35317,Occhiatana,20182,2B,40,29,12,63,32,107,69
35318,Ogliastro,20183,2B,31,5,13,41,14,68,36
35319,Olcani,20184,2B,24,6,7,31,12,50,30
35320,Oletta,20185,2B,212,286,129,542,312,983,498
35321,Olmeta-di-Capocorso,20187,2B,54,16,6,50,22,78,70
35322,Olmeta-di-Tuda,20188,2B,50,86,38,157,88,283,136
35323,Olmi-Cappella,20190,2B,23,12,6,53,11,70,35
35324,Olmo,20192,2B,22,26,22,64,29,115,48
35325,Omessa,20193,2B,62,105,36,149,85,270,167
35326,Ortale,20194,2B,4,0,4,13,4,21,4
35327,Ortiporio,20195,2B,8,5,4,20,10,34,13
35328,Palasca,20199,2B,24,24,12,73,29,114,48
35329,Pancheraccia,20201,2B,58,17,13,59,26,98,75
35330,Parata,20202,2B,18,0,1,8,1,10,18
35331,Patrimonio,20205,2B,121,131,63,272,137,472,252
35332,Penta-Acquatella,20206,2B,4,0,0,3,2,5,4
35333,Penta-di-Casinca,20207,2B,411,749,389,1029,676,2094,1160
35334,Perelli,20208,2B,24,12,13,52,9,74,36
35335,Pero-Casevecchie,20210,2B,29,13,15,54,12,81,42
35336,Pianello,20213,2B,7,0,0,9,1,10,7
35337,Piano,20214,2B,1,0,1,3,0,4,1
35338,Piazzali,20216,2B,7,0,2,6,2,10,7
35339,Piazzole,20217,2B,7,6,9,13,7,29,13
35340,Piedicorte-di-Gaggio,20218,2B,29,15,7,32,20,59,44
35341,Piedicroce,20219,2B,16,19,8,35,32,75,35
35342,Piedigriggio,20220,2B,34,20,14,48,29,91,54
35343,Piedipartino,20221,2B,2,3,1,9,3,13,5
35344,Pie-d'Orezza,20222,2B,10,4,4,16,1,21,14
35345,Pietralba,20223,2B,80,78,41,159,72,272,158
35346,Pietracorbara,20224,2B,147,107,47,231,109,387,254
35347,Pietra-di-Verde,20225,2B,36,7,3,47,14,64,43
35348,Pietraserena,20226,2B,31,3,3,37,3,43,34
35349,Pietricaggio,20227,2B,14,3,1,12,5,18,17
35350,Pietroso,20229,2B,60,51,11,86,43,140,111
35351,Piève,20230,2B,26,11,8,54,10,72,37
35352,Pigna,20231,2B,12,23,4,43,18,65,35
35353,Pino,20233,2B,35,10,0,29,3,32,45
35354,Piobetta,20234,2B,1,0,1,3,0,4,1
35355,Pioggiola,20235,2B,28,14,8,25,12,45,42
35356,Poggio-di-Nazza,20236,2B,37,7,4,38,5,47,44
35357,Poggio-di-Venaco,20238,2B,23,22,19,44,12,75,45
35358,Poggio-d'Oletta,20239,2B,15,21,10,66,18,94,36
35359,Poggio-Marinaccio,20241,2B,5,5,0,14,6,20,10
35360,Poggio-Mezzana,20242,2B,74,121,56,259,116,431,195
35361,Polveroso,20243,2B,1,1,2,3,0,5,2
35362,Popolasca,20244,2B,14,6,10,17,3,30,20
35363,Porri,20245,2B,9,2,7,23,3,33,11
35364,La Porta,20246,2B,58,23,22,70,20,112,81
35365,Prato-di-Giovellina,20248,2B,12,3,6,22,0,28,15
35366,Prunelli-di-Casacconi,20250,2B,10,16,6,29,9,44,26
35367,Prunelli-di-Fiumorbo,20251,2B,528,782,325,1087,682,2094,1310
35368,Pruno,20252,2B,32,36,13,61,34,108,68
35369,Quercitello,20255,2B,6,10,1,25,5,31,16
35370,Rapaggio,20256,2B,0,1,0,2,0,2,1
35371,Rapale,20257,2B,15,14,6,30,7,43,29
35372,Riventosa,20260,2B,17,22,28,60,25,113,39
35373,Rogliano,20261,2B,127,76,44,226,101,371,203
35374,Rospigliani,20263,2B,24,11,7,28,10,45,35
35375,Rusio,20264,2B,31,8,3,29,8,40,39
35376,Rutali,20265,2B,71,71,38,139,62,239,142
35377,Saliceto,20267,2B,16,4,4,28,7,39,20
35378,Scata,20273,2B,5,3,0,3,1,4,8
35379,Scolca,20274,2B,24,18,6,33,23,62,42
35380,Sermano,20275,2B,17,5,9,25,4,38,22
35381,Serra-di-Fiumorbo,20277,2B,47,64,18,116,71,205,111
35382,Silvareccio,20280,2B,8,11,1,23,5,29,19
35383,Sisco,20281,2B,136,208,99,383,224,706,344
35384,Solaro,20283,2B,151,112,39,285,96,420,263
35385,Sorbo-Ocagnano,20286,2B,107,150,64,249,114,427,257
35386,Sorio,20287,2B,49,12,8,47,21,76,61
35387,Soveria,20289,2B,16,24,17,40,16,73,40
35388,Speloncato,20290,2B,64,52,20,99,43,162,116
35389,Stazzona,20291,2B,12,4,6,11,6,23,16
35390,Sant'Andréa-di-Bozio,20292,2B,33,5,3,29,3,35,38
35391,Sant'Andréa-di-Cotone,20293,2B,30,36,6,45,26,77,66
35392,Sant'Antonino,20296,2B,17,22,9,44,21,74,39
35393,San-Damiano,20297,2B,3,15,0,23,14,37,18
35394,Saint-Florent,20298,2B,319,275,131,593,264,988,594
35395,San-Gavino-d'Ampugnani,20299,2B,20,18,6,33,23,62,38
35396,San-Gavino-di-Tenda,20301,2B,17,9,4,28,7,39,26
35397,San-Giovanni-di-Moriani,20302,2B,14,16,7,42,12,61,30
35398,San-Giuliano,20303,2B,98,113,45,198,89,332,211
35399,San-Lorenzo,20304,2B,16,21,4,17,13,34,37
35400,San-Martino-di-Lota,20305,2B,435,499,271,1012,514,1797,934
35401,Santa-Lucia-di-Mercurio,20306,2B,3,6,8,15,4,27,9
35402,Santa-Lucia-di-Moriani,20307,2B,155,264,120,428,225,773,419
35403,Santa-Maria-di-Lota,20309,2B,334,333,148,671,271,1090,667
35404,Santa-Maria-Poggio,20311,2B,98,132,57,268,109,434,230
35405,San-Nicolao,20313,2B,297,397,172,602,322,1096,694
35406,Santo-Pietro-di-Tenda,20314,2B,89,46,31,145,45,221,135
35407,Santo-Pietro-di-Venaco,20315,2B,39,42,57,84,38,179,81
35408,Santa-Reparata-di-Balagna,20316,2B,166,190,96,377,192,665,356
35409,Santa-Reparata-di-Moriani,20317,2B,15,9,6,10,10,26,24
35410,Taglio-Isolaccio,20318,2B,92,103,57,215,98,370,195
35411,Talasani,20319,2B,66,161,37,231,125,393,227
35412,Tallone,20320,2B,66,48,29,132,49,210,114
35413,Tarrano,20321,2B,4,1,0,8,2,10,5
35414,Tomino,20327,2B,47,35,13,82,31,126,82
35415,Tox,20328,2B,42,6,7,33,11,51,48
35416,Tralonca,20329,2B,17,21,16,36,17,69,38
35417,Urtaca,20332,2B,26,30,6,42,30,78,56
35418,Vallecalle,20333,2B,18,12,0,26,13,39,30
35419,Valle-d'Alesani,20334,2B,23,3,0,37,1,38,26
35420,Valle-di-Campoloro,20335,2B,45,41,25,83,43,151,86
35421,Valle-di-Rostino,20337,2B,10,6,2,38,0,40,16
35422,Valle-d'Orezza,20338,2B,11,3,6,22,6,34,14
35423,Vallica,20339,2B,2,0,0,3,0,3,2
35424,Velone-Orneto,20340,2B,6,15,0,15,14,29,21
35425,Venaco,20341,2B,176,98,67,270,102,439,274
35426,Ventiseri,20342,2B,217,602,229,681,513,1423,819
35427,Venzolasca,20343,2B,191,346,156,559,347,1062,537
35428,Verdèse,20344,2B,10,4,0,16,6,22,14
35429,Vescovato,20346,2B,312,587,283,855,494,1632,899
35430,Vezzani,20347,2B,61,19,7,99,24,130,80
35431,Vignale,20350,2B,41,19,14,77,17,108,60
35432,Ville-di-Paraso,20352,2B,19,25,5,49,19,73,44
35433,Ville-di-Pietrabugno,20353,2B,658,622,243,1310,558,2111,1280
35434,Vivario,20354,2B,71,52,44,154,37,235,123
35435,Volpajola,20355,2B,31,69,24,124,60,208,100
35436,Zalana,20356,2B,26,3,2,35,1,38,29
35437,Zilia,20361,2B,50,76,14,91,59,164,126
35438,Zuani,20364,2B,9,2,1,14,2,17,11
35439,San-Gavino-di-Fiumorbo,20365,2B,43,7,13,70,15,98,50
35440,Chisa,20366,2B,37,5,5,43,7,55,42
35441,Aigaliers,30001,30,72,140,28,176,80,284,212
35442,Aigremont,30002,30,60,188,43,213,177,433,248
35443,Aigues-Mortes,30003,30,1285,1825,730,2955,1505,5190,3110
35444,Aigues-Vives,30004,30,396,791,260,935,612,1807,1187
35445,Aiguèze,30005,30,20,48,12,88,44,144,68
35446,Aimargues,30006,30,622,1434,503,1439,1234,3176,2056
35447,Alès,30007,30,7314,8239,4814,12582,6103,23499,15553
35448,Allègre-les-Fumades,30008,30,135,208,55,271,193,519,343
35449,Alzon,30009,30,33,22,18,76,9,103,55
35450,Anduze,30010,30,591,657,264,1245,413,1922,1248
35451,Les Angles,30011,30,1718,1578,723,2938,1349,5010,3296
35452,Aramon,30012,30,468,961,337,1379,770,2486,1429
35453,Argilliers,30013,30,28,144,40,205,74,319,172
35454,Arpaillargues-et-Aureillac,30014,30,95,211,85,487,155,727,306
35455,Arphy,30015,30,30,0,20,100,20,140,30
35456,Arre,30016,30,40,100,5,135,45,185,140
35457,Arrigas,30017,30,35,35,5,112,30,147,70
35458,Aspères,30018,30,32,122,21,149,144,314,154
35459,Aubais,30019,30,250,674,180,948,465,1593,924
35460,Aubord,30020,30,187,599,201,890,433,1524,786
35461,Aubussargues,30021,30,56,92,16,120,60,196,148
35462,Aujac,30022,30,19,30,23,65,16,104,49
35463,Aujargues,30023,30,125,210,75,365,119,559,335
35464,Aulas,30024,30,64,113,34,225,69,328,177
35465,Aumessas,30025,30,48,28,0,112,40,152,76
35466,Avèze,30026,30,200,220,50,420,161,631,420
35467,Bagard,30027,30,329,652,175,862,448,1485,981
35468,Bagnols-sur-Cèze,30028,30,2835,4249,1913,5636,2977,10526,7084
35469,Barjac,30029,30,310,250,135,574,199,908,560
35470,Baron,30030,30,42,83,33,89,61,183,125
35471,La Bastide-d'Engras,30031,30,16,25,0,61,40,101,41
35472,Beaucaire,30032,30,1669,4312,1626,4936,3017,9579,5981
35473,Beauvoisin,30033,30,419,1212,486,1404,942,2832,1631
35474,Bellegarde,30034,30,719,1717,704,2073,1300,4077,2436
35475,Belvézet,30035,30,35,35,15,85,60,160,70
35476,Bernis,30036,30,518,780,225,920,681,1826,1298
35477,Bessèges,30037,30,616,470,125,1045,443,1613,1086
35478,Bez-et-Esparon,30038,30,76,64,12,144,40,196,140
35479,Bezouce,30039,30,305,544,202,753,347,1302,849
35480,Blandas,30040,30,20,24,0,60,28,88,44
35481,Blauzac,30041,30,142,260,95,408,185,688,402
35482,Boisset-et-Gaujac,30042,30,273,610,204,901,439,1544,883
35483,Boissières,30043,30,64,158,8,212,69,289,222
35484,Bonnevaux,30044,30,5,5,10,47,20,77,10
35485,Bordezac,30045,30,85,65,20,170,50,240,150
35486,Boucoiran-et-Nozières,30046,30,60,223,120,196,249,565,283
35487,Bouillargues,30047,30,794,1591,547,2191,986,3724,2385
35488,Bouquet,30048,30,26,30,4,62,26,92,56
35489,Bourdic,30049,30,65,110,15,115,85,215,175
35490,Bragassargues,30050,30,12,24,20,65,12,97,36
35491,Branoux-les-Taillades,30051,30,230,258,94,494,217,805,488
35492,Bréau-et-Salagosse,30052,30,50,108,25,135,99,259,158
35493,Brignon,30053,30,115,180,45,305,125,475,295
35494,Brouzet-lès-Quissac,30054,30,45,85,10,70,60,140,130
35495,Brouzet-lès-Alès,30055,30,95,120,65,215,130,410,215
35496,La Bruguière,30056,30,40,88,4,134,65,203,128
35497,Cabrières,30057,30,76,405,128,622,278,1028,481
35498,La Cadière-et-Cambo,30058,30,61,29,22,61,12,95,90
35499,Le Cailar,30059,30,352,490,160,858,402,1420,842
35500,Caissargues,30060,30,629,987,270,1341,735,2346,1616
35501,La Calmette,30061,30,351,423,239,726,331,1296,774
35502,Calvisson,30062,30,498,1469,488,1532,1271,3291,1967
35503,Campestre-et-Luc,30064,30,20,15,15,40,10,65,35
35504,Canaules-et-Argentières,30065,30,57,82,32,118,45,195,139
35505,Cannes-et-Clairan,30066,30,75,136,25,201,106,332,211
35506,La Capelle-et-Masmolène,30067,30,54,89,45,163,84,292,143
35507,Cardet,30068,30,156,208,88,264,124,476,364
35508,Carnas,30069,30,70,95,35,170,85,290,165
35509,Carsan,30070,30,65,185,50,235,135,420,250
35510,Cassagnoles,30071,30,50,121,25,105,120,250,171
35511,Castelnau-Valence,30072,30,30,119,55,144,80,279,149
35512,Castillon-du-Gard,30073,30,196,330,141,525,267,933,526
35513,Causse-Bégon,30074,30,0,0,0,4,8,12,0
35514,Caveirac,30075,30,503,863,330,1654,592,2576,1366
35515,Cavillargues,30076,30,92,180,88,280,156,524,272
35516,Cendras,30077,30,370,385,135,585,330,1050,755
35517,Chambon,30079,30,43,26,26,130,42,198,69
35518,Chamborigaud,30080,30,204,76,32,344,92,468,280
35519,Chusclan,30081,30,160,188,92,328,192,612,348
35520,Clarensac,30082,30,395,1238,320,1429,862,2611,1633
35521,Codognan,30083,30,265,600,215,840,505,1560,865
35522,Codolet,30084,30,25,195,125,245,94,464,220
35523,Collias,30085,30,120,252,68,416,260,744,372
35524,Collorgues,30086,30,28,156,44,196,128,368,184
35525,Colognac,30087,30,13,27,3,74,33,110,40
35526,Combas,30088,30,65,146,42,209,102,353,211
35527,Comps,30089,30,169,433,108,579,368,1055,602
35528,Concoules,30090,30,28,28,8,124,32,164,56
35529,Congénies,30091,30,149,411,145,517,323,985,560
35530,Connaux,30092,30,242,385,71,564,339,974,627
35531,Conqueyrac,30093,30,25,25,5,20,25,50,50
35532,Corbès,30094,30,12,22,6,65,25,96,34
35533,Corconne,30095,30,35,115,50,195,110,355,150
35534,Cornillon,30096,30,110,220,60,285,180,525,330
35535,Courry,30097,30,70,60,10,101,50,161,130
35536,Crespian,30098,30,40,104,44,104,68,216,144
35537,Cros,30099,30,32,32,4,140,36,180,64
35538,Cruviers-Lascours,30100,30,49,200,70,169,200,439,249
35539,Deaux,30101,30,52,186,53,217,142,412,238
35540,Dions,30102,30,65,125,81,219,100,400,190
35541,Domazan,30103,30,65,243,80,358,191,629,308
35542,Domessargues,30104,30,45,195,55,230,150,435,240
35543,Dourbies,30105,30,47,16,3,52,13,68,63
35544,Durfort-et-Saint-Martin-de-Sossenac,30106,30,120,145,5,235,160,400,265
35545,Estézargues,30107,30,44,139,24,156,122,302,183
35546,L'Estréchure,30108,30,20,20,15,94,20,129,40
35547,Euzet,30109,30,52,92,24,160,88,272,144
35548,Flaux,30110,30,39,100,33,118,51,202,139
35549,Foissac,30111,30,45,115,45,115,105,265,160
35550,Fons,30112,30,117,382,113,409,304,826,499
35551,Fons-sur-Lussan,30113,30,35,40,20,115,20,155,75
35552,Fontanès,30114,30,62,165,53,169,171,393,227
35553,Fontarèches,30115,30,12,63,4,104,50,158,75
35554,Fournès,30116,30,43,301,69,309,268,646,344
35555,Fourques,30117,30,343,696,180,988,582,1750,1039
35556,Fressac,30119,30,30,22,33,53,54,140,52
35557,Gagnières,30120,30,217,216,72,446,200,718,433
35558,Gailhan,30121,30,5,79,15,79,50,144,84
35559,Gajan,30122,30,50,140,55,300,125,480,190
35560,Gallargues-le-Montueux,30123,30,244,1004,329,1017,841,2187,1248
35561,Le Garn,30124,30,32,48,20,88,40,148,80
35562,Garons,30125,30,495,1264,448,1481,905,2834,1759
35563,Garrigues-Sainte-Eulalie,30126,30,64,179,60,243,143,446,243
35564,Gaujac,30127,30,84,322,112,289,311,712,406
35565,Générac,30128,30,382,1017,431,1195,859,2485,1399
35566,Générargues,30129,30,148,128,84,284,76,444,276
35567,Génolhac,30130,30,160,145,70,315,120,505,305
35568,Goudargues,30131,30,188,176,110,399,107,616,364
35569,La Grand-Combe,30132,30,984,1178,415,1447,868,2730,2162
35570,Le Grau-du-Roi,30133,30,1647,1264,596,3298,1180,5074,2911
35571,Issirac,30134,30,25,60,13,94,41,148,85
35572,Jonquières-Saint-Vincent,30135,30,418,1073,340,1066,726,2132,1491
35573,Junas,30136,30,127,253,59,334,203,596,380
35574,Lamelouze,30137,30,20,26,4,62,16,82,46
35575,Langlade,30138,30,268,453,162,925,317,1404,721
35576,Lanuéjols,30139,30,40,70,20,155,50,225,110
35577,Lasalle,30140,30,217,252,68,380,176,624,469
35578,Laudun-l'Ardoise,30141,30,587,1420,453,1736,1102,3291,2007
35579,Laval-Pradel,30142,30,140,230,114,483,188,785,370
35580,Laval-Saint-Roman,30143,30,20,44,15,93,16,124,64
35581,Lecques,30144,30,15,185,35,100,135,270,200
35582,Lédenon,30145,30,126,374,136,559,226,921,500
35583,Lédignan,30146,30,200,370,130,460,250,840,570
35584,Lézan,30147,30,145,406,145,484,324,953,551
35585,Liouc,30148,30,50,60,0,109,40,149,110
35586,Lirac,30149,30,72,224,80,296,224,600,296
35587,Logrian-Florian,30150,30,10,60,5,135,55,195,70
35588,Lussan,30151,30,73,90,24,154,105,283,163
35589,Les Mages,30152,30,307,420,174,843,285,1302,727
35590,Malons-et-Elze,30153,30,16,16,4,52,24,80,32
35591,Mandagout,30154,30,51,57,12,156,63,231,108
35592,Manduel,30155,30,898,1535,545,2327,1122,3994,2433
35593,Marguerittes,30156,30,1196,1935,753,3095,1428,5276,3131
35594,Mars,30157,30,10,50,0,84,54,138,60
35595,Martignargues,30158,30,56,104,20,120,104,244,160
35596,Le Martinet,30159,30,129,161,69,276,113,458,290
35597,Maruéjols-lès-Gardon,30160,30,20,67,20,89,33,142,87
35598,Massanes,30161,30,48,44,4,60,40,104,92
35599,Massillargues-Attuech,30162,30,109,135,60,253,95,408,244
35600,Mauressargues,30163,30,25,40,15,35,30,80,65
35601,Méjannes-le-Clap,30164,30,83,136,46,288,91,425,219
35602,Méjannes-lès-Alès,30165,30,130,285,125,430,230,785,415
35603,Meynes,30166,30,267,525,285,837,450,1572,792
35604,Meyrannes,30167,30,110,170,50,345,150,545,280
35605,Mialet,30168,30,86,93,52,248,76,376,179
35606,Milhaud,30169,30,751,1378,653,1873,950,3476,2129
35607,Molières-Cavaillac,30170,30,105,195,70,350,140,560,300
35608,Molières-sur-Cèze,30171,30,183,342,87,469,189,745,525
35609,Monoblet,30172,30,72,132,76,248,128,452,204
35610,Mons,30173,30,128,317,108,716,308,1132,445
35611,Montaren-et-Saint-Médiers,30174,30,200,300,70,650,235,955,500
35612,Montclus,30175,30,20,45,10,75,45,130,65
35613,Montdardier,30176,30,24,40,48,72,16,136,64
35614,Monteils,30177,30,52,168,92,192,136,420,220
35615,Montfaucon,30178,30,139,357,118,519,278,915,496
35616,Montfrin,30179,30,451,763,237,1026,569,1832,1214
35617,Montignargues,30180,30,20,198,43,135,160,338,218
35618,Montmirat,30181,30,20,152,48,84,92,224,172
35619,Montpezat,30182,30,128,276,48,344,212,604,404
35620,Moulézan,30183,30,80,200,80,165,135,380,280
35621,Moussac,30184,30,204,281,112,449,248,809,485
35622,Mus,30185,30,200,379,106,358,262,726,579
35623,Nages-et-Solorgues,30186,30,207,354,80,532,277,889,561
35624,Navacelles,30187,30,80,55,20,94,70,184,135
35625,Ners,30188,30,84,172,60,220,182,462,256
35626,Nîmes,30189,30,20914,36017,19222,43733,25422,88377,56931
35627,Notre-Dame-de-la-Rouvière,30190,30,50,60,20,150,85,255,110
35628,Orsan,30191,30,185,245,65,399,160,624,430
35629,Orthoux-Sérignac-Quilhan,30192,30,60,85,10,180,55,245,145
35630,Parignargues,30193,30,64,124,24,180,140,344,188
35631,Peyremale,30194,30,90,35,10,95,50,155,125
35632,Peyrolles,30195,30,3,3,0,21,3,24,6
35633,Le Pin,30196,30,30,101,21,128,104,253,131
35634,Les Plans,30197,30,20,62,4,80,64,148,82
35635,Les Plantiers,30198,30,34,34,8,83,36,127,68
35636,Pommiers,30199,30,5,10,0,35,0,35,15
35637,Pompignan,30200,30,144,196,30,202,177,409,340
35638,Ponteils-et-Brésis,30201,30,38,51,13,104,35,152,89
35639,Pont-Saint-Esprit,30202,30,1425,2509,1135,3322,1687,6144,3934
35640,Portes,30203,30,65,55,20,155,35,210,120
35641,Potelières,30204,30,39,72,25,151,43,219,111
35642,Pougnadoresse,30205,30,36,36,32,116,20,168,72
35643,Poulx,30206,30,333,1038,318,1628,563,2509,1371
35644,Pouzilhac,30207,30,51,191,39,204,119,362,242
35645,Puechredon,30208,30,3,0,6,16,0,22,3
35646,Pujaut,30209,30,455,1084,208,1621,747,2576,1539
35647,Quissac,30210,30,422,664,287,886,591,1764,1086
35648,Redessan,30211,30,374,1159,291,1269,810,2370,1533
35649,Remoulins,30212,30,288,588,284,700,496,1480,876
35650,Revens,30213,30,3,3,0,9,3,12,6
35651,Ribaute-les-Tavernes,30214,30,173,576,178,642,404,1224,749
35652,Rivières,30215,30,40,60,35,135,50,220,100
35653,Robiac-Rochessadoule,30216,30,142,157,65,384,95,544,299
35654,Rochefort-du-Gard,30217,30,675,1965,585,2735,1515,4835,2640
35655,Rochegude,30218,30,56,29,24,61,24,109,85
35656,Rogues,30219,30,31,15,0,26,11,37,46
35657,Roquedur,30220,30,31,30,8,53,20,81,61
35658,Roquemaure,30221,30,697,1288,493,1651,1150,3294,1985
35659,La Roque-sur-Cèze,30222,30,12,35,0,85,16,101,47
35660,Rousson,30223,30,450,952,222,1475,739,2436,1402
35661,La Rouvière,30224,30,44,149,60,140,180,380,193
35662,Sabran,30225,30,210,343,125,705,328,1158,553
35663,Saint-Alexandre,30226,30,122,225,126,464,184,774,347
35664,Saint-Ambroix,30227,30,696,523,206,1154,445,1805,1219
35665,Sainte-Anastasie,30228,30,200,475,85,540,370,995,675
35666,Saint-André-de-Majencoules,30229,30,100,100,20,250,110,380,200
35667,Saint-André-de-Roquepertuis,30230,30,84,120,24,248,116,388,204
35668,Saint-André-de-Valborgne,30231,30,100,80,28,136,68,232,180
35669,Saint-André-d'Olérargues,30232,30,30,74,29,202,54,285,104
35670,Saint-Bauzély,30233,30,62,160,16,173,125,314,222
35671,Saint-Bénézet,30234,30,44,50,35,105,40,180,94
35672,Saint-Bonnet-du-Gard,30235,30,72,232,96,214,205,515,304
35673,Saint-Bonnet-de-Salendrinque,30236,30,20,32,8,48,12,68,52
35674,Saint-Brès,30237,30,92,104,28,292,108,428,196
35675,Saint-Bresson,30238,30,8,0,8,28,0,36,8
35676,Sainte-Cécile-d'Andorge,30239,30,58,117,25,197,102,324,175
35677,Saint-Césaire-de-Gauzignan,30240,30,32,108,17,118,65,200,140
35678,Saint-Chaptes,30241,30,150,507,144,588,370,1102,657
35679,Saint-Christol-de-Rodières,30242,30,16,44,4,72,40,116,60
35680,Saint-Christol-lès-Alès,30243,30,1025,1514,698,2676,960,4334,2539
35681,Saint-Clément,30244,30,20,110,30,75,125,230,130
35682,Saint-Côme-et-Maruéjols,30245,30,38,163,100,244,134,478,201
35683,Sainte-Croix-de-Caderle,30246,30,14,20,5,65,20,90,34
35684,Saint-Denis,30247,30,35,84,48,79,50,177,119
35685,Saint-Dézéry,30248,30,32,100,44,132,93,269,132
35686,Saint-Dionisy,30249,30,76,252,108,336,200,644,328
35687,Saint-Étienne-de-l'Olm,30250,30,12,97,8,147,62,217,109
35688,Saint-Étienne-des-Sorts,30251,30,83,120,40,172,125,337,203
35689,Saint-Félix-de-Pallières,30252,30,47,38,0,79,47,126,85
35690,Saint-Florent-sur-Auzonnet,30253,30,264,244,104,424,180,708,508
35691,Saint-Geniès-de-Comolas,30254,30,163,464,197,661,365,1223,627
35692,Saint-Geniès-de-Malgoirès,30255,30,276,849,396,832,560,1788,1125
35693,Saint-Gervais,30256,30,79,131,48,307,89,444,210
35694,Saint-Gervasy,30257,30,149,495,120,676,325,1121,644
35695,Saint-Gilles,30258,30,1558,3554,1292,4104,2436,7832,5112
35696,Saint-Hilaire-de-Brethmas,30259,30,645,895,400,1510,660,2570,1540
35697,Saint-Hilaire-d'Ozilhan,30260,30,130,235,55,315,265,635,365
35698,Saint-Hippolyte-de-Caton,30261,30,36,52,0,76,44,120,88
35699,Saint-Hippolyte-de-Montaigu,30262,30,20,60,20,105,55,180,80
35700,Saint-Hippolyte-du-Fort,30263,30,597,765,370,1351,584,2305,1362
35701,Saint-Jean-de-Ceyrargues,30264,30,20,44,8,64,36,108,64
35702,Saint-Jean-de-Crieulon,30265,30,8,60,16,100,52,168,68
35703,Saint-Jean-de-Maruéjols-et-Avéjan,30266,30,142,200,103,391,139,633,342
35704,Saint-Jean-de-Serres,30267,30,72,148,40,144,128,312,220
35705,Saint-Jean-de-Valériscle,30268,30,85,135,55,300,110,465,220
35706,Saint-Jean-du-Gard,30269,30,414,490,242,970,421,1633,904
35707,Saint-Jean-du-Pin,30270,30,200,320,132,576,192,900,520
35708,Saint-Julien-de-Cassagnas,30271,30,64,116,72,296,108,476,180
35709,Saint-Julien-de-la-Nef,30272,30,20,29,12,24,16,52,49
35710,Saint-Julien-de-Peyrolas,30273,30,148,298,108,484,272,864,446
35711,Saint-Julien-les-Rosiers,30274,30,401,796,212,1224,640,2076,1197
35712,Saint-Just-et-Vacquières,30275,30,65,52,20,88,31,139,117
35713,Saint-Laurent-d'Aigouze,30276,30,458,715,339,1177,706,2222,1173
35714,Saint-Laurent-de-Carnols,30277,30,29,116,22,170,88,280,145
35715,Saint-Laurent-des-Arbres,30278,30,248,873,226,784,617,1627,1121
35716,Saint-Laurent-la-Vernède,30279,30,197,131,40,186,129,355,328
35717,Saint-Laurent-le-Minier,30280,30,70,55,15,165,30,210,125
35718,Saint-Mamert-du-Gard,30281,30,191,454,111,432,324,867,645
35719,Saint-Marcel-de-Careiret,30282,30,64,236,68,284,192,544,300
35720,Saint-Martial,30283,30,42,10,13,52,18,83,52
35721,Saint-Martin-de-Valgalgues,30284,30,689,873,326,1629,691,2646,1562
35722,Saint-Maurice-de-Cazevieille,30285,30,71,212,38,193,151,382,283
35723,Saint-Maximin,30286,30,100,175,10,267,165,442,275
35724,Saint-Michel-d'Euzet,30287,30,88,106,48,262,76,386,194
35725,Saint-Nazaire,30288,30,107,290,128,368,210,706,397
35726,Saint-Nazaire-des-Gardies,30289,30,20,26,0,8,17,25,46
35727,Saint-Paulet-de-Caisson,30290,30,186,408,108,743,255,1106,594
35728,Saint-Paul-la-Coste,30291,30,65,50,15,115,20,150,115
35729,Saint-Pons-la-Calm,30292,30,47,86,43,155,52,250,133
35730,Saint-Privat-de-Champclos,30293,30,72,60,4,124,64,192,132
35731,Saint-Privat-des-Vieux,30294,30,760,973,365,1946,842,3153,1733
35732,Saint-Quentin-la-Poterie,30295,30,405,654,194,1167,437,1798,1059
35733,Saint-Roman-de-Codières,30296,30,26,26,11,80,31,122,52
35734,Saint-Sauveur-Camprieu,30297,30,45,45,15,110,30,155,90
35735,Saint-Sébastien-d'Aigrefeuille,30298,30,84,120,44,236,60,340,204
35736,Saint-Siffret,30299,30,150,215,45,490,140,675,365
35737,Saint-Théodorit,30300,30,50,121,28,176,101,305,171
35738,Saint-Victor-des-Oules,30301,30,48,60,32,92,56,180,108
35739,Saint-Victor-la-Coste,30302,30,249,459,196,678,350,1224,708
35740,Saint-Victor-de-Malcap,30303,30,100,198,64,320,137,521,298
35741,Salazac,30304,30,19,26,12,68,15,95,45
35742,Salindres,30305,30,521,765,191,1065,631,1887,1286
35743,Salinelles,30306,30,110,135,70,155,105,330,245
35744,Les Salles-du-Gardon,30307,30,545,540,180,865,360,1405,1085
35745,Sanilhac-Sagriès,30308,30,158,195,65,267,151,483,353
35746,Sardan,30309,30,35,70,10,115,40,165,105
35747,Saumane,30310,30,53,26,13,74,23,110,79
35748,Sauve,30311,30,228,436,132,680,424,1236,664
35749,Sauveterre,30312,30,228,501,156,613,367,1136,729
35750,Sauzet,30313,30,60,201,40,239,159,438,261
35751,Savignargues,30314,30,25,70,25,60,70,155,95
35752,Saze,30315,30,192,524,196,620,432,1248,716
35753,Sénéchas,30316,30,40,40,10,135,25,170,80
35754,Sernhac,30317,30,150,420,120,485,500,1105,570
35755,Servas,30318,30,30,43,0,47,45,92,73
35756,Serviers-et-Labaume,30319,30,88,160,56,156,128,340,248
35757,Seynes,30320,30,0,32,4,0,0,4,32
